"Name","TeamAbbreviation","GamesPlayed","Minutes","Assists","AssistPoints","TwoPtAssists","ThreePtAssists","AtRimAssists","ShortMidRangeAssists","LongMidRangeAssists","Corner3Assists","Arc3Assists"
"LeBron James","LAL",1310,50058,9696,22689,6399,3297,3830,878,1691,1488,1809
"Dirk Nowitzki","DAL",1393,47491,3401,7839,2364,1037,1347,417,600,334,703
"Joe Johnson","HOU",1276,44235,5001,11490,3513,1488,1624,554,1335,539,949
"Carmelo Anthony","POR",1191,41721,3354,7711,2351,1003,1512,312,527,361,642
"Paul Pierce","LAC",1222,41673,4372,9915,3201,1171,1638,453,1110,456,715
"Vince Carter","ATL",1409,41497,4243,9673,3056,1187,1607,450,999,505,682
"Kobe Bryant","LAL",1080,41074,5503,12548,3961,1542,2378,663,920,594,948
"Pau Gasol","MIL",1226,40983,3925,9071,2704,1221,1642,406,656,312,909
"Jason Terry","MIL",1329,40143,5069,11253,3954,1115,1820,658,1476,321,794
"Tim Duncan","SAS",1186,39333,3646,8171,2767,879,1704,367,696,307,572
"Jamal Crawford","BKN",1327,38974,4541,10007,3616,925,2087,505,1024,328,597
"Shawn Marion","CLE",1112,38831,2130,4921,1469,661,718,204,547,209,452
"Andre Iguodala","MIA",1192,38784,5014,11201,3841,1173,2260,653,928,388,785
"Dwight Howard","PHI",1182,38495,1641,3923,1000,641,616,113,271,149,492
"Tony Parker","CHA",1254,38293,7035,16290,4815,2220,2227,895,1693,1011,1209
"Andre Miller","SAS",1222,38179,8048,17464,6680,1368,3999,703,1978,426,942
"Chris Paul","PHX",1090,37757,10275,23657,7168,3107,4008,898,2262,994,2113
"Kevin Garnett","MIN",1095,36889,4113,9068,3271,842,1590,469,1212,262,580
"Dwyane Wade","MIA",1054,35788,5701,13073,4030,1671,2408,492,1130,697,974
"Ray Allen","MIA",1004,35748,3309,7457,2470,839,1303,455,712,323,516
"LaMarcus Aldridge","BKN",1029,35194,2034,4971,1131,903,574,173,384,228,675
"Antawn Jamison","LAC",993,35033,1637,3697,1214,423,645,182,387,107,316
"Jason Kidd","NYK",977,34682,8243,17968,6761,1482,3493,983,2285,404,1078
"Zach Randolph","SAC",1115,34627,2049,4707,1440,609,896,243,301,91,518
"Richard Jefferson","DEN",1181,34303,2412,5480,1756,656,851,239,666,209,447
"Steve Nash","LAL",980,32922,9444,21186,7146,2298,4110,1157,1879,767,1531
"Russell Westbrook","WAS",943,32748,8061,18361,5822,2239,3559,963,1300,702,1537
"Rudy Gay","SAS",1009,32708,2167,4906,1595,572,889,340,366,188,384
"Trevor Ariza","MIA",1094,32488,2352,5453,1603,749,970,263,370,282,467
"Kevin Durant","BKN",884,32461,3681,8533,2510,1171,1518,401,591,398,773
"Chris Bosh","MIA",893,31939,1795,4168,1217,578,643,188,386,190,388
"Elton Brand","PHI",977,31919,2029,4607,1480,549,608,237,635,85,464
"Rashard Lewis","MIA",947,31828,1691,3973,1100,591,558,205,337,187,404
"Tyson Chandler","HOU",1160,31621,967,2176,725,242,353,109,263,44,198
"Tayshaun Prince","MIN",1017,31577,2407,5391,1830,577,727,379,724,161,416
"Kyle Korver","MIL",1232,31162,2114,4618,1724,390,1029,309,386,137,253
"Thaddeus Young","CHI",1033,30934,1899,4374,1323,576,844,215,264,197,379
"Luol Deng","MIN",902,30927,2042,4654,1472,570,816,204,452,199,371
"Kyle Lowry","TOR",960,30483,5995,13742,4243,1752,2502,832,909,602,1150
"James Harden","BKN",877,30196,5730,13645,3545,2185,2886,399,260,784,1401
"Marvin Williams","MIL",1072,30158,1373,3145,974,399,506,139,329,114,285
"Paul Millsap","DEN",1052,30123,2349,5497,1550,799,891,197,462,278,521
"DeMar DeRozan","SAS",881,30048,3355,8257,1808,1547,994,402,412,453,1094
"Shane Battier","MIA",977,30003,1717,3876,1275,442,611,279,385,152,290
"Lamar Odom","LAC",885,29353,3237,7292,2419,818,1225,496,698,226,592
"Jason Richardson","PHI",857,29241,2284,5163,1689,595,836,317,536,207,388
"Metta World Peace","LAL",919,29203,2429,5454,1833,596,863,336,634,164,432
"David West","GSW",1034,29140,2273,5296,1523,750,923,273,327,241,509
"Mike Bibby","NYK",869,29057,4527,9848,3733,794,1856,477,1400,291,503
"Chauncey Billups","DET",905,29030,5110,11195,4135,975,1817,716,1602,319,656
"Monta Ellis","IND",833,29011,3856,9013,2555,1301,1606,324,625,413,888
"Josh Smith","NOP",894,29000,2789,6403,1964,825,1386,187,391,406,419
"Deron Williams","CLE",845,28866,6819,15279,5178,1641,2725,775,1678,424,1217
"Raymond Felton","OKC",971,28830,5096,11791,3497,1599,2010,420,1067,544,1055
"Boris Diaw","UTA",1064,28757,3684,8454,2598,1086,1357,409,832,390,696
"Marc Gasol","LAL",891,28723,2996,6919,2069,927,1322,317,430,289,638
"Jeff Green","BKN",976,28615,1529,3568,1019,510,519,167,333,163,347
"Al Horford","OKC",881,28594,2912,6953,1783,1129,1072,267,444,365,764
"Mike Conley","UTA",886,28561,5022,11208,3858,1164,2002,722,1134,357,807
"Caron Butler","SAC",881,28324,2007,4551,1470,537,801,224,445,175,362
"Richard Hamilton","CHI",850,28209,3017,6592,2459,558,1288,358,813,202,356
"Rajon Rondo","LAC",918,27873,7414,16810,5432,1982,2989,748,1695,642,1340
"Mike Miller","DEN",1031,27811,2666,6006,1992,674,943,364,685,243,431
"Ben Wallace","DET",860,27585,1332,2951,1045,287,511,144,390,100,187
"Stephen Jackson","LAC",858,27388,2634,5824,2078,556,1421,244,413,199,357
"Mike Dunleavy","ATL",986,27343,2185,4917,1638,547,906,258,474,183,364
"Derek Fisher","OKC",997,27096,2939,6463,2354,585,1294,407,653,160,425
"Baron Davis","NYK",753,27076,5716,12674,4474,1242,2594,601,1279,394,848
"Kirk Hinrich","ATL",879,27016,4245,9336,3399,846,1346,549,1504,291,555
"Al Harrington","WAS",910,26990,1606,3674,1144,462,651,138,355,178,284
"Carlos Boozer","LAL",861,26915,1928,4199,1585,343,870,179,536,64,279
"Manu Ginobili","SAS",1057,26867,4001,9022,2981,1020,1745,500,736,516,504
"Hedo Turkoglu","LAC",997,26717,2832,6482,2014,818,1175,297,542,362,456
"Nicolas Batum","LAC",856,26566,3115,7186,2159,956,1286,411,462,271,685
"Allen Iverson","PHI",640,26553,4012,8844,3192,820,1706,463,1023,336,484
"Wesley Matthews","LAL",849,26344,1750,4107,1143,607,593,175,375,168,439
"Lou Williams","ATL",1067,26303,3684,8295,2757,927,1783,416,558,326,601
"Al Jefferson","IND",915,26295,1347,3117,924,423,506,106,312,58,365
"JR Smith","LAL",977,26272,2077,4839,1392,685,891,149,352,242,443
"Amar'e Stoudemire","MIA",846,26251,1050,2460,690,360,412,71,207,124,236
"Stephen Curry","GSW",762,26152,4984,11321,3631,1353,2369,545,717,462,891
"Tracy McGrady","ATL",746,25932,3687,8397,2664,1023,1420,451,793,376,647
"Brook Lopez","MIL",855,25896,1239,2897,820,419,522,113,185,95,324
"Jrue Holiday","MIL",772,25609,4916,11265,3483,1433,2014,646,823,450,983
"DeAndre Jordan","BKN",931,25576,911,2111,622,289,351,93,178,73,216
"Rasheed Wallace","NYK",775,25430,1438,3133,1181,257,656,210,315,82,175
"Nene","HOU",965,25244,1719,3887,1270,449,751,162,357,150,299
"Jermaine O'Neal","GSW",800,24938,1313,2971,968,345,555,104,309,117,228
"Damian Lillard","POR",682,24777,4514,10632,2910,1604,1814,468,628,485,1119
"Gerald Wallace","BOS",832,24736,1725,3891,1284,441,759,183,342,166,275
"Jameer Nelson","DET",878,24541,4508,10496,3028,1480,1746,473,809,497,983
"David Lee","SAS",829,24294,1825,4420,1055,770,616,132,307,258,512
"Goran Dragic","MIA",867,24235,4168,9726,2778,1390,1598,464,716,505,885
"Peja Stojakovic","DAL",682,24203,1230,2761,929,301,400,125,404,123,178
"Jarrett Jack","NYK",867,24140,3952,8854,3002,950,1422,547,1033,336,614
"Serge Ibaka","LAC",849,24066,696,1730,358,338,228,52,78,111,227
"Devin Harris","DAL",985,23966,3869,8749,2858,1011,1531,437,890,368,643
"JJ Redick","DAL",940,23964,1862,4344,1242,620,843,192,207,201,419
"Andrei Kirilenko","BKN",797,23936,2169,4551,1956,213,1154,211,591,60,153
"Mo Williams","CLE",818,23880,3990,8807,3163,827,1788,471,904,272,555
"Kemba Walker","BOS",704,23718,3788,8761,2603,1185,1397,505,701,297,888
"Cuttino Mobley","LAC",617,23680,1686,3711,1347,339,584,271,492,116,223
"Paul George","LAC",706,23665,2465,5720,1675,790,1033,305,337,299,491
"Jose Calderon","DET",894,23643,5148,11562,3882,1266,1830,661,1391,393,873
"John Salmons","NOP",895,23641,2183,4981,1568,615,729,289,550,223,392
"Kevin Love","CLE",738,23426,1759,3945,1332,427,875,210,247,136,291
"Kenyon Martin","MIL",757,23148,1439,3176,1141,298,642,127,372,72,226
"Brad Miller","MIN",775,23123,2403,5276,1933,470,1003,226,704,132,338
"Michael Finley","BOS",724,23099,1671,3860,1153,518,507,225,421,176,342
"Blake Griffin","BKN",668,22860,2889,6991,1676,1213,980,243,453,359,854
"Eric Gordon","HOU",692,22590,1967,4510,1391,576,841,214,336,246,330
"George Hill","PHI",815,22415,2577,5964,1767,810,760,377,630,294,516
"Marcus Camby","NYK",742,22306,1568,3322,1382,186,889,183,310,48,138
"Zaza Pachulia","DET",1098,22234,1433,3219,1080,353,617,127,336,92,261
"Jeff Teague","MIL",826,22164,4585,10564,3191,1394,1694,553,944,400,994
"Corey Maggette","DET",750,22003,1635,3597,1308,327,534,319,455,113,214
"D.J. Augustin","HOU",921,21969,3654,8346,2616,1038,1345,414,857,294,744
"Matt Barnes","GSW",929,21951,1691,3831,1242,449,776,177,289,181,268
"Courtney Lee","DAL",811,21944,1353,3123,936,417,413,206,317,125,292
"Kurt Thomas","NYK",883,21905,1009,2341,686,323,327,120,239,106,217
"John Wall","HOU",613,21833,5557,12901,3770,1787,2227,556,987,658,1129
"Shaquille O'Neal","BOS",673,21774,1596,3653,1135,461,726,104,305,47,414
"Stephon Marbury","BOS",574,21703,4186,9245,3313,873,1479,475,1359,373,500
"Samuel Dalembert","NYK",886,21657,465,1023,372,93,218,44,110,26,67
"Luke Ridnour","ORL",830,21624,3713,8545,2594,1119,1341,470,783,309,810
"Udonis Haslem","MIA",859,21568,729,1672,515,214,304,69,142,59,155
"Kevin Martin","SAS",714,21562,1352,3106,950,402,418,159,373,110,292
"Bruce Bowen","SAS",712,21378,946,2172,666,280,254,150,262,109,171
"Gordon Hayward","CHA",685,21267,2399,5632,1565,834,977,294,294,282,552
"James Posey","IND",783,21208,1267,2915,886,381,403,164,319,127,254
"Harrison Barnes","SAC",670,21176,1190,2978,592,598,326,123,143,167,431
"Tobias Harris","PHI",680,21076,1476,3508,920,556,557,184,179,180,376
"Taj Gibson","NYK",844,21031,848,2003,541,307,269,94,178,66,241
"Bradley Beal","WAS",605,20980,2436,5672,1636,800,919,378,339,236,564
"Jimmy Butler","MIA",633,20932,2524,5905,1667,857,883,358,426,283,574
"Arron Afflalo","ORL",762,20828,1386,3191,967,419,510,143,314,112,307
"Steve Blake","DET",870,20817,3446,7750,2588,858,1371,393,824,315,543
"Ricky Davis","LAC",642,20806,2306,5114,1804,502,787,296,721,174,328
"Juwan Howard","MIA",798,20797,1265,2884,911,354,469,146,296,101,253
"Darren Collison","IND",708,20797,3543,8154,2475,1068,1240,468,767,253,815
"Quentin Richardson","NYK",783,20792,1138,2548,866,272,473,179,214,93,179
"Antoine Walker","MIN",605,20747,2200,4850,1750,450,1011,207,532,135,315
"Marcin Gortat","LAC",806,20691,915,2156,589,326,280,61,248,101,225
"Derrick Rose","NYK",646,20668,3543,8155,2474,1069,1188,332,954,396,673
"P.J. Tucker","MIL",706,20549,1000,2391,609,391,383,92,134,111,280
"Nikola Vucevic","CHI",668,20452,1801,4342,1061,740,674,182,205,184,556
"Zydrunas Ilgauskas","MIA",756,20422,880,1975,665,215,359,91,215,46,169
"Ben Gordon","ORL",744,20377,1868,4175,1429,439,734,200,495,123,316
"Klay Thompson","GSW",615,20338,1416,3194,1054,362,716,160,178,133,229
"Wilson Chandler","BKN",676,20286,1205,2933,682,523,415,111,156,170,353
"Drew Gooden","WAS",790,20136,896,1984,704,192,413,110,181,67,125
"Jared Dudley","LAL",904,20115,1395,3191,994,401,593,163,238,141,260
"Michael Redd","PHX",629,20111,1338,2979,1035,303,524,163,348,100,203
"Danilo Gallinari","ATL",662,20107,1313,3015,924,389,576,175,173,126,263
"Robin Lopez","WAS",903,19962,742,1746,480,262,230,70,180,50,212
"Troy Murphy","DAL",729,19939,1088,2554,710,378,358,106,246,88,290
"Andrew Bogut","GSW",705,19865,1546,3535,1103,443,655,149,299,116,327
"Andre Drummond","LAL",645,19831,872,2037,579,293,342,125,112,88,205
"Raja Bell","UTA",706,19826,1208,2741,883,325,388,145,350,97,228
"Channing Frye","CLE",890,19772,864,2067,525,339,304,102,119,122,217
"Kyrie Irving","BKN",582,19713,3337,7802,2209,1128,1329,439,441,336,792
"Eric Bledsoe","NOP",702,19660,3320,7747,2213,1107,1505,316,392,362,745
"Chris Kaman","POR",735,19653,921,2061,702,219,385,81,236,56,163
"Desmond Mason","SAC",643,19635,1049,2356,791,258,345,151,295,84,174
"Marco Belinelli","SAS",860,19546,1429,3295,992,437,528,219,245,161,276
"Earl Watson","POR",878,19501,3871,8481,3132,739,1650,435,1047,225,514
"Anthony Davis","LAL",564,19402,1292,3080,796,496,542,123,131,150,346
"Danny Green","PHI",757,19387,1206,2711,907,299,500,182,225,127,172
"Morris Peterson","OKC",711,19366,1090,2431,839,251,350,152,337,116,135
"Gilbert Arenas","MEM",552,19355,2909,6423,2304,605,1182,391,731,169,436
"Randy Foye","BKN",752,19279,2112,4752,1584,528,851,240,493,211,317
"Ricky Rubio","MIN",631,19158,4820,10889,3571,1249,2296,583,692,423,826
"Giannis Antetokounmpo","MIL",589,19150,2632,6453,1443,1189,915,285,243,354,835
"Thabo Sefolosha","HOU",869,19059,1196,2724,864,332,458,111,295,88,244
"Emeka Okafor","NOP",616,19058,520,1201,359,161,157,45,157,39,122
"Larry Hughes","ORL",595,19056,2008,4390,1634,374,873,289,472,134,240
"Rafer Alston","MIA",644,19037,3132,7034,2362,770,968,431,963,282,488
"Luis Scola","BKN",743,19002,1194,2867,715,479,397,118,200,121,358
"Ersan Ilyasova","UTA",825,18958,908,2140,584,324,333,109,142,121,203
"Gary Payton","MIA",549,18946,3418,7607,2647,771,1168,477,1002,207,564
"Evan Turner","ATL",705,18939,2462,5603,1783,679,1082,277,424,146,533
"Steve Francis","HOU",499,18858,2966,6645,2253,713,1261,307,685,208,505
"DeMarcus Cousins","LAC",606,18794,1908,4458,1266,642,872,178,216,240,402
"Corey Brewer","SAC",819,18771,1250,2808,942,308,609,190,143,92,216
"Brendan Haywood","CLE",816,18695,442,1005,321,121,119,45,157,27,94
"Tristan Thompson","BOS",673,18660,691,1680,393,298,189,89,115,59,239
"Joakim Noah","LAC",672,18645,1907,4235,1486,421,832,178,476,93,328
"Jason Williams","MEM",657,18617,3723,8163,3006,717,1521,467,1018,224,493
"Andrew Wiggins","GSW",525,18607,1232,2948,748,484,416,161,171,158,326
"Nick Collison","OKC",910,18604,939,2133,684,255,427,97,160,47,208
"Khris Middleton","MIL",585,18552,2103,4777,1532,571,1155,220,157,186,385
"Derrick Favors","UTA",751,18550,826,2008,470,356,284,66,120,108,248
"Danny Granger","MIA",586,18488,1097,2548,743,354,376,112,255,104,250
"Mehmet Okur","BKN",634,18437,1089,2414,853,236,432,92,329,65,171
"DeShawn Stevenson","ATL",824,18389,1355,3003,1062,293,561,125,376,71,222
"Erick Dampier","ATL",762,18389,607,1395,426,181,158,58,210,40,141
"Leandro Barbosa","PHX",850,18383,1775,4123,1202,573,652,182,368,241,332
"Amir Johnson","PHI",870,18322,1073,2433,786,287,398,130,258,71,216
"Tyreke Evans","IND",594,18243,2852,6634,1922,930,1035,307,580,294,636
"Beno Udrih","DET",831,18191,2858,6447,2127,731,1036,340,751,285,446
"Draymond Green","GSW",639,18181,3413,8033,2206,1207,1424,345,437,319,888
"Tony Allen","NOP",820,18046,1077,2374,857,220,507,152,198,87,133
"Kawhi Leonard","LAC",576,18025,1672,4071,945,727,554,195,196,274,453
"Eddie Jones","DAL",538,18012,1431,3118,1175,256,507,219,449,88,168
"Wally Szczerbiak","CLE",578,17893,1331,2941,1052,279,371,243,438,95,184
"Shareef Abdur-Rahim","SAC",536,17890,1278,2925,909,369,388,120,401,98,271
"Rodney Stuckey","IND",651,17890,2333,5248,1751,582,823,257,671,228,354
"Marcus Morris Sr.","LAC",664,17887,972,2262,654,318,397,132,125,134,184
"Grant Hill","LAC",591,17771,1532,3441,1155,377,612,162,381,114,263
"Sam Cassell","BOS",559,17723,3391,7385,2788,603,1021,702,1065,141,462
"Al-Farouq Aminu","CHI",711,17699,879,2036,601,278,363,98,140,64,214
"Kentavious Caldwell-Pope","LAL",606,17643,1005,2358,657,348,461,128,68,109,239
"P.J. Brown","BOS",565,17614,862,1892,694,168,258,126,310,42,126
"Greg Monroe","PHI",632,17476,1354,3075,987,367,678,119,190,120,247
"Jerry Stackhouse","BKN",614,17475,1985,4484,1471,514,640,209,622,168,346
"Markieff Morris","LAL",698,17427,1130,2631,759,371,491,129,139,139,232
"CJ Miles","WAS",848,17280,914,2009,733,181,450,111,172,62,119
"Mario Chalmers","MEM",646,17245,2412,5390,1846,566,1011,233,602,232,334
"Rasual Butler","SAS",809,17214,658,1453,521,137,260,88,173,58,79
"Shaun Livingston","GSW",833,17193,2483,5571,1878,605,907,324,647,161,444
"Kendrick Perkins","CLE",782,17157,813,1823,616,197,386,59,171,47,150
"O.J. Mayo","MIL",547,16921,1607,3518,1303,304,767,257,279,105,199
"Jalen Rose","PHX",485,16910,1920,4270,1490,430,740,261,489,163,267
"Brandon Jennings","MIL",555,16843,3151,7077,2376,775,1363,359,654,262,513
"Ryan Anderson","HOU",649,16769,586,1399,359,227,213,71,75,73,154
"Avery Bradley","HOU",598,16746,1057,2416,755,302,439,143,173,74,228
"Jae Crowder","PHX",668,16675,1058,2495,679,379,444,117,118,116,263
"Tim Thomas","DAL",617,16655,1023,2296,773,250,260,205,308,97,153
"Eric Snow","CLE",542,16480,2911,6334,2399,512,1112,410,877,189,323
"CJ McCollum","POR",528,16479,1729,4159,1028,701,640,189,199,210,491
"Nick Young","DEN",720,16419,687,1535,526,161,248,94,184,39,122
"Brandon Bass","LAC",758,16411,608,1439,385,223,148,69,168,70,153
"Matt Harpring","UTA",611,16409,854,1837,725,129,311,120,294,28,101
"Roy Hibbert","DEN",662,16391,885,1997,658,227,439,69,150,44,183
"J.J. Barea","DAL",831,16286,3270,7428,2382,888,1301,365,716,265,623
"Trenton Hassell","BKN",644,16278,1132,2499,897,235,379,173,345,78,157
"Rasho Nesterovic","TOR",727,16246,742,1639,587,155,282,63,242,29,126
"Rudy Gobert","UTA",545,16181,735,1792,413,322,246,67,100,77,245
"Vladimir Radmanovic","CHI",737,16175,998,2271,723,275,384,142,197,112,163
"Antonio McDyess","SAS",653,16144,772,1806,510,262,222,86,202,94,168
"Evan Fournier","BOS",565,16118,1505,3475,1040,465,549,249,242,144,321
"Ramon Sessions","WAS",691,16117,2807,6333,2088,719,1047,389,652,203,516
"Ty Lawson","SAC",551,16087,3316,7655,2293,1023,1497,375,421,314,709
"Damon Stoudamire","SAS",528,16053,2712,5954,2182,530,1068,370,744,143,387
"Luc Mbah a Moute","HOU",688,16038,588,1383,381,207,236,49,96,60,147
"Antonio Daniels","PHI",682,15905,2317,5371,1580,737,728,268,584,257,480
"Jonas Valanciunas","MEM",621,15902,634,1510,392,242,199,105,88,44,198
"Yao Ming","HOU",486,15840,769,1834,473,296,321,38,114,60,236
"David Wesley","CLE",469,15814,1529,3365,1222,307,496,294,432,86,221
"Steven Adams","NOP",588,15814,726,1721,457,269,253,71,133,59,210
"Andrea Bargnani","BKN",550,15807,653,1484,475,178,222,84,169,56,122
"Clifford Robinson","BKN",526,15787,1222,2735,931,291,472,161,298,111,180
"Enes Kanter","POR",713,15690,630,1511,379,251,195,64,120,41,210
"Chucky Atkins","DET",614,15678,2090,4623,1647,443,826,247,574,134,309
"Jeff Foster","IND",745,15668,698,1587,507,191,212,66,229,40,151
"Reggie Jackson","LAC",628,15664,2661,6254,1729,932,1017,340,372,313,619
"Nazr Mohammed","OKC",951,15598,371,806,307,64,202,30,75,16,48
"Reggie Evans","SAC",809,15581,458,1044,330,128,169,50,111,40,88
"Chris Webber","GSW",426,15571,1802,4009,1397,405,786,193,418,128,277
"Spencer Hawes","MIL",684,15542,1271,2832,981,290,569,144,268,89,201
"Chris Duhon","LAL",606,15519,2690,6126,1944,746,971,239,734,217,529
"Kenny Thomas","SAC",560,15518,862,1984,602,260,327,69,206,85,175
"Joe Smith","LAL",668,15394,556,1242,426,130,180,81,165,40,90
"Bojan Bogdanovic","UTA",534,15387,825,1988,487,338,315,95,77,134,204
"Josh Howard","MIN",507,15346,817,1848,603,214,244,79,280,67,147
"Wayne Ellington","DET",727,15289,822,1900,566,256,328,114,124,87,169
"Isaiah Thomas","NOP",528,15229,2605,6056,1759,846,1025,268,466,247,599
"Terrence Ross","ORL",607,15178,725,1698,477,248,287,105,85,81,167
"Brent Barry","HOU",599,15140,1948,4305,1539,409,774,292,473,148,261
"Anderson Varejao","CLE",632,15091,737,1681,530,207,330,70,130,58,149
"Donyell Marshall","PHI",577,15059,705,1555,560,145,322,74,164,56,89
"Jason Collins","BKN",735,14978,626,1364,514,112,203,60,251,28,84
"Victor Oladipo","MIA",454,14968,1796,4121,1267,529,696,224,347,170,359
"Patrick Patterson","LAC",719,14920,736,1799,409,327,254,57,98,93,234
"Dante Cunningham","SAS",715,14875,506,1189,329,177,175,55,99,41,136
"Jason Thompson","TOR",588,14820,635,1439,466,169,277,63,126,46,123
"Jeff McInnis","CHA",503,14800,2334,5067,1935,399,880,442,613,94,305
"Willie Green","ORL",731,14784,1018,2291,763,255,369,103,291,76,179
"Latrell Sprewell","MIN",394,14747,1379,3072,1065,314,379,311,375,90,224
"Patty Mills","SAS",739,14667,1711,3946,1187,524,584,262,341,155,369
"Jamaal Magloire","TOR",680,14650,386,874,284,102,110,44,130,27,75
"Dennis Schroder","LAL",557,14610,2611,6187,1646,965,1050,296,300,244,721
"Tim Hardaway Jr.","DAL",544,14596,1003,2369,640,363,379,104,157,99,264
"Cory Joseph","DET",663,14561,1949,4639,1208,741,618,299,291,211,530
"Keith Bogans","BOS",671,14530,866,1901,697,169,327,173,197,70,99
"Jamaal Tinsley","UTA",547,14443,3330,7333,2657,673,1373,464,820,180,493
"Mike James","CHI",595,14361,2075,4610,1615,460,603,259,753,165,295
"Austin Rivers","DEN",588,14359,1348,3277,767,581,437,129,201,173,408
"Kris Humphries","ATL",800,14228,556,1262,406,150,173,65,168,49,101
"Bismack Biyombo","CHA",702,14214,419,964,293,126,129,64,100,27,99
"Anthony Tolliver","PHI",730,14185,650,1495,455,195,243,95,117,63,132
"Keyon Dooling","MEM",728,14132,1601,3623,1180,421,583,156,441,142,279
"James Johnson","NOP",685,14129,1453,3453,906,547,593,159,154,175,372
"Robert Covington","POR",466,14125,711,1709,424,287,307,63,54,91,196
"Jordan Clarkson","UTA",521,14049,1332,3145,851,481,559,167,125,149,332
"Joe Ingles","UTA",545,14035,2055,4762,1403,652,1082,206,115,276,376
"Mark Blount","MIA",605,14005,513,1141,398,115,236,31,131,31,84
"Karl-Anthony Towns","MIN",408,13996,1217,2816,835,382,557,129,149,101,281
"Bonzi Wells","NOP",518,13940,1149,2493,954,195,564,147,243,42,153
"Martell Webster","WAS",580,13914,588,1321,443,145,211,78,154,71,74
"Michael Beasley","LAL",609,13904,788,1810,554,234,332,90,132,95,139
"Nate Robinson","NOP",618,13877,1826,4109,1369,457,729,181,459,130,327
"Gerald Henderson","PHI",535,13855,1009,2304,723,286,376,133,214,76,210
"Will Barton","DEN",552,13846,1429,3331,956,473,598,206,152,118,355
"Ruben Patterson","LAC",544,13727,1022,2284,782,240,468,98,216,72,168
"Devin Booker","PHX",409,13715,1899,4551,1146,753,831,196,119,276,477
"Garrett Temple","CHI",632,13686,1114,2568,774,340,439,180,155,111,229
"DeMarre Carroll","HOU",578,13674,726,1737,441,285,268,80,93,87,198
"Julius Randle","NYK",446,13602,1472,3694,722,750,428,123,171,205,545
"Jared Jeffries","POR",629,13578,798,1860,534,264,281,67,186,61,203
"Charlie Villanueva","DAL",656,13576,549,1230,417,132,253,57,107,68,64
"Ed Davis","MIN",691,13555,532,1256,340,192,175,39,126,39,153
"Nikola Jokic","DEN",453,13541,2697,6229,1862,835,1320,332,210,250,585
"Darrell Armstrong","BKN",577,13533,2139,4816,1601,538,715,180,706,122,416
"Tony Battie","PHI",640,13533,346,783,255,91,121,40,94,16,75
"Wesley Johnson","WAS",609,13471,645,1450,485,160,298,76,111,60,100
"Ryan Gomes","OKC",487,13463,712,1641,495,217,259,87,149,76,141
"Aaron Brooks","MIN",645,13439,1925,4422,1353,572,699,268,386,208,364
"Kwame Brown","PHI",607,13385,554,1214,448,106,214,67,167,20,86
"Anthony Parker","CLE",439,13368,1100,2429,871,229,433,143,295,72,157
"Matt Bonner","SAS",792,13346,552,1318,338,214,130,68,140,103,111
"Chandler Parsons","ATL",440,13247,1201,2831,772,429,512,96,164,168,261
"Ish Smith","WAS",654,13228,2555,6159,1506,1049,951,240,315,274,775
"Marcus Smart","BOS",449,13188,1901,4478,1225,676,829,173,223,181,495
"Maurice Harkless","MIA",574,13155,549,1298,349,200,200,62,87,60,140
"Brandon Knight","DET",446,13139,1769,4047,1260,509,676,194,390,155,354
"Eddy Curry","DAL",527,13124,287,674,187,100,85,25,77,17,83
"Travis Outlaw","SAC",622,13025,514,1201,341,173,174,63,104,77,96
"Gerald Green","HOU",657,13024,596,1386,402,194,232,70,100,73,121
"Doug Christie","LAC",390,13017,1573,3422,1297,276,654,157,486,120,156
"Kent Bazemore","GSW",618,13000,1120,2575,785,335,542,125,118,100,235
"Mason Plumlee","DET",588,12975,1385,3288,867,518,544,146,177,135,383
"Antonio Davis","TOR",404,12968,630,1418,472,158,200,78,194,50,108
"Jerami Grant","DET",508,12954,636,1571,337,299,215,64,58,93,206
"Derek Anderson","CHA",447,12952,1491,3304,1169,322,607,210,352,101,221
"Patrick Beverley","LAC",468,12933,1571,3794,919,652,628,193,98,194,458
"Aaron Gordon","DEN",453,12901,1125,2622,753,372,467,142,144,94,278
"Zach LaVine","CHI",411,12890,1557,3561,1110,447,607,273,230,130,317
"Elfrid Payton","NYK",450,12835,2768,6354,1950,818,1128,354,468,217,601
"JaVale McGee","DEN",746,12811,316,707,241,75,170,33,38,16,59
"Bobby Jackson","SAC",564,12779,1289,2861,1006,283,491,121,394,90,193
"Brevin Knight","UTA",545,12754,3065,6636,2559,506,1160,381,1018,143,363
"Kelly Olynyk","HOU",570,12645,1137,2733,678,459,464,90,124,147,312
"Reggie Miller","IND",376,12574,1078,2315,919,159,395,270,254,60,99
"E'Twaun Moore","PHX",598,12563,1055,2402,763,292,413,143,207,88,204
"Damon Jones","MIL",578,12507,1669,3664,1343,326,620,225,498,117,209
"Jerryd Bayless","MIN",586,12484,1674,3816,1206,468,527,186,493,156,312
"Chris Wilcox","BOS",628,12477,455,988,377,78,225,48,104,19,59
"Earl Boykins","HOU",604,12477,2011,4485,1548,463,687,219,642,148,315
"Andray Blatche","BKN",564,12462,798,1858,536,262,342,63,131,86,176
"Eddie House","MIA",717,12385,1112,2442,894,218,434,128,332,98,120
"Dorell Wright","POR",549,12282,850,1944,606,244,309,92,205,93,151
"Anthony Morrow","CHI",564,12281,494,1134,348,146,189,65,94,54,92
"Tony Snell","ATL",548,12269,641,1482,441,200,264,84,93,58,142
"Chris Andersen","CLE",695,12261,337,740,271,66,143,28,100,22,44
"Tyronn Lue","ORL",531,12240,1685,3651,1404,281,529,190,685,86,195
"Jeremy Lin","TOR",480,12217,2042,4699,1427,615,1012,211,204,198,417
"Lorenzen Wright","CLE",509,12196,464,1059,333,131,176,54,103,44,87
"Sebastian Telfair","OKC",564,12147,1960,4473,1407,553,688,219,500,158,395
"Jodie Meeks","TOR",539,12109,583,1340,409,174,209,78,122,57,117
"C.J. Watson","ORL",600,12092,1485,3403,1052,433,467,123,462,146,287
"Justin Holiday","IND",502,12091,732,1695,501,231,313,101,87,72,159
"Alec Burks","NYK",544,12060,1025,2356,719,306,442,135,142,97,209
"Theo Ratliff","LAL",470,12031,316,706,242,74,119,40,83,13,61
"Andres Nocioni","PHI",514,12016,614,1402,440,174,200,70,170,51,123
"Omri Casspi","MEM",588,11960,662,1483,503,159,315,86,102,42,117
"Mickael Pietrus","TOR",557,11950,445,1044,291,154,168,35,88,50,104
"JJ Hickson","WAS",534,11927,449,1076,271,178,169,30,72,57,121
"Gorgui Dieng","SAS",553,11897,750,1743,507,243,287,76,144,63,180
"T.J. Ford","SAS",429,11895,2495,5704,1781,714,896,248,637,228,486
"Lance Stephenson","LAL",508,11867,1456,3291,1077,379,583,192,302,122,257
"Francisco Garcia","HOU",549,11853,747,1696,545,202,280,93,172,77,125
"Delonte West","DAL",432,11840,1540,3371,1249,291,616,201,432,102,189
"Dion Waiters","LAL",419,11835,1163,2796,693,470,385,141,167,177,293
"Chuck Hayes","HOU",644,11815,781,1766,577,204,346,66,165,49,155
"Anthony Johnson","ORL",611,11777,1766,3968,1330,436,637,180,513,139,297
"Gary Harris","ORL",407,11744,857,2059,512,345,337,98,77,84,261
"Raef LaFrentz","POR",470,11729,501,1129,374,127,165,73,136,37,90
"Kenneth Faried","HOU",478,11729,470,1105,305,165,225,35,45,47,118
"Darius Miles","MEM",446,11727,840,1849,671,169,378,107,186,50,119
"Joel Przybilla","MIL",592,11725,256,569,199,57,95,41,63,22,35
"Marquis Daniels","MIL",548,11706,966,2230,668,298,315,99,254,87,211
"Dikembe Mutombo","HOU",511,11694,235,528,177,58,67,28,82,8,50
"Otto Porter Jr.","ORL",441,11685,673,1536,483,190,293,106,84,55,135
"Robert Horry","SAS",572,11663,977,2182,749,228,414,134,201,68,160
"Carlos Delfino","HOU",507,11584,887,2002,659,228,347,93,219,85,143
"Brandon Roy","MIN",326,11560,1517,3525,1026,491,401,123,502,248,243
"Ronnie Brewer","CHI",502,11538,828,1835,649,179,368,80,201,51,128
"Carl Landry","PHI",513,11524,355,849,216,139,75,35,106,26,113
"Bobby Simmons","LAC",466,11514,710,1544,586,124,291,148,147,34,90
"Hassan Whiteside","SAC",446,11485,300,705,195,105,116,44,35,17,88
"Iman Shumpert","BKN",461,11471,845,2045,490,355,301,58,131,93,262
"Keith Van Horn","DAL",391,11468,571,1263,450,121,211,84,155,32,89
"Josh Richardson","DAL",373,11438,1057,2548,623,434,383,144,96,121,313
"Jason Maxiell","CHA",618,11378,266,594,204,62,107,26,71,14,48
"Brian Grant","PHX",402,11366,452,995,361,91,176,70,115,14,77
"Devean George","GSW",581,11341,531,1204,389,142,172,70,147,36,106
"Jonas Jerebko","GSW",635,11323,525,1236,339,186,187,63,89,35,151
"Marcus Thornton","WAS",483,11297,676,1485,543,133,325,83,135,48,85
"Kosta Koufos","SAC",686,11272,359,840,237,122,79,44,114,33,89
"Jacque Vaughn","SAS",634,11261,1702,3824,1282,420,562,151,569,154,266
"Marko Jaric","MEM",447,11255,1600,3463,1337,263,568,312,457,87,176
"Ben McLemore","LAL",492,11248,504,1160,352,152,220,66,66,59,93
"Allan Houston","NYK",307,11212,724,1604,568,156,201,181,186,58,98
"Eduardo Najera","CHA",619,11204,493,1118,361,132,166,39,156,29,103
"Buddy Hield","SAC",387,11176,951,2205,648,303,423,139,86,90,213
"Andris Biedrins","UTA",516,11146,467,1071,330,137,149,40,141,38,99
"Myles Turner","IND",389,11145,469,1126,281,188,181,48,52,74,114
"James Jones","CLE",709,11089,366,883,215,151,92,32,91,65,86
"Nick Van Exel","SAS",373,11078,1946,4326,1512,434,818,183,511,138,296
"Flip Murray","CHI",487,11077,1096,2484,804,292,437,119,248,102,190
"Damien Wilkins","IND",582,10989,796,1799,589,207,246,143,200,56,151
"Michael Kidd-Gilchrist","DAL",446,10979,515,1231,314,201,160,64,90,43,158
"Jeremy Lamb","IND",517,10961,823,1938,531,292,324,108,99,71,221
"Maurice Evans","WAS",562,10908,420,973,287,133,115,52,120,44,89
"Trevor Booker","IND",532,10873,565,1400,295,270,175,54,66,69,201
"Glen Davis","LAC",514,10866,457,1073,298,159,173,34,91,42,117
"Stromile Swift","PHX",547,10802,275,609,216,59,121,30,65,26,33
"Andrew Bynum","IND",418,10691,490,1103,367,123,169,56,142,31,92
"Marreese Speights","ORL",705,10638,461,1055,328,133,204,54,70,37,96
"Carlos Arroyo","BOS",569,10635,1761,3876,1407,354,709,150,548,106,248
"Hakim Warrick","CHA",526,10624,400,931,269,131,145,47,77,32,99
"Cody Zeller","CHA",467,10619,669,1577,430,239,240,74,116,74,165
"Clint Capela","ATL",396,10572,373,941,178,195,121,40,17,71,124
"Brandon Rush","MIN",481,10564,468,1105,299,169,133,63,103,58,111
"Nenad Krstic","BOS",419,10551,346,815,223,123,97,24,102,27,96
"Dale Davis","DET",448,10521,430,974,316,114,123,52,141,33,81
"Malik Rose","OKC",585,10498,557,1232,439,118,275,77,87,57,61
"Jim Jackson","LAL",358,10451,865,1896,699,166,296,175,228,72,94
"Josh Childress","NOP",391,10427,609,1354,473,136,210,50,213,47,89
"D'Angelo Russell","MIN",359,10400,1910,4470,1260,650,936,189,135,158,492
"Jamal Murray","DEN",345,10384,1322,3133,833,489,471,242,120,98,391
"Ian Mahinmi","WAS",618,10351,357,850,221,136,113,38,70,33,103
"Anthony Carter","TOR",544,10304,1985,4377,1578,407,838,197,543,132,275
"Fred Jones","LAC",430,10290,990,2245,725,265,324,117,284,98,167
"Rodney Hood","TOR",396,10268,698,1685,409,289,268,73,68,85,204
"Corliss Williamson","SAC",485,10263,447,1029,312,135,160,58,94,55,80
"Karl Malone","LAL",284,10244,1244,2609,1123,121,674,113,336,28,93
"Brandon Ingram","NOP",313,10210,1105,2633,682,423,514,119,49,112,311
"Joe Harris","BKN",400,10178,665,1615,380,285,280,76,24,110,175
"Alex Len","WAS",530,10150,444,1066,266,178,146,51,69,37,141
"Adonal Foyle","ORL",558,10142,270,590,220,50,115,28,77,7,43
"Kelly Oubre Jr.","GSW",403,10051,400,936,264,136,139,73,52,25,111
"T.J. McConnell","IND",454,10038,2273,5445,1374,899,1011,196,167,232,667
"Jason Smith","NOP",616,10028,453,1043,316,137,136,59,121,37,100
"Terry Rozier","CHA",404,9981,1183,2885,664,519,416,148,100,139,380
"Greg Buckner","MEM",522,9964,664,1466,526,138,245,69,212,44,94
"Trey Burke","DAL",456,9962,1465,3386,1009,456,602,164,243,142,314
"Jarvis Hayes","BKN",427,9899,459,1037,340,119,163,62,115,46,73
"Michael Carter-Williams","ORL",391,9899,1701,3951,1152,549,657,207,288,118,431
"Brian Skinner","MEM",554,9886,276,617,211,65,92,31,88,14,51
"Jordan Farmar","SAC",504,9840,1453,3304,1055,398,504,199,352,148,250
"Dahntay Jones","CLE",624,9793,529,1204,383,146,198,53,132,35,111
"Doug McDermott","IND",476,9788,432,1000,296,136,169,67,60,37,99
"Mikki Moore","GSW",532,9750,393,901,278,115,112,21,145,32,83
"Langston Galloway","PHX",445,9733,720,1698,462,258,235,96,131,81,177
"Aaron McKie","LAL",371,9732,1156,2482,986,170,469,205,312,42,128
"Alvin Williams","LAC",301,9723,1518,3364,1190,328,466,194,530,109,219
"Domantas Sabonis","IND",353,9670,1170,2806,704,466,415,125,164,119,347
"Luke Walton","CLE",564,9667,1317,2884,1067,250,653,177,237,69,181
"Vlade Divac","LAL",337,9666,1253,2800,959,294,546,73,340,111,183
"Jumaine Jones","PHX",438,9639,403,890,319,84,141,66,112,28,56
"T.J. Warren","IND",332,9542,397,946,245,152,155,48,42,43,109
"Nerlens Noel","NYK",424,9524,468,1100,304,164,211,37,56,33,131
"Eric Williams","CHA",412,9522,595,1379,406,189,200,71,135,44,145
"Greivis Vasquez","BKN",401,9518,1935,4294,1511,424,820,287,404,116,308
"Solomon Hill","ATL",435,9514,650,1527,423,227,222,93,108,67,160
"Kevin Ollie","OKC",579,9500,1387,3108,1053,334,406,180,467,87,247
"Shandon Anderson","MIA",440,9499,574,1279,443,131,220,85,138,43,88
"Jayson Tatum","BOS",289,9452,772,1912,404,368,241,103,60,104,264
"Donovan Mitchell","UTA",278,9372,1184,2955,597,587,463,91,43,229,358
"Charlie Bell","GSW",376,9364,857,1949,622,235,299,104,219,88,147
"Michael Olowokandi","BOS",375,9362,264,632,160,104,62,24,74,11,93
"Jaylen Brown","BOS",337,9339,591,1411,362,229,220,85,57,71,158
"Ben Simmons","PHI",275,9326,2127,5250,1131,996,739,197,195,202,794
"Daniel Gibson","CLE",397,9315,775,1771,554,221,276,98,180,87,134
"Glenn Robinson","SAS",262,9255,690,1563,507,183,244,120,143,75,108
"Omer Asik","CHI",471,9217,280,648,192,88,99,20,73,27,61
"Darius Songaila","PHI",495,9216,589,1339,428,161,244,47,137,42,119
"Pascal Siakam","TOR",332,9202,881,2231,412,469,300,77,35,151,318
"Mike Scott","PHI",555,9182,499,1190,307,192,196,52,59,63,129
"Troy Hudson","GSW",422,9161,1410,3056,1174,236,453,223,498,68,168
"Allen Crabbe","MIN",381,9120,434,1035,267,167,157,60,50,46,121
"Kyle Anderson","MEM",436,9100,984,2275,677,307,431,154,92,87,220
"Willie Cauley-Stein","DAL",402,9092,588,1362,402,186,232,74,96,45,141
"Matthew Dellavedova","CLE",447,9073,1649,3811,1136,513,795,190,151,150,363
"Alonzo Gee","DEN",417,9069,441,1031,292,149,130,56,106,31,118
"Jason Kapono","LAL",509,9061,417,944,307,110,133,67,107,35,75
"JaMychal Green","DEN",420,9050,386,906,252,134,162,47,43,33,101
"Pat Garrity","ORL",431,9035,367,856,245,122,100,40,105,29,93
"Dario Saric","PHX",356,8952,699,1651,446,253,284,104,58,67,186
"Darrell Arthur","DEN",503,8943,409,935,292,117,179,57,56,31,86
"Sasha Vujacic","NYK",580,8905,748,1708,536,212,258,85,193,70,142
"Kristaps Porzingis","DAL",286,8905,418,1025,229,189,119,48,62,55,134
"Derrick Williams","LAL",428,8862,293,690,189,104,107,28,54,36,68
"Malcolm Brogdon","IND",297,8846,1384,3246,906,478,597,178,131,145,333
"Tyler Johnson","BKN",348,8617,806,1941,477,329,293,105,79,120,209
"Larry Nance Jr.","CLE",350,8487,666,1608,390,276,246,80,64,83,193
"De'Aaron Fox","SAC",263,8242,1675,4042,983,692,642,235,106,164,528
"Montrezl Harrell","LAL",387,8223,497,1202,289,208,174,59,56,64,144