,Name,TeamAbbreviation,GamesPlayed,Minutes,Assists,AssistPoints,TwoPtAssists,ThreePtAssists,AtRimAssists,ShortMidRangeAssists,LongMidRangeAssists,Corner3Assists,Arc3Assists,Season
0,Julius Randle,NYK,71,2667,427,1092,189,238,108,42,39,91,147,2021
1,RJ Barrett,NYK,72,2511,217,520,131,86,94,24,13,38,48,2021
2,Nikola Jokic,DEN,72,2488,599,1410,387,212,263,75,49,81,131,2021
3,Buddy Hield,SAC,71,2433,257,579,192,65,121,52,19,26,39,2021
4,Damian Lillard,POR,67,2398,505,1256,259,246,200,36,23,66,180,2021
5,Terry Rozier,CHA,69,2383,293,720,159,134,110,38,11,45,89,2021
6,Russell Westbrook,WAS,65,2369,763,1767,522,241,286,175,61,77,164,2021
7,Andrew Wiggins,GSW,71,2364,167,428,73,94,43,23,7,25,69,2021
8,Nikola Vucevic,CHI,70,2348,269,661,146,123,87,32,27,37,86,2021
9,Mikal Bridges,PHX,72,2348,152,361,95,57,60,24,11,22,35,2021
10,Anthony Edwards,MIN,72,2314,211,528,105,106,79,17,9,25,81,2021
11,Jayson Tatum,BOS,64,2290,276,696,132,144,73,43,16,43,101,2021
12,Devin Booker,PHX,67,2270,289,716,151,138,105,33,13,65,73,2021
13,Khris Middleton,MIL,68,2269,370,873,237,133,180,47,10,40,93,2021
14,Duncan Robinson,MIA,72,2262,127,294,87,40,64,20,3,11,29,2021
15,Luka Doncic,DAL,66,2254,567,1375,326,241,244,49,33,82,159,2021
16,Robert Covington,POR,70,2243,117,299,52,65,42,8,2,13,52,2021
17,Royce O'Neale,UTA,71,2241,181,478,65,116,52,13,0,42,74,2021
18,Domantas Sabonis,IND,62,2232,415,1008,237,178,163,44,30,33,145,2021
19,Bojan Bogdanovic,UTA,72,2216,136,352,56,80,43,11,2,35,45,2021
20,Norman Powell,POR,69,2205,129,325,62,67,47,11,4,15,52,2021
21,Chris Paul,PHX,70,2199,622,1484,382,240,220,113,49,73,167,2021
22,Rudy Gobert,UTA,71,2187,89,233,34,55,19,12,3,23,32,2021
23,Justin Holiday,IND,72,2183,119,283,74,45,51,19,4,14,31,2021
24,Isaac Okoro,CLE,67,2173,128,318,66,62,39,21,6,18,44,2021
25,Coby White,CHI,69,2156,328,806,178,150,97,54,27,49,101,2021
26,Stephen Curry,GSW,63,2152,363,843,246,117,187,45,14,64,53,2021
27,Bradley Beal,WAS,60,2147,265,617,178,87,94,65,19,24,63,2021
28,Bam Adebayo,MIA,64,2143,346,873,165,181,129,25,11,30,151,2021
29,Joe Harris,BKN,69,2141,130,319,71,59,52,14,5,28,31,2021
30,Dejounte Murray,SAS,67,2139,363,847,242,121,128,66,48,37,84,2021
31,Kevin Huerter,ATL,69,2126,241,575,148,93,98,40,10,30,63,2021
32,Trae Young,ATL,63,2125,594,1403,379,215,289,67,23,70,145,2021
33,Collin Sexton,CLE,60,2115,262,623,163,99,109,47,7,19,80,2021
34,Deandre Ayton,PHX,69,2115,99,238,59,40,27,23,9,12,28,2021
35,Eric Bledsoe,NOP,71,2111,268,629,175,93,127,37,11,32,61,2021
36,Harrison Barnes,SAC,58,2102,201,497,106,95,48,41,17,41,54,2021
37,Brandon Ingram,NOP,61,2093,296,701,187,109,148,31,8,33,76,2021
38,DeMar DeRozan,SAS,61,2056,422,1044,222,200,131,56,35,53,147,2021
39,Ja Morant,MEM,63,2053,465,1106,289,176,174,97,18,66,110,2021
40,Jae'Sean Tate,HOU,70,2043,178,460,74,104,60,10,4,26,78,2021
41,De'Aaron Fox,SAC,58,2036,417,1003,248,169,157,79,12,41,128,2021
42,Zach LaVine,CHI,58,2034,282,677,169,113,98,58,13,42,71,2021
43,Zion Williamson,NOP,61,2026,226,569,109,117,61,23,25,40,77,2021
44,Tobias Harris,PHI,62,2014,220,539,121,99,74,32,15,31,68,2021
45,Giannis Antetokounmpo,MIL,61,2013,357,926,145,212,88,30,27,56,156,2021
46,Pascal Siakam,TOR,56,2006,250,647,103,147,68,24,11,40,107,2021
47,Jaylen Brown,BOS,58,1999,195,464,121,74,77,32,12,27,47,2021
48,Kelly Olynyk,HOU,70,1997,203,486,123,80,101,18,4,28,52,2021
49,Dillon Brooks,MEM,67,1997,157,358,113,44,66,46,1,17,27,2021
50,Tim Hardaway Jr.,DAL,70,1989,126,309,69,57,44,12,13,14,43,2021
51,Patrick Williams,CHI,71,1983,99,245,52,47,36,9,7,17,30,2021
52,Draymond Green,GSW,63,1982,558,1330,344,214,257,62,25,49,165,2021
53,Keldon Johnson,SAS,69,1968,121,280,83,38,51,17,15,9,29,2021
54,Dennis Schroder,LAL,61,1956,351,853,200,151,129,50,21,33,118,2021
55,Kyle Kuzma,LAL,68,1954,127,304,77,50,55,15,7,12,38,2021
56,P.J. Washington,CHA,64,1954,161,401,82,79,53,12,17,18,61,2021
57,Reggie Bullock,NYK,65,1949,99,238,59,40,39,11,9,10,30,2021
58,Danny Green,PHI,69,1934,118,273,81,37,51,21,9,15,22,2021
59,Miles Bridges,CHA,66,1932,147,363,78,69,58,12,8,26,43,2021
60,Malcolm Brogdon,IND,56,1930,329,791,196,133,153,35,8,39,94,2021
61,Dorian Finney-Smith,DAL,60,1915,102,251,55,47,34,11,10,11,36,2021
62,Michael Porter Jr.,DEN,61,1912,70,168,42,28,17,21,4,6,22,2021
63,Saddiq Bey,DET,70,1909,95,236,49,46,33,10,6,12,34,2021
64,Jrue Holiday,MIL,59,1907,357,856,215,142,131,53,31,39,103,2021
65,Kentavious Caldwell-Pope,LAL,67,1902,127,305,76,51,62,11,3,16,35,2021
66,Brook Lopez,MIL,70,1902,50,125,25,25,14,5,6,3,22,2021
67,Fred VanVleet,TOR,52,1899,328,825,159,169,107,35,17,58,111,2021
68,Clint Capela,ATL,63,1898,49,119,28,21,13,11,4,10,11,2021
69,Kyle Anderson,MEM,69,1887,250,575,175,75,114,51,10,22,53,2021
70,Kyrie Irving,BKN,54,1886,324,780,192,132,140,36,16,38,94,2021
71,Ben Simmons,PHI,58,1877,401,1010,193,208,93,62,38,69,139,2021
72,Joe Ingles,UTA,67,1867,318,777,177,141,135,38,4,58,83,2021
73,Jarrett Allen,CLE,63,1864,106,256,62,44,37,15,10,11,33,2021
74,Dwayne Bacon,ORL,72,1853,93,232,47,46,23,8,16,9,37,2021
75,John Collins,ATL,63,1848,78,188,46,32,26,14,6,9,23,2021
76,Jakob Poeltl,SAS,69,1845,134,304,98,36,45,29,24,8,28,2021
77,Jeff Green,BKN,68,1835,108,280,44,64,28,9,7,14,50,2021
78,Nicolas Batum,LAC,67,1835,148,354,90,58,46,29,15,25,33,2021
79,Jerami Grant,DET,54,1829,152,362,94,58,67,19,8,20,38,2021
80,Paul George,LAC,54,1821,280,693,147,133,99,27,21,43,90,2021
81,Jordan Clarkson,UTA,68,1818,168,418,86,82,60,20,6,28,54,2021
82,Donte DiVincenzo,MIL,66,1814,203,472,137,66,96,25,16,24,42,2021
83,Gary Trent Jr.,TOR,58,1802,80,200,40,40,21,12,7,9,31,2021
84,Rui Hachimura,WAS,57,1797,82,203,43,39,20,14,9,8,31,2021
85,T.J. McConnell,IND,69,1796,456,1093,275,181,221,44,10,51,130,2021
86,Josh Richardson,DAL,59,1795,153,391,68,85,43,16,9,24,61,2021
87,Darius Garland,CLE,54,1790,329,747,240,89,184,46,10,27,62,2021
88,Richaun Holmes,SAC,61,1782,101,240,63,38,44,14,5,15,23,2021
89,Theo Maledon,OKC,65,1778,227,560,121,106,87,25,9,31,75,2021
90,Kawhi Leonard,LAC,52,1773,269,695,112,157,62,29,21,55,102,2021
91,Ricky Rubio,MIN,68,1772,433,1033,266,167,202,50,14,42,125,2021
92,Donovan Mitchell,UTA,53,1771,277,699,132,145,102,29,1,49,96,2021
93,Enes Kanter,POR,72,1758,84,213,39,45,21,5,13,7,38,2021
94,Jonas Valanciunas,MEM,62,1755,112,255,81,31,34,30,17,3,28,2021
95,Delon Wright,SAC,63,1748,278,703,131,147,83,36,12,44,103,2021
96,Lonzo Ball,NOP,55,1747,316,717,231,85,170,38,23,22,63,2021
97,Tyrese Haliburton,SAC,58,1746,309,721,206,103,128,62,16,31,72,2021
98,Jimmy Butler,MIA,52,1745,369,893,214,155,153,46,15,43,112,2021
99,Will Barton,DEN,56,1736,181,424,119,62,58,47,14,16,46,2021
100,Darius Bazley,OKC,55,1714,99,245,52,47,39,6,7,14,33,2021
101,Jamal Murray,DEN,48,1704,231,553,140,91,79,41,20,17,74,2021
102,Jalen Brunson,DAL,68,1697,239,602,115,124,64,26,25,35,89,2021
103,Carmelo Anthony,POR,69,1690,104,261,51,53,36,6,9,16,37,2021
104,Karl-Anthony Towns,MIN,50,1689,225,548,127,98,95,20,12,34,64,2021
105,Kelly Oubre Jr.,GSW,55,1687,73,173,46,27,23,13,10,8,19,2021
106,Patty Mills,SAS,68,1685,162,373,113,49,65,28,20,7,42,2021
107,Devonte' Graham,CHA,55,1659,295,713,172,123,129,33,10,41,82,2021
108,Thaddeus Young,CHI,68,1652,291,685,188,103,124,36,28,37,66,2021
109,Kendrick Nunn,MIA,56,1650,148,344,100,48,71,21,8,10,38,2021
110,Jae Crowder,PHX,60,1648,127,297,84,43,55,20,9,23,20,2021
111,Seth Curry,PHI,57,1638,155,366,99,56,58,27,14,22,34,2021
112,Tyler Herro,MIA,54,1635,184,451,101,83,79,18,4,25,58,2021
113,Doug McDermott,IND,66,1619,85,201,54,31,28,20,6,14,17,2021
114,James Harden,BKN,44,1609,475,1113,312,163,234,55,23,49,114,2021
115,Ivica Zubac,LAC,72,1609,90,219,51,39,23,12,16,13,26,2021
116,Steven Adams,NOP,58,1605,111,256,77,34,39,12,26,3,31,2021
117,Kyle Lowry,TOR,46,1601,338,816,198,140,150,35,13,42,98,2021
118,Daniel Theis,CHI,65,1601,108,257,67,41,39,20,8,9,32,2021
119,CJ McCollum,POR,47,1600,223,562,107,116,75,19,13,27,89,2021
120,Joel Embiid,PHI,51,1585,145,350,85,60,38,28,19,20,40,2021
121,Marcus Smart,BOS,48,1581,273,658,161,112,112,30,19,27,85,2021
122,Montrezl Harrell,LAL,69,1580,73,174,45,28,24,11,10,5,23,2021
123,Pat Connaughton,MIL,69,1575,81,195,48,33,34,10,4,12,21,2021
124,Josh Jackson,DET,62,1560,143,331,98,45,83,11,4,12,33,2021
125,Nerlens Noel,NYK,64,1547,46,106,32,14,18,4,10,3,11,2021
126,Reggie Jackson,LAC,67,1544,205,513,102,103,53,27,22,41,62,2021
127,Luguentz Dort,OKC,52,1543,88,218,46,42,33,11,2,5,37,2021
128,Khem Birch,TOR,67,1529,89,225,42,47,14,15,13,11,36,2021
129,Garrett Temple,CHI,56,1528,124,292,80,44,48,25,7,11,33,2021
130,Lonnie Walker IV,SAS,60,1522,101,239,64,37,43,11,10,11,26,2021
131,Desmond Bane,MEM,68,1519,118,287,67,51,40,20,7,18,33,2021
132,Solomon Hill,ATL,71,1513,75,183,42,33,25,13,4,10,23,2021
133,Jaden McDaniels,MIN,63,1511,71,178,35,36,26,7,2,4,32,2021
134,Cedi Osman,CLE,59,1511,174,415,107,67,80,25,2,24,43,2021
135,LeBron James,LAL,45,1504,350,837,213,137,163,37,13,53,84,2021
136,Marcus Morris Sr.,LAC,57,1502,58,146,28,30,23,4,1,11,19,2021
137,Mason Plumlee,DET,56,1499,202,500,106,96,73,19,14,22,74,2021
138,Mike Conley,UTA,51,1498,305,768,147,158,118,24,5,51,107,2021
139,Gordon Hayward,CHA,44,1496,181,443,100,81,74,23,3,22,59,2021
140,Caris LeVert,IND,47,1485,245,584,151,94,112,27,12,15,79,2021
141,Elfrid Payton,NYK,63,1484,203,486,123,80,85,17,21,27,53,2021
142,LaMelo Ball,CHA,51,1469,313,733,206,107,159,31,16,23,84,2021
143,Davis Bertans,WAS,57,1464,49,110,37,12,21,7,9,5,7,2021
144,Shake Milton,PHI,63,1461,193,478,101,92,57,36,8,37,55,2021
145,Myles Turner,IND,47,1455,48,112,32,16,24,6,2,6,10,2021
146,Isaiah Stewart,DET,68,1455,59,142,35,24,16,8,11,3,21,2021
147,Chris Boucher,TOR,60,1453,63,157,32,31,25,3,4,5,26,2021
148,Bruce Brown,BKN,65,1451,104,265,47,57,34,8,5,22,35,2021
149,Cory Joseph,DET,63,1446,213,512,127,86,64,49,14,29,57,2021
150,Cameron Johnson,PHX,60,1437,86,210,48,38,24,19,5,20,18,2021
151,OG Anunoby,TOR,43,1433,94,236,46,48,35,9,2,11,37,2021
152,Kenrich Williams,OKC,66,1426,152,367,89,63,54,27,8,20,43,2021
153,Isaiah Roby,OKC,61,1425,107,253,68,39,44,15,9,9,30,2021
154,Facundo Campazzo,DEN,65,1425,232,575,121,111,74,30,17,27,84,2021
155,Lou Williams,ATL,66,1423,225,540,135,90,105,18,12,37,53,2021
156,Brandon Clarke,MEM,59,1415,95,221,64,31,30,27,7,8,23,2021
157,Raul Neto,WAS,64,1403,146,345,93,53,57,26,10,10,43,2021
158,Landry Shamet,BKN,61,1403,99,240,57,42,40,15,2,14,28,2021
159,Aaron Gordon,DEN,50,1384,161,382,101,60,55,25,21,17,43,2021
160,Wendell Carter Jr.,ORL,54,1375,104,252,60,44,23,15,22,6,38,2021
161,Bobby Portis,MIL,66,1372,71,183,30,41,21,5,4,10,31,2021
162,Kemba Walker,BOS,43,1369,212,514,122,90,67,39,16,29,61,2021
163,Rudy Gay,SAS,63,1358,88,208,56,32,32,14,10,10,22,2021
164,P.J. Tucker,MIL,52,1356,61,157,26,35,21,3,2,5,30,2021
165,Bryn Forbes,MIL,70,1354,45,115,20,25,13,4,3,11,14,2021
166,Robin Lopez,WAS,71,1354,55,135,30,25,15,11,4,4,21,2021
167,Josh Hart,NOP,47,1349,109,264,63,46,45,12,6,18,28,2021
168,Bismack Biyombo,CHA,66,1349,81,187,56,25,21,23,12,7,18,2021
169,Naz Reid,MIN,70,1347,72,177,39,33,24,12,3,11,22,2021
170,Terrence Ross,ORL,46,1347,108,257,67,41,32,23,12,11,30,2021
171,Maxi Kleber,DAL,50,1341,68,172,32,36,15,12,5,8,28,2021
172,Andre Iguodala,MIA,63,1339,142,349,77,65,60,12,5,20,45,2021
173,Goran Dragic,MIA,50,1337,219,535,122,97,85,25,12,37,60,2021
174,Kent Bazemore,GSW,67,1334,108,261,63,45,41,12,10,10,35,2021
175,Kristaps Porzingis,DAL,43,1327,68,172,32,36,20,6,6,9,27,2021
176,Christian Wood,HOU,41,1326,71,178,35,36,28,6,1,11,25,2021
177,Svi Mykhailiuk,OKC,66,1324,110,268,62,48,46,11,5,15,33,2021
178,Derrick Jones Jr.,POR,58,1318,47,120,21,26,12,3,6,6,20,2021
179,Lauri Markkanen,CHI,51,1317,45,110,25,20,14,8,3,7,13,2021
180,Tomas Satoransky,CHI,58,1307,271,642,171,100,123,37,11,28,72,2021
181,Bogdan Bogdanovic,ATL,44,1305,147,357,84,63,59,23,2,15,48,2021
182,Talen Horton-Tucker,LAL,65,1304,181,419,124,57,85,24,15,22,35,2021
183,Matisse Thybulle,PHI,65,1298,63,151,38,25,20,11,7,5,20,2021
184,John Wall,HOU,40,1288,275,686,139,136,108,25,6,49,87,2021
185,Tristan Thompson,BOS,54,1287,67,165,36,31,16,11,9,3,28,2021
186,Derrick Rose,NYK,50,1279,209,520,107,102,69,24,14,39,63,2021
187,Cole Anthony,ORL,47,1273,192,457,119,73,50,42,27,8,65,2021
188,Payton Pritchard,BOS,66,1268,120,286,74,46,41,23,10,10,36,2021
189,Terance Mann,LAC,67,1263,104,262,50,54,32,13,5,20,34,2021
190,Grayson Allen,MEM,50,1259,108,258,66,42,38,20,8,17,25,2021
191,Evan Fournier,BOS,42,1259,144,352,80,64,36,27,17,13,51,2021
192,Deni Avdija,WAS,54,1257,63,145,44,19,19,18,7,4,15,2021
193,Alec Burks,NYK,49,1255,107,260,61,46,43,10,8,19,27,2021
194,DeAndre Jordan,BKN,57,1246,93,217,62,31,29,21,12,4,27,2021
195,Immanuel Quickley,NYK,64,1243,127,310,71,56,49,13,9,18,38,2021
196,Andre Drummond,LAL,46,1242,94,217,65,29,41,20,4,12,17,2021
197,Luke Kennard,LAC,63,1232,104,264,48,56,33,13,2,21,35,2021
198,Sterling Brown,HOU,51,1229,72,178,38,34,33,4,1,14,20,2021
199,Hamidou Diallo,DET,52,1226,101,248,55,46,37,10,8,9,37,2021
200,Tyus Jones,MEM,70,1222,259,618,159,100,77,73,9,37,63,2021
201,Danilo Gallinari,ATL,51,1222,76,188,40,36,21,14,5,11,25,2021
202,Alex Caruso,LAL,58,1216,160,383,97,63,75,14,8,18,45,2021
203,Malik Beasley,MIN,37,1214,88,212,52,36,37,9,6,13,23,2021
204,Dean Wade,CLE,63,1212,74,176,46,28,29,11,6,5,23,2021
205,Markieff Morris,LAL,61,1200,73,179,40,33,29,8,3,10,23,2021
206,Josh Okogie,MIN,59,1197,63,149,40,23,31,5,4,7,16,2021
207,D'Angelo Russell,MIN,42,1196,244,584,148,96,119,24,5,18,78,2021
208,Monte Morris,DEN,47,1196,150,376,74,76,38,24,12,16,60,2021
209,Dwight Howard,PHI,69,1196,61,138,45,16,20,11,14,3,13,2021
210,Blake Griffin,BKN,46,1187,140,353,67,73,46,10,11,9,64,2021
211,Shai Gilgeous-Alexander,OKC,35,1180,207,523,98,109,76,13,9,34,75,2021
212,Aaron Holiday,IND,66,1176,123,293,76,47,52,15,9,19,28,2021
213,Paul Millsap,DEN,56,1162,98,240,54,44,33,13,8,13,31,2021
214,Anthony Davis,LAL,36,1162,110,266,64,46,43,11,10,15,31,2021
215,Kevon Looney,GSW,61,1161,119,299,58,61,26,17,15,13,48,2021
216,Kevin Durant,BKN,35,1157,195,459,126,69,91,30,5,18,51,2021
217,Georges Niang,UTA,72,1154,59,139,38,21,28,6,4,5,16,2021
218,Jarred Vanderbilt,MIN,64,1139,76,188,40,36,30,6,4,10,26,2021
219,Grant Williams,BOS,63,1138,64,166,26,38,22,4,0,6,32,2021
220,Chuma Okeke,ORL,45,1133,101,243,60,41,30,18,12,10,31,2021
221,Wesley Matthews,LAL,58,1130,54,129,33,21,18,12,3,4,17,2021
222,D.J. Augustin,HOU,57,1129,188,444,120,68,83,19,18,20,48,2021
223,JaMychal Green,DEN,58,1120,53,133,26,27,18,5,3,9,18,2021
224,Marvin Bagley III,SAC,43,1112,43,106,23,20,15,6,2,6,14,2021
225,Juan Toscano-Anderson,GSW,53,1107,150,367,83,67,63,13,7,17,50,2021
226,Anfernee Simons,POR,64,1104,89,232,35,54,14,8,13,12,42,2021
227,Larry Nance Jr.,CLE,35,1091,107,256,65,42,45,16,4,18,24,2021
228,Aleksej Pokusevski,OKC,45,1090,97,232,59,38,38,15,6,12,26,2021
229,PJ Dozier,DEN,50,1088,92,222,54,38,34,13,7,17,21,2021
230,Xavier Tillman,MEM,59,1085,75,183,42,33,13,18,11,8,25,2021
231,Gary Harris,ORL,39,1080,78,194,40,38,27,7,6,12,26,2021
232,Victor Oladipo,MIA,33,1080,151,373,80,71,65,14,1,12,59,2021
233,Cameron Payne,PHX,60,1080,217,534,117,100,71,34,12,30,70,2021
234,Damion Lee,GSW,57,1079,73,178,41,32,23,14,4,13,19,2021
235,Terence Davis,SAC,61,1074,83,202,47,36,31,12,4,13,23,2021
236,Kenyon Martin Jr.,HOU,45,1068,48,125,19,29,15,1,3,7,22,2021
237,Derrick White,SAS,36,1064,127,289,92,35,53,24,15,7,28,2021
238,Furkan Korkmaz,PHI,55,1062,82,195,51,31,35,9,7,12,19,2021
239,Devin Vassell,SAS,62,1056,56,138,30,26,19,7,4,4,22,2021
240,Brad Wanamaker,CHA,61,1053,174,431,91,83,58,23,10,22,61,2021
241,Timothe Luwawu-Cabarrot,BKN,58,1050,69,165,42,27,28,11,3,14,13,2021
242,James Johnson,NOP,51,1048,98,238,56,42,31,19,6,9,33,2021
243,De'Anthony Melton,MEM,52,1045,132,307,89,43,49,32,8,14,29,2021
244,Derrick Favors,UTA,68,1039,44,124,8,36,2,5,1,10,26,2021
245,Garrison Mathews,WAS,64,1038,26,65,13,13,8,4,1,5,8,2021
246,Denzel Valentine,CHI,62,1036,105,257,58,47,42,11,5,17,30,2021
247,Wayne Ellington,DET,46,1012,67,158,43,24,34,4,5,11,13,2021
248,Nickeil Alexander-Walker,NOP,46,1007,102,233,73,29,62,8,3,3,26,2021
249,Stanley Johnson,TOR,61,1006,89,220,47,42,32,14,1,9,33,2021
250,Cody Zeller,CHA,48,1005,86,212,46,40,26,9,11,15,25,2021
251,Marc Gasol,LAL,52,993,109,252,75,34,57,13,5,13,21,2021
252,Tony Snell,ATL,47,992,59,147,30,29,16,10,4,7,22,2021
253,Jordan Poole,GSW,51,988,99,241,56,43,40,11,5,6,37,2021
254,James Ennis III,ORL,41,986,62,142,44,18,27,8,9,5,13,2021
255,Robert Williams III,BOS,52,985,94,233,49,45,24,15,10,9,36,2021
256,Aron Baynes,TOR,53,980,47,116,25,22,13,3,9,6,16,2021
257,Alex Len,WAS,64,979,49,123,24,25,9,9,6,4,21,2021
258,DeAndre' Bembry,TOR,51,972,107,266,55,52,39,13,3,16,36,2021
259,Dwight Powell,DAL,58,966,63,152,37,26,15,8,14,5,21,2021
260,Jaxson Hayes,NOP,60,964,35,85,20,15,11,3,6,2,13,2021
261,Serge Ibaka,LAC,41,955,74,185,37,37,17,12,8,16,21,2021
262,Jeff Teague,MIL,55,950,132,311,85,47,39,29,17,9,38,2021
263,Semi Ojeleye,BOS,56,950,37,86,25,12,14,9,2,2,10,2021
264,Rodney Hood,TOR,55,943,53,140,19,34,10,6,3,3,31,2021
265,Jordan McLaughlin,MIN,51,938,193,461,118,75,88,21,9,21,54,2021
266,Taj Gibson,NYK,45,936,36,86,22,14,11,6,5,5,9,2021
267,Tyrese Maxey,PHI,61,935,120,291,69,51,48,12,9,12,39,2021
268,Danuel House Jr.,HOU,36,932,69,180,27,42,22,4,1,21,21,2021
269,Malachi Flynn,TOR,47,928,137,336,75,62,48,21,6,16,46,2021
270,Ish Smith,WAS,44,924,172,416,100,72,69,23,8,18,54,2021
271,Moses Brown,OKC,43,920,10,23,7,3,1,3,3,0,3,2021
272,Trey Burke,DAL,62,914,81,203,40,41,29,6,5,12,29,2021
273,Damyean Dotson,CLE,46,907,91,215,58,33,46,10,2,8,25,2021
274,Willie Cauley-Stein,DAL,53,906,35,86,19,16,9,5,5,1,15,2021
275,Taurean Prince,CLE,41,905,76,173,55,21,42,6,7,8,13,2021
276,Ben McLemore,LAL,53,905,39,93,24,15,19,2,3,3,12,2021
277,Kira Lewis Jr.,NOP,54,904,124,292,80,44,61,16,3,15,29,2021
278,Jalen McDaniels,CHA,47,904,53,135,24,29,15,6,3,9,20,2021
279,Juancho Hernangomez,MIN,52,900,35,88,17,18,11,5,1,5,13,2021
280,R.J. Hampton,ORL,51,888,87,210,51,36,34,13,4,10,26,2021
281,Jusuf Nurkic,POR,37,880,125,302,73,52,46,15,12,15,37,2021
282,Malik Monk,CHA,42,878,87,207,54,33,42,9,3,11,22,2021
283,Dario Saric,PHX,50,871,65,156,39,26,21,10,8,9,17,2021
284,Sekou Doumbouya,DET,56,869,47,112,29,18,22,4,3,1,17,2021
285,Edmond Sumner,IND,53,861,49,123,24,25,16,5,3,10,15,2021
286,Mitchell Robinson,NYK,31,853,17,38,13,4,3,3,7,0,4,2021
287,Mike Scott,PHI,51,852,40,100,20,20,10,5,5,10,10,2021
288,Cody Martin,CHA,52,849,86,207,51,35,36,10,5,11,24,2021
289,Willy Hernangomez,NOP,47,846,50,120,30,20,13,8,9,4,16,2021
290,Austin Rivers,DEN,36,845,81,197,46,35,23,14,9,10,25,2021
291,Trevor Ariza,MIA,30,841,55,133,32,23,22,7,3,8,15,2021
292,Chasson Randle,ORL,41,837,74,175,47,27,24,16,7,5,22,2021
293,James Wiseman,GSW,39,836,26,65,13,13,5,6,2,2,11,2021
294,Kevin Porter Jr.,HOU,26,835,164,386,106,58,84,18,4,8,50,2021
295,Patrick Beverley,LAC,37,832,76,186,42,34,22,4,16,17,17,2021
296,Caleb Martin,CHA,53,818,67,164,37,30,30,4,3,9,21,2021
297,Torrey Craig,PHX,50,803,49,118,29,20,14,10,5,3,17,2021
298,Michael Carter-Williams,ORL,31,800,129,313,74,55,33,23,18,5,50,2021
299,Daniel Gafford,WAS,54,791,29,66,21,8,10,4,7,1,7,2021
300,Eric Gordon,HOU,27,789,71,173,40,31,33,7,0,9,22,2021
301,Ty Jerome,OKC,33,788,120,290,70,50,51,13,6,14,36,2021
302,Al Horford,OKC,28,782,94,228,54,40,39,11,4,10,30,2021
303,Saben Lee,DET,48,781,174,422,100,74,68,19,13,22,52,2021
304,Maurice Harkless,MIA,37,772,44,107,25,19,17,7,1,5,14,2021
305,Rajon Rondo,LAC,45,769,199,496,101,98,62,22,17,25,73,2021
306,Mychal Mulder,GSW,60,766,26,65,13,13,7,2,4,1,12,2021
307,Jeremy Lamb,IND,36,765,53,126,33,20,21,8,4,7,13,2021
308,Jaylen Nowell,MIN,42,759,62,154,32,30,24,7,1,12,18,2021
309,Drew Eubanks,SAS,54,755,42,97,29,13,11,6,12,4,9,2021
310,Cam Reddish,ATL,26,750,35,83,22,13,17,4,1,3,10,2021
311,Frank Jackson,DET,40,738,36,90,18,18,14,2,2,4,14,2021
312,Precious Achiuwa,MIA,61,737,29,79,8,21,4,4,0,9,12,2021
313,Mo Bamba,ORL,46,725,35,84,21,14,13,6,2,3,11,2021
314,JJ Redick,DAL,44,723,51,113,40,11,33,5,2,1,10,2021
315,Yuta Watanabe,TOR,50,723,40,96,24,16,16,8,0,6,10,2021
316,Moritz Wagner,ORL,45,722,50,125,25,25,17,7,1,3,22,2021
317,Jevon Carter,PHX,60,717,71,177,36,35,20,11,5,10,25,2021
318,Frank Kaminsky,PHX,47,715,79,188,49,30,27,14,8,14,16,2021
319,DeMarcus Cousins,LAC,41,713,76,187,41,35,27,6,8,13,22,2021
320,Naji Marshall,NOP,32,700,88,199,65,23,44,16,5,6,17,2021
321,Eric Paschall,GSW,40,695,51,139,14,37,6,6,2,12,25,2021
322,Tony Bradley,OKC,42,684,37,82,29,8,13,8,8,2,6,2021
323,Tyler Johnson,BKN,39,684,47,112,29,18,22,4,3,8,10,2021
324,Obi Toppin,NYK,62,683,29,77,10,19,5,1,4,3,16,2021
325,David Nwaba,HOU,30,679,31,79,14,17,13,1,0,5,12,2021
326,JaVale McGee,DEN,46,678,39,89,28,11,17,6,5,1,10,2021
327,De'Andre Hunter,ATL,23,678,44,109,23,21,18,4,1,4,17,2021
328,LaMarcus Aldridge,BKN,26,674,49,124,23,26,14,4,5,4,22,2021
329,George Hill,PHI,30,672,73,176,43,30,28,10,5,8,22,2021
330,Killian Hayes,DET,26,670,138,333,81,57,64,14,3,16,41,2021
331,Aaron Nesmith,BOS,46,669,23,54,15,8,10,3,2,2,6,2021
332,Gabe Vincent,MIA,50,655,67,159,42,25,30,10,2,7,18,2021
333,Gary Clark,PHI,39,654,31,76,17,14,6,6,5,0,14,2021
334,Mike Muscala,OKC,35,645,28,67,17,11,15,1,1,1,10,2021
335,Nassir Little,POR,48,640,23,61,8,15,3,2,3,5,10,2021
336,Jake Layman,MIN,45,627,28,66,18,10,11,5,2,5,5,2021
337,Kevin Love,CLE,25,622,63,146,43,20,31,10,2,4,16,2021
338,Brandon Goodwin,ATL,47,620,95,229,56,39,26,18,12,8,31,2021
339,Otto Porter Jr.,ORL,28,607,55,129,36,19,23,10,3,6,13,2021
340,Avery Bradley,HOU,27,602,46,110,28,18,20,7,1,8,10,2021
341,Onyeka Okongwu,ATL,50,601,18,47,7,11,2,2,3,3,8,2021
342,Nemanja Bjelica,MIA,37,595,69,169,38,31,26,8,4,15,16,2021
343,Nicolas Claxton,BKN,32,594,28,68,16,12,7,8,1,1,11,2021
344,Patrick Patterson,LAC,38,582,29,74,13,16,8,3,2,7,9,2021
345,Justin Jackson,MIL,34,577,52,131,25,27,18,3,4,8,19,2021
346,John Konchar,MEM,43,575,47,123,18,29,11,6,1,7,22,2021
347,Nicolo Melli,DAL,45,566,44,112,20,24,13,5,2,4,20,2021
348,Goga Bitadze,IND,45,561,37,85,26,11,15,5,6,1,10,2021
349,Isaiah Hartenstein,CLE,46,559,55,130,35,20,18,13,4,8,12,2021
350,Gorgui Dieng,SAS,38,553,48,111,33,15,18,7,8,2,13,2021
351,Thanasis Antetokounmpo,MIL,57,551,46,118,20,26,10,2,8,6,20,2021
352,Hassan Whiteside,SAC,36,546,20,50,10,10,7,1,2,3,7,2021
353,Damian Jones,SAC,39,546,29,75,12,17,2,7,3,5,12,2021
354,Wes Iwundu,DAL,41,535,18,42,12,6,11,1,0,1,5,2021
355,Troy Brown Jr.,CHI,34,523,29,70,17,12,7,6,4,2,10,2021
356,Armoni Brooks,HOU,20,520,30,75,15,15,12,3,0,3,12,2021
357,Miye Oni,UTA,54,519,28,79,5,23,3,2,0,12,11,2021
358,Oshae Brissett,IND,21,519,18,47,7,11,5,2,0,4,7,2021
359,Dylan Windler,CLE,31,513,33,80,19,14,12,7,0,3,11,2021
360,Justise Winslow,MEM,26,507,50,116,34,16,19,11,4,5,11,2021
361,Max Strus,MIA,39,507,24,58,14,10,10,4,0,3,7,2021
362,Jarrett Culver,MIN,34,499,24,61,11,13,4,6,1,2,11,2021
363,Lamar Stevens,CLE,40,499,25,63,12,13,6,3,3,5,8,2021
364,DaQuan Jeffries,HOU,31,493,22,56,10,12,8,2,0,3,9,2021
365,Chimezie Metu,SAC,36,488,28,68,16,12,9,7,0,5,7,2021
366,Javonte Green,CHI,41,474,17,41,10,7,8,2,0,2,5,2021
367,Kevin Knox II,NYK,42,464,19,46,11,8,7,3,1,1,7,2021
368,Ryan Arcidiacono,CHI,44,450,56,130,38,18,17,18,3,3,15,2021
369,KZ Okpala,MIA,37,447,19,48,9,10,7,2,0,4,6,2021
370,Josh Green,DAL,39,445,28,70,14,14,12,0,2,4,10,2021
371,Langston Galloway,PHX,40,438,26,63,15,11,6,7,2,7,4,2021
372,Tyler Cook,DET,32,437,17,41,10,7,5,4,1,0,7,2021
373,Al-Farouq Aminu,CHI,23,434,31,75,18,13,9,6,3,3,10,2021
374,D.J. Wilson,HOU,35,433,23,57,12,11,10,2,0,3,8,2021
375,Isaac Bonga,WAS,40,432,23,52,17,6,7,8,2,3,3,2021
376,Dennis Smith Jr.,DET,23,420,77,182,49,28,40,7,2,6,22,2021
377,Anthony Lamb,HOU,24,415,23,59,10,13,7,2,1,3,10,2021
378,Brodric Thomas,CLE,32,399,30,70,20,10,14,3,3,4,6,2021
379,Zeke Nnaji,DEN,42,397,10,23,7,3,5,2,0,0,3,2021
380,Amir Coffey,LAC,44,394,22,56,10,12,5,3,2,7,5,2021
381,Freddie Gillespie,TOR,20,392,9,18,9,0,5,2,2,0,0,2021
382,E'Twaun Moore,PHX,27,389,40,93,27,13,20,4,3,2,11,2021
383,Isaiah Joe,PHI,41,383,20,46,14,6,9,3,2,0,6,2021
384,Glenn Robinson III,SAC,23,369,20,50,10,10,8,2,0,1,9,2021
385,Nico Mannion,GSW,30,364,70,168,42,28,27,8,7,4,24,2021
386,Trey Lyles,SAS,23,358,14,31,11,3,7,2,2,1,2,2021
387,Abdel Nader,PHX,24,355,19,44,13,6,9,1,3,4,2,2021
388,Harry Giles III,POR,38,348,29,73,14,15,9,1,4,5,10,2021
389,Luke Kornet,BOS,31,347,24,60,12,12,7,3,2,3,9,2021
390,Jahlil Okafor,DET,27,347,13,30,9,4,7,2,0,1,3,2021
391,Chandler Hutchison,WAS,25,346,17,42,9,8,6,3,0,1,7,2021
392,Josh Hall,OKC,21,336,28,68,16,12,13,2,1,3,9,2021
393,Mason Jones,PHI,32,334,42,101,25,17,21,3,1,4,13,2021
394,Shaquille Harrison,DEN,34,332,25,66,9,16,3,4,2,6,10,2021
395,Matt Thomas,UTA,45,327,19,47,10,9,8,2,0,6,3,2021
396,Kelan Martin,IND,35,322,17,40,11,6,3,6,2,1,5,2021
397,Frank Ntilikina,NYK,33,322,19,48,9,10,6,0,3,1,9,2021
398,Jaylen Hoard,OKC,19,320,24,52,20,4,13,5,2,0,4,2021
399,JaKarr Sampson,IND,29,316,4,9,3,1,2,1,0,0,1,2021
400,Justin James,SAC,36,310,22,51,15,7,6,6,3,2,5,2021
401,Luka Samanic,SAS,33,308,15,32,13,2,10,3,0,0,2,2021
402,Jerome Robinson,WAS,17,305,25,59,16,9,7,7,2,2,7,2021
403,Trent Forrest,UTA,30,302,45,119,16,29,7,9,0,9,20,2021
404,Ed Davis,MIN,23,299,21,53,10,11,5,1,4,1,10,2021
405,Paul Watson,TOR,27,297,17,44,7,10,3,3,1,3,7,2021
406,Romeo Langford,BOS,18,283,13,29,10,3,4,5,1,0,3,2021
407,Vlatko Cancar,DEN,41,281,14,34,8,6,6,2,0,1,5,2021
408,Mfiondu Kabengele,CLE,39,280,17,41,10,7,6,3,1,2,5,2021
409,Nathan Knight,ATL,33,279,8,21,3,5,2,1,0,1,4,2021
410,Carsen Edwards,BOS,31,276,14,37,5,9,3,1,1,5,4,2021
411,Jordan Nwora,MIL,30,274,7,15,6,1,6,0,0,1,0,2021
412,Boban Marjanovic,DAL,33,271,10,21,9,1,5,2,2,0,1,2021
413,Thomas Bryant,WAS,10,271,15,35,10,5,5,4,1,1,4,2021
414,Skylar Mays,ATL,33,269,30,72,18,12,15,1,2,4,8,2021
415,Tre Jones,SAS,37,269,39,89,28,11,21,2,5,2,9,2021
416,Jaren Jackson Jr.,MEM,11,258,12,30,6,6,4,2,0,3,3,2021
417,Alfonzo McKinnie,LAL,39,258,6,15,3,3,2,0,1,1,2,2021
418,Ignas Brazdeikis,ORL,13,249,17,38,13,4,11,2,0,0,4,2021
419,Justin Patton,HOU,13,247,14,36,6,8,5,0,1,3,5,2021
420,Keita Bates-Diop,SAS,30,245,12,27,9,3,7,2,0,1,2,2021
421,Wenyen Gabriel,NOP,21,241,11,28,5,6,3,1,1,5,1,2021
422,Tremont Waters,BOS,26,238,62,144,42,20,29,8,5,11,9,2021
423,Mike James,BKN,13,236,54,139,23,31,17,5,1,9,22,2021
424,Kyle Guy,SAC,31,235,32,74,22,10,12,6,4,2,8,2021
425,Sam Merrill,MIL,30,233,21,52,11,10,5,3,3,4,6,2021
426,Chris Chiozza,BKN,22,232,65,151,44,21,32,9,3,5,16,2021
427,Bruno Fernando,ATL,33,226,10,23,7,3,2,3,2,0,3,2021
428,Matthew Dellavedova,CLE,13,224,58,140,34,24,22,11,1,7,17,2021
429,Anthony Gill,WAS,26,218,11,25,8,3,4,2,2,2,1,2021
430,Sindarius Thornwell,ORL,21,217,21,51,12,9,8,2,2,2,7,2021
431,Markelle Fultz,ORL,8,215,43,103,26,17,11,12,3,1,16,2021
432,Gabriel Deck,OKC,10,212,24,60,12,12,8,3,1,2,10,2021
433,Reggie Perry,BKN,26,211,14,32,10,4,7,1,2,0,4,2021
434,Dewayne Dedmon,MIA,16,210,12,32,4,8,2,1,1,1,7,2021
435,Markus Howard,DEN,37,205,18,42,12,6,6,3,3,2,4,2021
436,Darius Miller,OKC,18,197,21,51,12,9,9,2,1,2,7,2021
437,Jordan Bone,ORL,14,196,18,44,10,8,5,4,1,3,5,2021
438,Rodney McGruder,DET,16,194,16,38,10,6,5,3,2,2,4,2021
439,CJ Elleby,POR,30,192,10,24,6,4,5,1,0,0,4,2021
440,Alize Johnson,BKN,18,189,14,35,7,7,4,3,0,2,5,2021
441,Killian Tillie,MEM,18,182,8,19,5,3,1,4,0,1,2,2021
442,Donta Hall,ORL,13,179,11,29,4,7,1,2,1,0,7,2021
443,Paul Reed,PHI,26,177,12,29,7,5,6,0,1,1,4,2021
444,Jalen Harris,TOR,13,172,17,44,7,10,4,2,1,1,9,2021
445,Jabari Parker,BOS,13,166,11,26,7,4,4,3,0,1,3,2021
446,Daniel Oturu,LAC,30,161,10,23,7,3,5,1,1,0,3,2021
447,Bol Bol,DEN,32,160,7,17,4,3,1,1,2,0,3,2021
448,Sean McDermott,MEM,18,158,4,10,2,2,2,0,0,1,1,2021
449,Quinn Cook,CLE,23,157,18,44,10,8,9,0,1,2,6,2021
450,Jalen Smith,PHX,27,156,4,10,2,2,0,1,1,1,1,2021
451,Khyri Thomas,HOU,5,153,25,63,12,13,9,2,1,0,13,2021
452,Charlie Brown Jr.,OKC,9,152,9,20,7,2,5,1,1,0,2,2021
453,Ersan Ilyasova,UTA,17,148,4,10,2,2,1,0,1,0,2,2021
454,Juwan Morgan,UTA,29,147,9,23,4,5,4,0,0,3,2,2021
455,Mamadi Diakite,MIL,14,141,8,20,4,4,2,0,2,1,3,2021
456,Jarrell Brantley,UTA,28,138,15,41,4,11,3,0,1,2,9,2021
457,Yogi Ferrell,LAC,10,137,22,52,14,8,9,3,2,5,3,2021
458,Tacko Fall,BOS,18,136,3,9,0,3,0,0,0,1,2,2021
459,Deividas Sirvydis,DET,20,133,5,14,1,4,1,0,0,1,3,2021
460,Rodions Kurucs,MIL,21,125,10,25,5,5,5,0,0,1,4,2021
461,Dakota Mathias,PHI,8,123,13,29,10,3,4,4,2,0,3,2021
462,Quinndary Weatherspoon,SAS,20,121,8,16,8,0,5,3,0,0,0,2021
463,T.J. Warren,IND,4,117,5,13,2,3,1,1,0,2,1,2021
464,Dante Exum,CLE,6,116,13,26,13,0,9,3,1,0,0,2021
465,Vernon Carey Jr.,CHA,19,115,2,4,2,0,2,0,0,0,0,2021
466,Rondae Hollis-Jefferson,POR,11,107,13,32,7,6,4,3,0,2,4,2021
467,Robert Franks,ORL,7,101,5,12,3,2,2,1,0,0,2,2021
468,Anthony Tolliver,PHI,11,99,2,5,1,1,1,0,0,0,1,2021
469,Cassius Winston,WAS,22,98,12,26,10,2,4,4,2,0,2,2021
470,Devontae Cacok,LAL,20,98,1,2,1,0,1,0,0,0,0,2021
471,Jahmi'us Ramsey,SAC,13,94,6,15,3,3,3,0,0,0,3,2021
472,Nate Hinton,DAL,21,93,8,19,5,3,4,0,1,1,2,2021
473,Cassius Stanley,IND,24,93,1,3,0,1,0,0,0,1,0,2021
474,Chris Silva,SAC,15,92,6,14,4,2,2,1,1,0,2,2021
475,Karim Mane,ORL,10,88,4,10,2,2,2,0,0,1,1,2021
476,Justin Robinson,OKC,9,88,9,22,5,4,4,1,0,1,3,2021
477,Cameron Oliver,HOU,4,87,5,13,2,3,1,1,0,1,2,2021
478,Louis King,SAC,6,85,9,22,5,4,4,0,1,1,3,2021
479,Jay Scrubb,LAC,4,84,1,2,1,0,0,0,1,0,0,2021
480,Alen Smailagic,GSW,15,84,4,9,3,1,2,1,0,0,1,2021
481,Cristiano Felicio,CHI,18,84,9,18,9,0,6,2,1,0,0,2021
482,Norvel Pelle,NYK,13,83,2,4,2,0,1,1,0,0,0,2021
483,Jordan Bell,GSW,6,82,7,17,4,3,3,0,1,1,2,2021
484,Jared Dudley,LAL,12,81,5,13,2,3,2,0,0,1,2,2021
485,Frank Mason,ORL,4,79,12,25,11,1,6,1,4,0,1,2021
486,Thon Maker,CLE,8,76,4,9,3,1,3,0,0,1,0,2021
487,Jeremiah Martin,CLE,9,75,4,10,2,2,2,0,0,1,1,2021
488,Keljin Blevins,POR,17,75,4,10,2,2,2,0,0,1,1,2021
489,Devin Cannady,ORL,8,74,1,3,0,1,0,0,0,0,1,2021
490,Tyler Bey,DAL,18,71,3,8,1,2,0,1,0,1,1,2021
491,Rayjon Tucker,PHI,14,68,6,14,4,2,2,2,0,0,2,2021
492,Spencer Dinwiddie,BKN,3,64,9,24,3,6,2,1,0,1,5,2021
493,Elijah Hughes,UTA,18,64,6,15,3,3,2,1,0,2,1,2021
494,Andre Roberson,BKN,5,63,4,9,3,1,3,0,0,0,1,2021
495,Nick Richards,CHA,18,63,2,4,2,0,1,0,1,0,0,2021
496,Tim Frazier,MEM,5,62,16,39,9,7,6,2,1,1,6,2021
497,Axel Toupane,MIL,8,61,4,10,2,2,1,0,1,1,1,2021
498,Udoka Azubuike,UTA,15,57,0,0,0,0,0,0,0,0,0,2021
499,Kostas Antetokounmpo,LAL,15,56,1,3,0,1,0,0,0,0,1,2021
0,CJ McCollum,POR,70,2556,310,742,188,122,107,50,31,33,89,2020
1,Devin Booker,PHX,70,2512,456,1109,259,197,196,42,21,69,128,2020
2,James Harden,HOU,68,2483,512,1226,310,202,271,27,12,61,141,2020
3,Harrison Barnes,SAC,72,2482,159,407,70,89,43,17,10,22,67,2020
4,Damian Lillard,POR,66,2474,530,1266,324,206,206,77,41,74,132,2020
5,Tobias Harris,PHI,72,2469,227,540,141,86,99,21,21,24,62,2020
6,P.J. Tucker,HOU,72,2467,115,286,59,56,49,9,1,11,45,2020
7,Shai Gilgeous-Alexander,OKC,70,2429,232,561,135,97,85,29,21,27,70,2020
8,Bam Adebayo,MIA,72,2417,368,928,176,192,119,35,22,42,150,2020
9,Donovan Mitchell,UTA,69,2364,294,739,143,151,118,20,5,59,92,2020
10,Nikola Jokic,DEN,73,2336,512,1171,365,147,264,55,46,51,96,2020
11,Rudy Gobert,UTA,68,2333,101,251,52,49,32,13,7,13,36,2020
12,DeMar DeRozan,SAS,68,2316,380,972,168,212,84,43,41,56,156,2020
13,LeBron James,LAL,67,2316,684,1602,450,234,329,70,51,98,136,2020
14,Jayson Tatum,BOS,66,2265,200,487,113,87,70,28,15,24,63,2020
15,Buddy Hield,SAC,72,2216,213,496,143,70,104,28,11,19,51,2020
16,Devonte' Graham,CHA,63,2211,471,1093,320,151,255,57,8,37,114,2020
17,Chris Paul,OKC,70,2208,472,1132,284,188,202,53,29,41,147,2020
18,T.J. Warren,IND,67,2202,99,230,67,32,38,16,13,7,25,2020
19,Duncan Robinson,MIA,73,2166,102,236,70,32,55,10,5,10,22,2020
20,Terry Rozier,CHA,63,2164,259,627,150,109,104,35,11,33,76,2020
21,Domantas Sabonis,IND,62,2159,310,731,199,111,105,41,53,30,81,2020
22,Collin Sexton,CLE,65,2143,192,465,111,81,73,29,9,17,64,2020
23,Robert Covington,HOU,70,2137,88,217,47,41,39,6,2,19,22,2020
24,Joe Ingles,UTA,72,2137,373,884,235,138,193,29,13,64,74,2020
25,Anthony Davis,LAL,62,2131,200,487,113,87,89,11,13,27,60,2020
26,Joe Harris,BKN,69,2123,144,352,80,64,67,11,2,28,36,2020
27,Trae Young,ATL,60,2120,560,1292,388,172,322,53,13,49,123,2020
28,Dorian Finney-Smith,DAL,71,2120,114,282,60,54,42,11,7,11,43,2020
29,Jrue Holiday,NOP,61,2117,408,994,230,178,182,22,26,66,112,2020
30,Dillon Brooks,MEM,73,2112,150,356,94,56,58,31,5,17,39,2020
31,Pascal Siakam,TOR,60,2110,207,533,88,119,71,14,3,31,88,2020
32,Brandon Ingram,NOP,62,2104,259,631,146,113,120,18,8,28,85,2020
33,Kyle Lowry,TOR,58,2098,433,997,302,131,213,53,36,45,86,2020
34,Tim Hardaway Jr.,DAL,71,2091,137,335,76,61,52,20,4,10,51,2020
35,Zach LaVine,CHI,60,2085,254,609,153,101,118,29,6,33,68,2020
36,Bojan Bogdanovic,UTA,63,2083,131,324,69,62,54,13,2,26,36,2020
37,Julius Randle,NYK,64,2080,198,502,92,106,61,13,18,26,80,2020
38,Evan Fournier,ORL,66,2076,209,470,157,52,103,46,8,15,37,2020
39,Ja Morant,MEM,67,2074,488,1161,303,185,207,76,20,46,139,2020
40,OG Anunoby,TOR,69,2066,108,276,48,60,41,7,0,18,42,2020
41,Bradley Beal,WAS,57,2053,347,815,226,121,172,26,28,29,92,2020
42,Royce O'Neale,UTA,71,2049,180,454,86,94,69,12,5,36,58,2020
43,Russell Westbrook,HOU,57,2049,401,1014,189,212,161,24,4,98,114,2020
44,Luka Doncic,DAL,61,2047,538,1320,294,244,214,47,33,102,142,2020
45,Mikal Bridges,PHX,73,2042,129,316,71,58,49,13,9,20,38,2020
46,Al Horford,PHI,67,2026,270,637,173,97,98,45,30,25,72,2020
47,Lonzo Ball,NOP,63,2025,438,1047,267,171,203,41,23,52,119,2020
48,De'Andre Hunter,ATL,63,2018,112,278,58,54,36,15,7,23,31,2020
49,Aaron Gordon,ORL,62,2017,228,536,148,80,93,33,22,19,61,2020
50,Ben Simmons,PHI,57,2017,455,1136,229,226,156,41,32,42,184,2020
51,Ricky Rubio,PHX,65,2016,570,1300,410,160,299,73,38,45,115,2020
52,Nemanja Bjelica,SAC,72,2011,203,500,109,94,79,19,11,26,68,2020
53,Hassan Whiteside,POR,67,2008,78,191,43,35,28,7,8,7,28,2020
54,Dennis Schroder,OKC,65,1999,262,602,184,78,136,28,20,23,55,2020
55,Nikola Vucevic,ORL,62,1998,222,530,136,86,77,33,26,17,69,2020
56,Markelle Fultz,ORL,72,1996,369,899,208,161,120,52,36,25,136,2020
57,Miles Bridges,CHA,65,1995,114,285,57,57,48,7,2,14,43,2020
58,Spencer Dinwiddie,BKN,64,1994,432,1033,263,169,229,21,13,46,123,2020
59,Kendrick Nunn,MIA,67,1962,220,521,139,81,104,28,7,16,65,2020
60,Jimmy Butler,MIA,58,1959,350,851,199,151,127,47,25,55,96,2020
61,Marcus Morris Sr.,LAC,62,1936,86,202,56,30,41,9,6,13,17,2020
62,Jaylen Brown,BOS,57,1934,118,280,74,44,47,18,9,10,34,2020
63,Kelly Oubre Jr.,PHX,56,1933,85,198,57,28,32,19,6,4,24,2020
64,Fred VanVleet,TOR,54,1928,357,860,211,146,148,46,17,46,100,2020
65,Marcus Smart,BOS,60,1919,291,678,195,96,139,29,27,36,60,2020
66,Giannis Antetokounmpo,MIL,63,1917,354,902,160,194,110,32,18,63,131,2020
67,Will Barton,DEN,58,1916,212,485,151,61,90,39,22,13,48,2020
68,Danuel House Jr.,HOU,63,1913,85,210,45,40,40,5,0,22,18,2020
69,Cedi Osman,CLE,65,1910,154,379,83,71,47,21,15,29,42,2020
70,Jamal Murray,DEN,59,1904,284,665,187,97,97,62,28,20,77,2020
71,Carmelo Anthony,POR,58,1902,85,212,43,42,31,8,4,15,27,2020
72,Jerami Grant,DEN,71,1892,88,221,43,45,20,13,10,12,33,2020
73,Maxi Kleber,DAL,74,1890,88,215,49,39,30,12,7,8,31,2020
74,Terrence Ross,ORL,69,1889,82,198,48,34,29,10,9,12,22,2020
75,Andre Drummond,CLE,57,1878,152,374,82,70,54,17,11,24,46,2020
76,Tomas Satoransky,CHI,65,1878,354,852,210,144,176,25,9,34,110,2020
77,Jae Crowder,MIA,65,1875,161,373,110,51,70,29,11,17,34,2020
78,Lou Williams,LAC,65,1864,365,854,241,124,188,39,14,37,87,2020
79,Andrew Wiggins,GSW,54,1859,198,493,101,97,78,18,5,26,71,2020
80,Taurean Prince,BKN,64,1857,116,279,69,47,58,8,3,16,31,2020
81,Khris Middleton,MIL,62,1853,265,609,186,79,151,25,10,22,57,2020
82,Jarrett Allen,BKN,70,1852,110,268,62,48,38,13,11,10,38,2020
83,Kawhi Leonard,LAC,57,1848,280,684,156,124,118,29,9,47,77,2020
84,Jonas Valanciunas,MEM,70,1845,131,316,77,54,32,32,13,2,52,2020
85,Danilo Gallinari,OKC,62,1834,119,280,77,42,52,19,6,13,29,2020
86,Myles Turner,IND,62,1826,72,177,39,33,24,4,11,9,24,2020
87,Justin Holiday,IND,73,1826,93,222,57,36,31,17,9,14,22,2020
88,Darius Garland,CLE,59,1824,229,550,137,92,103,26,8,18,74,2020
89,Brook Lopez,MIL,68,1817,99,249,48,51,33,5,10,3,48,2020
90,Kristaps Porzingis,DAL,57,1814,102,256,50,52,31,11,8,16,36,2020
91,Ish Smith,WAS,68,1787,334,828,174,160,124,28,22,37,123,2020
92,Glenn Robinson III,PHI,62,1786,96,235,53,43,34,9,10,13,30,2020
93,Troy Brown Jr.,WAS,69,1782,178,421,113,65,80,15,18,14,51,2020
94,Gary Harris,DEN,56,1780,118,292,62,56,38,14,10,21,35,2020
95,Kevin Love,CLE,56,1780,178,415,119,59,91,23,5,18,41,2020
96,Bogdan Bogdanovic,SAC,61,1766,207,494,127,80,91,21,15,28,52,2020
97,Kentavious Caldwell-Pope,LAL,69,1762,111,267,66,45,49,13,4,22,23,2020
98,Kevin Huerter,ATL,56,1760,213,511,128,85,100,23,5,23,62,2020
99,Cory Joseph,SAC,72,1759,251,614,139,112,72,40,27,35,77,2020
100,P.J. Washington,CHA,58,1759,123,310,59,64,47,7,5,20,44,2020
101,Josh Hart,NOP,65,1755,108,268,56,52,46,6,4,18,34,2020
102,Alec Burks,PHI,66,1754,189,438,129,60,78,32,19,14,46,2020
103,LaMarcus Aldridge,SAS,53,1754,129,309,78,51,20,15,43,5,46,2020
104,Montrezl Harrell,LAC,63,1749,107,266,55,52,34,12,9,17,35,2020
105,Kemba Walker,BOS,56,1742,268,643,161,107,109,38,14,35,72,2020
106,Gordon Hayward,BOS,52,1740,212,505,131,81,95,26,10,26,55,2020
107,Garrett Temple,BKN,62,1730,156,371,97,59,75,12,10,20,39,2020
108,Tristan Thompson,CLE,57,1722,120,290,70,50,33,28,9,8,42,2020
109,Jordan Clarkson,UTA,71,1705,136,341,67,69,47,19,1,27,42,2020
110,RJ Barrett,NYK,56,1704,143,322,107,36,78,17,12,10,26,2020
111,Langston Galloway,DET,66,1702,101,240,63,38,47,12,4,15,23,2020
112,Josh Richardson,PHI,55,1693,162,388,98,64,60,26,12,10,54,2020
113,Kent Bazemore,SAC,68,1688,93,213,66,27,44,14,8,7,20,2020
114,Dejounte Murray,SAS,66,1687,271,639,174,97,81,45,48,24,73,2020
115,Danny Green,LAL,68,1687,91,209,64,27,48,11,5,14,13,2020
116,Steven Adams,OKC,63,1680,146,336,102,44,55,21,26,8,36,2020
117,Derrick White,SAS,68,1677,241,555,168,73,87,47,34,24,49,2020
118,Coby White,CHI,65,1674,175,427,98,77,72,21,5,24,53,2020
119,Malcolm Brogdon,IND,54,1666,381,870,273,108,149,67,57,29,79,2020
120,Goran Dragic,MIA,59,1663,301,718,185,116,136,38,11,32,84,2020
121,Eric Paschall,GSW,60,1654,127,307,74,53,47,19,8,16,37,2020
122,Eric Bledsoe,MIL,61,1646,328,799,185,143,145,25,15,35,108,2020
123,Tony Snell,DET,59,1641,127,301,80,47,58,19,3,12,35,2020
124,Monte Morris,DEN,73,1636,255,610,155,100,101,17,37,24,76,2020
125,Wesley Matthews,MIL,67,1635,92,222,54,38,46,5,3,9,29,2020
126,De'Aaron Fox,SAC,51,1634,348,884,160,188,111,36,13,48,140,2020
127,Bruce Brown,DET,58,1634,230,550,140,90,96,38,6,26,64,2020
128,Dario Saric,PHX,66,1632,123,286,83,40,52,23,8,10,30,2020
129,Jaren Jackson Jr.,MEM,57,1622,78,185,49,29,27,16,6,2,27,2020
130,Ben McLemore,HOU,71,1619,58,155,19,39,14,5,0,23,16,2020
131,Aaron Holiday,IND,66,1617,225,534,141,84,84,32,25,26,58,2020
132,Austin Rivers,HOU,68,1594,113,292,47,66,36,10,1,25,41,2020
133,Thaddeus Young,CHI,64,1591,117,279,72,45,62,7,3,14,31,2020
134,Davis Bertans,WAS,54,1583,92,221,55,37,40,8,7,10,27,2020
135,JJ Redick,NOP,60,1581,119,288,69,50,58,9,2,16,34,2020
136,Bryn Forbes,SAS,63,1579,108,246,78,30,40,18,20,8,22,2020
137,Seth Curry,DAL,64,1576,124,306,66,58,47,17,2,16,42,2020
138,Delon Wright,DAL,73,1570,244,636,96,148,52,30,14,36,112,2020
139,Daniel Theis,BOS,65,1566,111,275,58,53,33,17,8,6,47,2020
140,Furkan Korkmaz,PHI,72,1559,79,187,50,29,37,11,2,9,20,2020
141,Cam Reddish,ATL,58,1551,87,212,49,38,39,4,6,15,23,2020
142,Josh Okogie,MIN,62,1547,99,245,52,47,44,7,1,16,31,2020
143,Kyle Kuzma,LAL,61,1526,80,194,46,34,33,6,7,10,24,2020
144,Donte DiVincenzo,MIL,66,1520,154,360,102,52,74,15,13,16,36,2020
145,Tyler Herro,MIA,55,1508,121,295,68,53,51,14,3,18,35,2020
146,Joel Embiid,PHI,51,1506,152,361,95,57,53,22,20,14,43,2020
147,Jarrett Culver,MIN,63,1506,110,266,64,46,47,11,6,7,39,2020
148,Trevor Ariza,POR,53,1492,91,223,50,41,31,11,8,11,30,2020
149,Lauri Markkanen,CHI,50,1492,74,181,41,33,37,3,1,14,19,2020
150,Patty Mills,SAS,66,1485,118,265,89,29,51,25,13,7,22,2020
151,Serge Ibaka,TOR,55,1485,77,197,34,43,27,2,5,15,28,2020
152,Norman Powell,TOR,52,1479,91,218,55,36,39,8,8,11,25,2020
153,Larry Nance Jr.,CLE,56,1472,123,312,57,66,40,14,3,19,47,2020
154,Jeff Teague,ATL,59,1464,308,755,169,139,117,38,14,30,109,2020
155,Rudy Gay,SAS,67,1461,114,263,79,35,51,15,13,12,23,2020
156,D'Angelo Russell,MIN,45,1452,285,646,209,76,153,35,21,15,61,2020
157,Landry Shamet,LAC,53,1452,99,239,58,41,46,12,0,18,23,2020
158,Anfernee Simons,POR,70,1449,97,242,49,48,30,10,9,16,32,2020
159,Rui Hachimura,WAS,48,1444,87,218,43,44,28,11,4,7,37,2020
160,Maurice Harkless,NYK,62,1427,68,162,42,26,31,5,6,11,15,2020
161,Damion Lee,GSW,49,1422,133,316,83,50,51,14,18,10,40,2020
162,D.J. Augustin,ORL,57,1420,262,640,146,116,75,40,31,20,96,2020
163,Paul George,LAC,48,1419,185,448,107,78,82,13,12,34,44,2020
164,Mitchell Robinson,NYK,61,1412,36,82,26,10,13,3,10,1,9,2020
165,Bobby Portis,NYK,66,1393,98,237,57,41,40,7,10,13,28,2020
166,Derrick Jones Jr.,MIA,59,1375,62,155,31,31,19,6,6,6,25,2020
167,Doug McDermott,IND,69,1372,78,169,65,13,47,10,8,7,6,2020
168,Brad Wanamaker,BOS,71,1369,179,433,104,75,70,17,17,17,58,2020
169,Mike Conley,UTA,47,1363,208,499,125,83,96,25,4,30,53,2020
170,John Collins,ATL,41,1363,60,144,36,24,22,10,4,4,20,2020
171,Shabazz Napier,WAS,56,1344,262,651,135,127,105,17,13,22,105,2020
172,Patrick Beverley,LAC,51,1342,183,458,91,92,58,21,12,22,70,2020
173,Cody Zeller,CHA,58,1341,88,211,53,35,43,9,1,14,21,2020
174,Gary Trent Jr.,POR,61,1332,61,151,32,29,19,7,6,9,20,2020
175,Kyle Anderson,MEM,67,1330,162,369,117,45,72,35,10,13,32,2020
176,Caris LeVert,BKN,45,1330,199,480,117,82,97,11,9,21,61,2020
177,Ivica Zubac,LAC,72,1326,82,196,50,32,18,14,18,9,23,2020
178,T.J. McConnell,IND,71,1326,355,850,215,140,154,31,30,43,97,2020
179,Christian Wood,DET,62,1325,60,144,36,24,25,8,3,10,14,2020
180,JaMychal Green,LAC,63,1307,49,123,24,25,15,5,4,10,15,2020
181,Dwight Howard,LAL,69,1306,45,105,30,15,16,5,9,2,13,2020
182,Kelly Olynyk,MIA,67,1300,116,288,60,56,39,11,10,12,44,2020
183,Brandon Clarke,MEM,58,1300,81,182,61,20,40,15,6,6,14,2020
184,Derrick Rose,DET,50,1298,278,700,134,144,96,29,9,65,79,2020
185,Jeremy Lamb,IND,46,1291,96,223,65,31,37,18,10,11,20,2020
186,Matisse Thybulle,PHI,65,1287,79,190,47,32,36,8,3,10,22,2020
187,Clint Capela,HOU,39,1279,48,122,22,26,16,4,2,7,19,2020
188,Jordan Poole,GSW,57,1274,134,316,86,48,59,17,10,11,37,2020
189,George Hill,MIL,59,1271,180,434,106,74,66,30,10,27,47,2020
190,Trey Lyles,SAS,63,1271,69,158,49,20,24,13,12,6,14,2020
191,Kris Dunn,CHI,51,1269,173,420,99,74,74,20,5,20,54,2020
192,James Ennis III,ORL,69,1266,63,149,40,23,29,3,8,4,19,2020
193,Svi Mykhailiuk,DET,56,1265,106,260,58,48,40,10,8,25,23,2020
194,Terrance Ferguson,OKC,56,1257,51,127,26,25,12,9,5,8,17,2020
195,Wendell Carter Jr.,CHI,43,1256,51,132,21,30,8,5,8,10,20,2020
196,Cameron Johnson,PHX,57,1255,69,173,34,35,18,11,5,11,24,2020
197,Isaac Bonga,WAS,66,1250,76,190,38,38,27,4,7,8,30,2020
198,Elfrid Payton,NYK,45,1246,323,737,232,91,167,26,39,31,60,2020
199,Pat Connaughton,MIL,67,1243,107,267,54,53,36,10,8,13,40,2020
200,Derrick Favors,NOP,51,1243,81,210,33,48,20,2,11,10,38,2020
201,Richaun Holmes,SAC,44,1242,42,97,29,13,19,4,6,3,10,2020
202,Paul Millsap,DEN,51,1240,83,197,52,31,36,7,9,13,18,2020
203,Deandre Ayton,PHX,38,1236,72,165,51,21,28,15,8,6,15,2020
204,DeAndre Jordan,BKN,56,1234,105,245,70,35,49,12,9,8,27,2020
205,Tyus Jones,MEM,65,1232,285,689,166,119,95,56,15,39,80,2020
206,Draymond Green,GSW,43,1222,266,636,162,104,96,36,30,31,73,2020
207,Terence Davis,TOR,72,1209,115,281,64,51,43,18,3,10,41,2020
208,Malik Beasley,MIN,55,1209,75,187,38,37,32,4,2,8,29,2020
209,Mike Scott,PHI,68,1207,56,131,37,19,22,5,10,6,13,2020
210,Marquese Chriss,GSW,59,1196,114,270,72,42,27,19,26,8,34,2020
211,Markieff Morris,LAL,58,1188,77,183,48,29,31,10,7,14,15,2020
212,Karl-Anthony Towns,MIN,35,1187,153,345,114,39,94,15,5,7,32,2020
213,Frank Ntilikina,NYK,57,1187,172,408,108,64,68,18,22,13,51,2020
214,Avery Bradley,LAL,49,1186,63,141,48,15,39,7,2,8,7,2020
215,Alex Caruso,LAL,64,1175,124,291,81,43,61,12,8,16,27,2020
216,Jakob Poeltl,SAS,66,1171,116,276,72,44,27,16,29,7,37,2020
217,Malik Monk,CHA,55,1169,114,269,73,41,56,17,0,9,32,2020
218,De'Anthony Melton,MEM,60,1167,175,403,122,53,73,42,7,13,40,2020
219,Kevin Knox II,NYK,65,1166,61,145,38,23,25,5,8,8,15,2020
220,Kevin Porter Jr.,CLE,50,1162,109,246,81,28,54,23,4,4,24,2020
221,Marc Gasol,TOR,44,1161,147,357,84,63,64,10,10,19,44,2020
222,Thomas Bryant,WAS,46,1147,83,189,60,23,37,6,17,4,19,2020
223,JaVale McGee,LAL,68,1130,37,83,28,9,22,3,3,2,7,2020
224,Darius Bazley,OKC,61,1130,41,104,19,22,11,4,4,4,18,2020
225,Marvin Williams,MIL,58,1129,60,149,31,29,22,7,2,8,21,2020
226,Nerlens Noel,OKC,61,1127,57,134,37,20,25,5,7,5,15,2020
227,Rondae Hollis-Jefferson,TOR,60,1122,106,277,41,65,30,8,3,10,55,2020
228,Willie Cauley-Stein,DAL,54,1098,70,165,45,25,25,8,12,6,19,2020
229,Gorgui Dieng,MEM,63,1097,73,177,42,31,22,16,4,7,24,2020
230,Solomon Hill,MIA,59,1088,104,250,62,42,35,24,3,12,30,2020
231,Jaxson Hayes,NOP,64,1080,56,143,25,31,15,3,7,6,25,2020
232,Torrey Craig,DEN,58,1072,47,110,31,16,18,8,5,3,13,2020
233,Dwight Powell,DAL,40,1061,59,144,33,26,7,17,9,10,16,2020
234,Mason Plumlee,DEN,61,1057,154,366,96,58,58,20,18,22,36,2020
235,Justin Jackson,DAL,65,1045,52,130,26,26,15,9,2,10,16,2020
236,Grant Williams,BOS,69,1043,68,161,43,25,25,10,8,3,22,2020
237,Nicolo Melli,NOP,60,1042,82,207,39,43,28,7,4,12,31,2020
238,Meyers Leonard,MIA,51,1034,55,135,30,25,19,6,5,8,17,2020
239,Bismack Biyombo,CHA,53,1029,50,116,34,16,20,11,3,6,10,2020
240,Taj Gibson,NYK,62,1025,52,131,25,27,13,6,6,4,23,2020
241,Jalen Brunson,DAL,57,1022,188,477,87,101,65,14,8,24,77,2020
242,E'Twaun Moore,NOP,56,1020,78,194,40,38,32,3,5,11,27,2020
243,Eric Gordon,HOU,36,1016,54,144,18,36,18,0,0,18,18,2020
244,Ky Bowman,GSW,45,1015,131,302,91,40,57,17,17,10,30,2020
245,Semi Ojeleye,BOS,69,1011,37,85,26,11,17,7,2,3,8,2020
246,Lonnie Walker IV,SAS,61,988,68,166,38,30,24,8,6,11,19,2020
247,Ersan Ilyasova,MIL,63,986,49,122,25,24,17,4,4,6,18,2020
248,Rajon Rondo,LAL,48,984,240,566,154,86,109,26,19,26,60,2020
249,Enes Kanter,BOS,58,983,56,133,35,21,24,9,2,5,16,2020
250,Jonathan Isaac,ORL,34,980,48,120,24,24,11,10,3,2,22,2020
251,Jerome Robinson,WAS,63,979,87,203,58,29,42,10,6,7,22,2020
252,Alex Len,SAC,55,971,50,125,25,25,9,8,8,3,22,2020
253,Jeff Green,HOU,48,960,50,126,24,26,19,3,2,7,19,2020
254,Kyle Korver,MIL,58,960,68,155,49,19,38,7,4,3,16,2020
255,Robin Lopez,MIL,66,958,45,114,21,24,11,3,7,6,18,2020
256,Wes Iwundu,ORL,52,953,60,147,33,27,21,6,6,3,24,2020
257,Jevon Carter,PHX,58,945,84,201,51,33,35,8,8,5,28,2020
258,Aron Baynes,PHX,42,934,67,163,38,29,16,14,8,6,23,2020
259,Ryan Arcidiacono,CHI,58,930,96,237,51,45,36,10,5,10,35,2020
260,Treveon Graham,ATL,55,929,45,109,26,19,18,4,4,2,17,2020
261,Isaiah Thomas,WAS,40,925,146,339,99,47,58,22,19,11,36,2020
262,Georges Niang,UTA,66,923,44,109,23,21,20,3,0,8,13,2020
263,Khem Birch,ORL,48,922,50,126,24,26,10,5,9,4,22,2020
264,Luke Kennard,DET,28,922,115,272,73,42,59,11,3,22,20,2020
265,Jabari Parker,SAC,38,918,68,160,44,24,29,9,6,8,16,2020
266,DeAndre' Bembry,ATL,43,915,81,190,53,28,45,3,5,9,19,2020
267,Patrick McCaw,TOR,37,908,79,194,43,36,30,9,4,10,26,2020
268,Michael Porter Jr.,DEN,55,903,46,101,37,9,28,5,4,4,5,2020
269,Cody Martin,CHA,48,903,95,231,54,41,44,8,2,13,28,2020
270,Hamidou Diallo,OKC,46,896,36,92,16,20,11,4,1,3,17,2020
271,Damian Jones,ATL,55,887,35,82,23,12,12,7,4,2,10,2020
272,Omari Spellman,GSW,49,886,47,107,34,13,22,2,10,5,8,2020
273,Marco Belinelli,SAS,57,883,69,160,47,22,19,17,11,7,15,2020
274,Mo Bamba,ORL,62,878,42,108,18,24,9,1,8,4,20,2020
275,Vince Carter,ATL,60,876,48,115,29,19,22,6,1,7,12,2020
276,Anthony Tolliver,MEM,55,872,42,109,17,25,10,5,2,7,18,2020
277,Mario Hezonja,POR,53,871,50,124,26,24,15,7,4,6,18,2020
278,Rodney McGruder,LAC,56,871,36,92,16,20,9,7,0,8,12,2020
279,Abdel Nader,OKC,55,867,38,92,22,16,16,4,2,6,10,2020
280,Timothe Luwawu-Cabarrot,BKN,47,853,29,67,20,9,15,3,2,3,6,2020
281,Emmanuel Mudiay,UTA,54,850,116,299,49,67,34,14,1,23,44,2020
282,Damyean Dotson,NYK,48,836,57,144,27,30,14,8,5,10,20,2020
283,Moritz Wagner,WAS,45,835,56,137,31,25,18,8,5,3,22,2020
284,Juancho Hernangomez,MIN,48,833,40,94,26,14,20,3,3,4,10,2020
285,Michael Carter-Williams,ORL,45,833,109,258,69,40,45,11,13,13,27,2020
286,Kenrich Williams,NOP,39,832,57,143,28,29,19,6,3,10,19,2020
287,Matthew Dellavedova,CLE,57,821,180,419,121,59,86,26,9,20,39,2020
288,Luguentz Dort,OKC,36,820,27,64,17,10,11,4,2,0,10,2020
289,Chris Boucher,TOR,62,819,26,68,10,16,7,0,3,4,12,2020
290,Ian Mahinmi,WAS,38,808,49,113,34,15,15,11,8,1,14,2020
291,Shake Milton,PHI,40,805,104,254,58,46,36,14,8,19,27,2020
292,Frank Jackson,NOP,59,797,61,152,31,30,25,4,2,12,18,2020
293,Jordan McRae,DET,37,785,93,223,56,37,43,10,3,10,27,2020
294,Frank Kaminsky,PHX,39,777,75,182,43,32,29,8,6,7,25,2020
295,Patrick Patterson,LAC,59,776,41,99,24,17,11,6,7,3,14,2020
296,Thon Maker,DET,60,776,43,107,22,21,13,7,2,4,17,2020
297,Dewayne Dedmon,ATL,44,774,22,51,15,7,11,3,1,0,7,2020
298,Sterling Brown,MIL,52,767,51,123,30,21,25,5,0,10,11,2020
299,Sekou Doumbouya,DET,38,754,19,45,12,7,8,3,1,2,5,2020
300,Keita Bates-Diop,DEN,44,744,30,77,13,17,12,1,0,3,14,2020
301,Reggie Jackson,LAC,31,743,126,296,82,44,58,17,7,14,30,2020
302,Wilson Chandler,BKN,35,734,39,99,18,21,16,2,0,9,12,2020
303,Elie Okobo,PHX,55,719,115,273,72,43,42,16,14,13,30,2020
304,Grayson Allen,MEM,38,718,52,127,29,23,17,5,7,10,13,2020
305,Bruno Fernando,ATL,56,713,49,119,28,21,10,8,10,5,16,2020
306,Tyler Johnson,BKN,39,709,74,184,38,36,21,14,3,9,27,2020
307,Dwayne Bacon,CHA,39,687,52,137,19,33,13,6,0,9,24,2020
308,Reggie Bullock,NYK,29,684,42,96,30,12,21,6,3,3,9,2020
309,Rodions Kurucs,BKN,47,684,51,131,22,29,20,0,2,8,21,2020
310,Zion Williamson,NOP,24,668,50,126,24,26,17,3,4,3,23,2020
311,Raul Neto,PHI,54,668,95,228,57,38,36,15,6,9,29,2020
312,Harry Giles III,SAC,46,667,60,137,43,17,33,4,6,6,11,2020
313,Tony Bradley,UTA,58,663,23,62,7,16,3,4,0,3,13,2020
314,Kyrie Irving,BKN,20,658,128,310,74,54,63,8,3,13,41,2020
315,Allen Crabbe,MIN,37,653,33,81,18,15,10,6,2,5,10,2020
316,James Johnson,MIN,32,620,74,185,37,37,30,5,2,8,29,2020
317,Rodney Hood,POR,21,619,32,84,12,20,5,6,1,1,19,2020
318,Daniel Gafford,CHI,43,609,21,50,13,8,8,4,1,1,7,2020
319,John Henson,DET,40,600,54,134,28,26,17,7,4,6,20,2020
320,Alfonzo McKinnie,CLE,40,593,14,36,6,8,5,0,1,2,6,2020
321,Nickeil Alexander-Walker,NOP,47,591,89,210,57,32,42,14,1,11,21,2020
322,Jordan McLaughlin,MIN,30,590,125,306,69,56,59,10,0,10,46,2020
323,Nassir Little,POR,48,573,22,55,11,11,8,1,2,4,7,2020
324,Mike Muscala,OKC,47,572,40,96,24,16,19,2,3,1,15,2020
325,Skal Labissiere,POR,33,567,42,102,24,18,11,3,10,5,13,2020
326,Gary Clark,ORL,42,566,17,43,8,9,6,1,1,2,7,2020
327,Luke Kornet,CHI,36,559,32,75,21,11,16,4,1,7,4,2020
328,Wayne Ellington,NYK,36,558,44,106,26,18,17,3,6,5,13,2020
329,Dennis Smith Jr.,NYK,34,537,98,239,55,43,34,8,13,9,34,2020
330,Troy Daniels,DEN,47,532,17,42,9,8,5,3,1,4,4,2020
331,Yogi Ferrell,SAC,50,530,69,170,37,32,20,9,8,9,23,2020
332,Victor Oladipo,IND,19,528,56,124,44,12,34,6,4,3,9,2020
333,Chandler Hutchison,CHI,28,527,26,64,14,12,12,2,0,2,10,2020
334,Trey Burke,DAL,33,520,83,199,50,33,35,12,3,12,21,2020
335,Blake Griffin,DET,18,512,59,151,26,33,19,4,3,13,20,2020
336,Quinn Cook,LAL,44,508,49,119,28,21,22,3,3,5,16,2020
337,Jake Layman,MIN,23,505,15,34,11,4,6,5,0,0,4,2020
338,Nicolas Batum,CHA,22,505,66,158,40,26,32,7,1,9,17,2020
339,Naz Reid,MIN,30,495,35,87,18,17,16,2,0,1,16,2020
340,Kelan Martin,MIN,31,495,23,59,10,13,8,2,0,1,12,2020
341,Denzel Valentine,CHI,36,488,43,106,23,20,23,0,0,7,13,2020
342,Dzanan Musa,BKN,40,487,43,109,20,23,14,2,4,4,19,2020
343,Dante Exum,CLE,35,486,40,93,27,13,19,5,3,2,11,2020
344,Shaquille Harrison,CHI,43,484,49,122,25,24,20,5,0,10,14,2020
345,Marko Guduric,MEM,44,484,45,106,29,16,20,6,3,6,10,2020
346,Cheick Diallo,PHX,47,479,22,50,16,6,9,2,5,1,5,2020
347,Goga Bitadze,IND,54,471,23,54,15,8,8,5,2,2,6,2020
348,JaKarr Sampson,IND,34,471,21,48,15,6,8,3,4,2,4,2020
349,Javonte Green,BOS,48,468,26,59,19,7,14,3,2,2,5,2020
350,Jahlil Okafor,NOP,30,467,37,89,22,15,14,2,6,3,12,2020
351,Brandon Knight,DET,25,462,69,175,32,37,24,6,2,6,31,2020
352,J.J. Barea,DAL,29,450,112,264,72,40,48,21,3,14,26,2020
353,Edmond Sumner,IND,31,447,55,131,34,21,23,7,4,8,13,2020
354,Matt Thomas,TOR,41,440,22,54,12,10,7,3,2,3,7,2020
355,Anzejs Pasecniks,WAS,26,437,18,42,12,6,4,4,4,2,4,2020
356,Thabo Sefolosha,HOU,41,436,25,66,9,16,7,1,1,5,11,2020
357,Gary Payton II,WAS,29,432,48,116,28,20,10,6,12,6,14,2020
358,Brandon Goodwin,ATL,34,430,51,119,34,17,28,4,2,2,15,2020
359,Boban Marjanovic,DAL,41,422,20,44,16,4,8,4,4,0,4,2020
360,Jacob Evans,MIN,29,418,31,74,19,12,10,4,5,4,8,2020
361,Andre Iguodala,MIA,21,418,51,125,28,23,21,5,2,6,17,2020
362,PJ Dozier,DEN,29,412,63,153,36,27,25,8,3,7,20,2020
363,Chris Chiozza,BKN,28,401,83,208,41,42,29,6,6,8,34,2020
364,Robert Williams III,BOS,29,388,27,63,18,9,14,2,2,1,8,2020
365,Cristiano Felicio,CHI,22,386,16,42,6,10,2,1,3,1,9,2020
366,Josh Jackson,MEM,22,381,35,78,27,8,20,5,2,4,4,2020
367,Al-Farouq Aminu,ORL,18,380,21,46,17,4,12,3,2,0,4,2020
368,Noah Vonleh,DEN,36,378,28,68,16,12,9,4,3,1,11,2020
369,Willy Hernangomez,CHA,31,375,29,71,16,13,8,5,3,5,8,2020
370,Romeo Langford,BOS,32,370,13,32,7,6,3,3,1,1,5,2020
371,Admiral Schofield,WAS,33,368,15,33,12,3,5,4,3,0,3,2020
372,Theo Pinson,BKN,33,365,56,141,27,29,22,4,1,13,16,2020
373,Jared Dudley,LAL,45,364,28,67,17,11,9,2,6,2,9,2020
374,D.J. Wilson,MIL,37,363,25,62,13,12,6,3,4,2,10,2020
375,Terance Mann,LAC,41,362,53,135,24,29,20,2,2,10,19,2020
376,Deonte Burton,OKC,39,356,17,44,7,10,6,1,0,5,5,2020
377,Tim Frazier,DET,27,355,93,226,53,40,44,4,5,10,30,2020
378,Justise Winslow,MIA,11,352,44,104,28,16,19,4,5,5,11,2020
379,Carsen Edwards,BOS,37,351,24,54,18,6,14,0,4,1,5,2020
380,Chris Silva,MIA,44,346,23,61,8,15,4,2,2,2,13,2020
381,Courtney Lee,DAL,24,345,12,32,4,8,3,1,0,2,6,2020
382,Marvin Bagley III,SAC,13,334,10,24,6,4,3,2,1,0,4,2020
383,Otto Porter Jr.,CHI,14,331,25,58,17,8,11,5,1,1,7,2020
384,Ty Jerome,PHX,31,328,44,110,22,22,15,2,5,6,16,2020
385,Caleb Martin,CHA,18,317,23,56,13,10,9,3,1,3,7,2020
386,Kyle O'Quinn,PHI,29,313,51,118,35,16,22,7,6,4,12,2020
387,Ed Davis,UTA,28,303,12,31,5,7,2,3,0,1,6,2020
388,Keldon Johnson,SAS,17,301,15,37,8,7,4,3,1,1,6,2020
389,Jalen McDaniels,CHA,16,293,13,32,7,6,5,1,1,1,5,2020
390,Allonzo Trier,NYK,24,291,28,70,14,14,7,4,3,1,13,2020
391,Chris Clemons,HOU,33,291,27,64,17,10,16,1,0,2,8,2020
392,Zach Collins,POR,11,290,16,34,14,2,4,4,6,1,1,2020
393,DeMarre Carroll,HOU,24,290,25,65,10,15,5,2,3,6,9,2020
394,Caleb Swanigan,POR,27,288,31,76,17,14,8,3,6,5,9,2020
395,Dragan Bender,GSW,16,286,28,64,20,8,13,3,4,4,4,2020
396,Michael Kidd-Gilchrist,DAL,25,281,14,37,5,9,4,1,0,2,7,2020
397,Drew Eubanks,SAS,22,272,15,38,7,8,4,0,3,2,6,2020
398,Juan Toscano-Anderson,GSW,13,272,26,62,16,10,11,4,1,4,6,2020
399,David Nwaba,BKN,20,268,8,19,5,3,5,0,0,0,3,2020
400,Isaiah Hartenstein,HOU,23,266,18,43,11,7,11,0,0,2,5,2020
401,Kevon Looney,GSW,20,262,20,47,13,7,4,4,5,1,6,2020
402,Jordan Bell,MEM,29,256,16,40,8,8,3,5,0,0,8,2020
403,Jusuf Nurkic,POR,8,253,32,75,21,11,16,2,3,2,9,2020
404,Evan Turner,ATL,19,251,38,92,22,16,16,4,2,4,12,2020
405,Derrick Walton Jr.,DET,26,248,27,71,10,17,8,1,1,1,16,2020
406,Bruno Caboclo,HOU,30,244,12,28,8,4,4,3,1,1,3,2020
407,Iman Shumpert,BKN,13,241,12,31,5,7,4,1,0,2,5,2020
408,Wenyen Gabriel,POR,30,235,8,18,6,2,3,1,2,0,2,2020
409,Justin James,SAC,36,232,18,42,12,6,9,2,1,4,2,2020
410,Norvel Pelle,PHI,24,232,8,19,5,3,1,2,2,0,3,2020
411,Garrison Mathews,WAS,18,227,10,27,3,7,3,0,0,2,5,2020
412,TJ Leaf,IND,28,222,9,23,4,5,4,0,0,0,5,2020
413,Ante Zizic,CLE,22,221,6,14,4,2,2,2,0,0,2,2020
414,Tyson Chandler,HOU,26,219,6,13,5,1,4,1,0,0,1,2020
415,Dion Waiters,LAL,10,207,20,52,8,12,5,3,0,4,8,2020
416,Mychal Mulder,GSW,7,204,8,18,6,2,2,2,2,2,0,2020
417,Nicolas Claxton,BKN,15,187,16,37,11,5,9,2,0,0,5,2020
418,Cameron Payne,PHX,8,183,24,60,12,12,10,0,2,5,7,2020
419,John Konchar,MEM,19,181,22,54,12,10,9,2,1,4,6,2020
420,Ryan Broekhoff,DAL,17,180,11,28,5,6,5,0,0,1,5,2020
421,Johnathan Williams,WAS,15,180,8,19,5,3,2,2,1,0,3,2020
422,Malcolm Miller,TOR,28,162,11,31,2,9,2,0,0,1,8,2020
423,Rayjon Tucker,UTA,19,161,5,13,2,3,2,0,0,1,2,2020
424,CJ Miles,WAS,10,161,12,26,10,2,7,2,1,0,2,2020
425,Tyrone Wallace,ATL,14,160,13,31,8,5,6,2,0,3,2,2020
426,Amir Coffey,LAC,18,159,14,37,5,9,4,1,0,3,6,2020
427,Jaylen Nowell,MIN,15,151,19,44,13,6,11,2,0,3,3,2020
428,Stanley Johnson,TOR,25,150,20,51,9,11,8,1,0,2,9,2020
429,Michael Frazier,HOU,13,145,2,6,0,2,0,0,0,2,0,2020
430,DaQuan Jeffries,SAC,13,141,7,17,4,3,1,1,2,1,2,2020
431,Stephen Curry,GSW,5,139,33,77,22,11,18,3,1,4,7,2020
432,Alen Smailagic,GSW,14,139,13,33,6,7,2,3,1,2,5,2020
433,Oshae Brissett,TOR,19,135,7,20,1,6,1,0,0,3,3,2020
434,Juwan Morgan,UTA,21,134,6,14,4,2,3,0,1,1,1,2020
435,Donta Hall,BKN,9,133,4,9,3,1,2,0,1,0,1,2020
436,Vincent Poirier,BOS,21,130,8,21,3,5,2,1,0,0,5,2020
437,Thanasis Antetokounmpo,MIL,20,129,15,38,7,8,4,1,2,4,4,2020
438,Melvin Frazier Jr.,ORL,19,126,3,7,2,1,2,0,0,0,1,2020
439,Tremont Waters,BOS,11,119,16,39,9,7,6,1,2,4,3,2020
440,Frank Mason,MIL,9,118,29,73,14,15,9,5,0,5,10,2020
441,Alize Johnson,IND,17,118,7,16,5,2,2,2,1,0,2,2020
442,Kadeem Allen,NYK,10,117,21,51,12,9,7,0,5,2,7,2020
443,Adam Mokoka,CHI,11,112,4,10,2,2,2,0,0,1,1,2020
444,Miye Oni,UTA,10,109,4,10,2,2,2,0,0,1,1,2020
445,Justin Anderson,BKN,10,107,8,19,5,3,4,0,1,1,2,2020
446,Chimezie Metu,SAS,18,105,10,24,6,4,1,3,2,0,4,2020
447,Yuta Watanabe,MEM,18,105,5,12,3,2,1,1,1,0,2,2020
448,Jaylen Hoard,POR,13,103,4,9,3,1,0,3,0,0,1,2020
449,Jeremiah Martin,BKN,9,99,18,45,9,9,7,2,0,4,5,2020
450,Lance Thomas,BKN,7,98,6,16,2,4,2,0,0,1,3,2020
451,Jarrell Brantley,UTA,9,96,11,28,5,6,4,1,0,1,5,2020
452,Paul Watson,TOR,10,87,8,19,5,3,4,1,0,0,3,2020
453,Bol Bol,DEN,6,87,6,13,5,1,5,0,0,1,0,2020
454,Andre Roberson,OKC,7,87,4,10,2,2,2,0,0,0,2,2020
455,Gabe Vincent,MIA,9,83,6,15,3,3,3,0,0,1,2,2020
456,BJ Johnson,ORL,10,83,3,7,2,1,1,1,0,0,1,2020
457,Talen Horton-Tucker,LAL,6,81,6,13,5,1,2,2,1,0,1,2020
458,Devon Hall,OKC,11,81,13,35,4,9,3,0,1,0,9,2020
459,Jerian Grant,WAS,6,80,9,22,5,4,2,2,1,3,1,2020
460,JR Smith,LAL,6,79,3,8,1,2,1,0,0,1,1,2020
461,Quinndary Weatherspoon,SAS,11,78,11,29,4,7,2,1,1,3,4,2020
462,Amile Jefferson,ORL,18,74,4,10,2,2,0,0,2,0,2,2020
463,Dean Wade,CLE,12,71,2,5,1,1,0,1,0,0,1,2020
464,Mfiondu Kabengele,LAC,12,64,2,5,1,1,0,1,0,1,0,2020
465,Louis King,DET,10,62,5,12,3,2,3,0,0,0,2,2020
466,Vic Law,ORL,8,62,3,8,1,2,1,0,0,1,1,2020
467,Khyri Thomas,DET,8,61,3,8,1,2,1,0,0,1,1,2020
468,Chandler Parsons,ATL,5,54,3,8,1,2,1,0,0,0,2,2020
469,Tyler Cook,DEN,13,54,1,2,1,0,1,0,0,0,0,2020
470,Ignas Brazdeikis,NYK,9,53,4,9,3,1,3,0,0,1,0,2020
471,Jarrod Uthoff,WAS,7,53,0,0,0,0,0,0,0,0,0,2020
472,Jordan Bone,DET,10,53,8,21,3,5,1,2,0,0,5,2020
473,Kevin Hervey,OKC,10,52,5,10,5,0,4,0,1,0,0,2020
474,Zylan Cheatham,NOP,4,51,3,7,2,1,2,0,0,0,1,2020
475,Joakim Noah,LAC,5,50,7,16,5,2,4,0,1,2,0,2020
476,Nigel Williams-Goss,UTA,10,50,6,14,4,2,2,2,0,0,2,2020
477,Justin Robinson,WAS,9,49,7,17,4,3,3,1,0,1,2,2020
478,Luka Samanic,SAS,3,48,6,14,4,2,2,2,0,1,1,2020
479,Jonah Bolden,PHX,7,47,0,0,0,0,0,0,0,0,0,2020
480,Naz Mitrou-Long,IND,5,47,8,18,6,2,3,3,0,0,2,2020
481,Jarred Vanderbilt,MIN,11,47,2,6,0,2,0,0,0,0,2,2020
482,Antonius Cleveland,DAL,11,46,1,2,1,0,0,1,0,0,0,2020
483,Vlatko Cancar,DEN,14,45,3,6,3,0,3,0,0,0,0,2020
484,Justin Wright-Foreman,UTA,4,45,7,16,5,2,4,1,0,0,2,2020
485,Jeremy Pargo,GSW,3,44,8,19,5,3,4,0,1,0,3,2020
486,Udonis Haslem,MIA,4,44,1,2,1,0,0,0,1,0,0,2020
487,Johnathan Motley,LAC,13,41,8,21,3,5,1,1,1,1,4,2020
488,Zach Norvell Jr.,GSW,5,41,3,7,2,1,1,1,0,0,1,2020
489,Charles Brown Jr.,ATL,10,40,2,5,1,1,0,1,0,0,1,2020
490,Chasson Randle,GSW,3,40,5,13,2,3,2,0,0,1,2,2020
491,Josh Magette,ORL,8,38,5,12,3,2,1,1,1,0,2,2020
492,Sindarius Thornwell,NOP,2,35,4,8,4,0,3,0,1,0,0,2020
493,Joe Chealey,CHA,4,33,1,2,1,0,1,0,0,0,0,2020
494,Moses Brown,POR,9,33,1,2,1,0,1,0,0,0,0,2020
495,Corey Brewer,SAC,5,33,2,4,2,0,0,1,1,0,0,2020
496,Tacko Fall,BOS,7,33,1,2,1,0,1,0,0,0,0,2020
497,Zhaire Smith,PHI,7,32,2,6,0,2,0,0,0,0,2,2020
498,Jalen Lecque,PHX,5,32,2,4,2,0,2,0,0,0,0,2020
499,Brian Bowen II,IND,6,31,0,0,0,0,0,0,0,0,0,2020
0,Bradley Beal,WAS,82,3028,448,1084,260,188,191,47,22,54,134,2019
1,James Harden,HOU,78,2867,586,1390,368,218,336,27,5,83,135,2019
2,Kemba Walker,CHA,82,2863,484,1164,288,196,184,80,24,74,122,2019
3,Tobias Harris,PHI,82,2848,229,548,139,90,89,29,21,24,66,2019
4,Paul George,OKC,77,2841,318,760,194,124,150,32,12,51,73,2019
5,Damian Lillard,POR,80,2838,551,1267,386,165,296,51,39,45,120,2019
6,PJ Tucker,HOU,82,2802,96,247,41,55,29,11,1,19,36,2019
7,Kevin Durant,GSW,78,2702,457,1108,263,194,167,44,52,42,152,2019
8,Ben Simmons,PHI,79,2700,610,1480,350,260,240,42,68,45,215,2019
9,DeMar DeRozan,SAS,77,2688,475,1146,279,196,120,79,80,54,142,2019
10,LaMarcus Aldridge,SAS,81,2687,194,459,123,71,45,32,46,15,56,2019
11,Steven Adams,OKC,80,2669,124,297,75,49,50,11,14,18,31,2019
12,Klay Thompson,GSW,78,2652,186,421,137,49,96,16,25,26,23,2019
13,Andre Drummond,DET,79,2647,112,274,62,50,40,16,6,12,38,2019
14,Aaron Gordon,ORL,78,2633,289,677,190,99,118,34,38,25,74,2019
15,Russell Westbrook,OKC,73,2630,784,1862,490,294,358,98,34,98,196,2019
16,Blake Griffin,DET,75,2622,402,1007,199,203,125,37,37,44,159,2019
17,Buddy Hield,SAC,82,2615,205,483,132,73,99,22,11,21,52,2019
18,Jerami Grant,OKC,80,2612,79,204,33,46,21,7,5,15,31,2019
19,Justin Holiday,MEM,82,2607,146,345,93,53,69,15,9,18,35,2019
20,Collin Sexton,CLE,82,2605,243,579,150,93,87,42,21,17,76,2019
21,Donovan Mitchell,UTA,77,2598,322,805,161,161,120,23,18,68,93,2019
22,Rudy Gobert,UTA,81,2577,161,393,90,71,55,18,17,18,53,2019
23,Bojan Bogdanovic,IND,81,2573,161,381,102,59,71,14,17,24,35,2019
24,Joe Ingles,UTA,82,2568,469,1063,344,125,263,58,23,45,80,2019
25,Evan Fournier,ORL,81,2553,295,701,184,111,93,50,41,34,77,2019
26,Pascal Siakam,TOR,80,2548,248,624,120,128,77,27,16,58,70,2019
27,De'Aaron Fox,SAC,81,2546,590,1400,370,220,263,67,40,42,178,2019
28,Karl-Anthony Towns,MIN,77,2545,259,597,180,79,138,20,22,22,57,2019
29,Andrew Wiggins,MIN,73,2543,184,454,98,86,53,25,20,31,55,2019
30,Josh Richardson,MIA,73,2539,298,715,179,119,118,44,17,38,81,2019
31,Harrison Barnes,SAC,77,2533,115,287,58,57,44,8,6,10,47,2019
32,Nikola Vucevic,ORL,80,2510,307,744,177,130,125,27,25,44,86,2019
33,Nikola Jokic,DEN,80,2504,580,1333,407,173,265,99,43,51,122,2019
34,Trae Young,ATL,81,2503,653,1569,390,263,336,35,19,104,159,2019
35,Thaddeus Young,IND,81,2489,204,478,134,70,92,19,23,24,46,2019
36,Jayson Tatum,BOS,79,2455,168,412,92,76,61,13,18,20,56,2019
37,D'Angelo Russell,BKN,81,2448,563,1322,367,196,311,44,12,50,146,2019
38,Jamal Murray,DEN,75,2447,363,861,228,135,129,79,20,32,103,2019
39,Cedi Osman,CLE,76,2444,195,471,114,81,69,34,11,25,56,2019
40,Marc Gasol,TOR,79,2436,349,840,207,142,133,48,26,44,98,2019
41,Mikal Bridges,PHX,82,2417,173,393,126,47,89,27,10,16,31,2019
42,Jrue Holiday,NOP,67,2402,518,1197,357,161,272,64,21,51,110,2019
43,Khris Middleton,MIL,77,2394,331,770,223,108,191,23,9,26,82,2019
44,JJ Redick,PHI,76,2379,206,470,148,58,110,29,9,13,45,2019
45,CJ McCollum,POR,70,2375,207,499,122,85,93,16,13,22,63,2019
46,Giannis Antetokounmpo,MIL,72,2358,424,1093,179,245,135,27,17,66,179,2019
47,Nicolas Batum,CHA,75,2354,247,599,142,105,89,35,18,33,72,2019
48,Trevor Ariza,WAS,69,2349,252,591,165,87,115,26,24,29,58,2019
49,Mike Conley,MEM,70,2342,449,1041,306,143,196,60,50,40,103,2019
50,Stephen Curry,GSW,69,2331,361,843,240,121,153,48,39,39,82,2019
51,Brook Lopez,MIL,81,2322,98,241,53,45,37,10,6,11,34,2019
52,Luka Doncic,DAL,72,2318,429,1048,239,190,193,31,15,80,110,2019
53,Dennis Schroder,OKC,79,2314,323,765,204,119,167,23,14,29,90,2019
54,Kyle Kuzma,LAL,70,2314,178,418,116,62,100,12,4,17,45,2019
55,Joe Harris,BKN,76,2293,181,436,107,74,82,18,7,25,49,2019
56,Bryn Forbes,SAS,82,2292,175,400,125,50,60,34,31,12,38,2019
57,Al-Farouq Aminu,POR,81,2292,104,243,69,35,48,13,8,6,29,2019
58,Reggie Jackson,DET,82,2289,344,821,211,133,158,41,12,47,86,2019
59,Eric Bledsoe,MIL,78,2272,430,1026,264,166,226,22,16,34,132,2019
60,D.J. Augustin,ORL,81,2269,426,994,284,142,162,69,53,37,105,2019
61,Jeremy Lamb,CHA,79,2250,172,414,102,70,76,15,11,18,52,2019
62,Clint Capela,HOU,67,2249,96,243,45,51,28,14,3,22,29,2019
63,Julius Randle,NOP,73,2232,229,555,132,97,83,25,24,19,78,2019
64,Devin Booker,PHX,64,2230,433,1032,267,166,190,60,17,55,111,2019
65,Danny Green,TOR,80,2216,126,305,73,53,48,14,11,17,36,2019
66,Jordan Clarkson,CLE,81,2214,196,486,102,94,73,23,6,35,59,2019
67,Kyrie Irving,BOS,67,2214,464,1093,299,165,167,58,74,39,126,2019
68,Kyle Lowry,TOR,65,2213,564,1282,410,154,244,105,61,60,94,2019
69,Willie Cauley-Stein,SAC,81,2213,194,458,124,70,68,21,35,19,51,2019
70,Marcus Smart,BOS,80,2200,321,763,200,121,126,36,38,20,101,2019
71,Jimmy Butler,PHI,65,2185,263,632,157,106,94,39,24,34,72,2019
72,Deandre Ayton,PHX,71,2183,125,310,65,60,39,14,12,16,44,2019
73,Shai Gilgeous-Alexander,LAC,82,2174,270,654,156,114,114,32,10,29,85,2019
74,Zach LaVine,CHI,63,2171,283,653,196,87,106,64,26,23,64,2019
75,Jae Crowder,UTA,80,2166,133,328,71,62,56,7,8,20,42,2019
76,Tomas Satoransky,WAS,80,2164,399,949,248,151,187,34,27,40,111,2019
77,Montrezl Harrell,LAC,82,2158,162,381,105,57,58,23,24,21,36,2019
78,Eric Gordon,HOU,68,2158,129,318,69,60,59,9,1,34,26,2019
79,Kevin Knox,NYK,75,2158,82,203,43,39,29,5,9,8,31,2019
80,Joel Embiid,PHI,64,2154,234,562,140,94,58,22,60,15,79,2019
81,Terrence Ross,ORL,81,2150,135,314,91,44,55,17,19,15,29,2019
82,Darren Collison,IND,76,2143,459,1067,310,149,167,66,77,31,118,2019
83,Patrick Beverley,LAC,78,2137,300,719,181,119,113,46,22,30,89,2019
84,Marvin Williams,CHA,75,2133,92,224,52,40,35,7,10,12,28,2019
85,Myles Turner,IND,74,2119,115,267,78,37,50,16,12,14,23,2019
86,Jeff Green,WAS,77,2097,137,331,80,57,61,8,11,10,47,2019
87,Jarrett Allen,BKN,80,2096,110,283,47,63,31,12,4,11,52,2019
88,Wesley Matthews,IND,69,2091,160,380,100,60,78,12,10,19,41,2019
89,Marcus Morris,BOS,75,2091,109,259,68,41,45,13,10,14,27,2019
90,Draymond Green,GSW,66,2065,454,1069,293,161,178,43,72,39,122,2019
91,Cory Joseph,IND,82,2063,321,748,215,106,135,40,40,28,78,2019
92,Danilo Gallinari,LAC,68,2059,178,419,115,63,67,30,18,23,40,2019
93,Tim Hardaway Jr.,DAL,65,2057,159,387,90,69,64,13,13,18,51,2019
94,Kevin Huerter,ATL,75,2048,214,524,118,96,92,20,6,33,63,2019
95,DeAndre Jordan,NYK,69,2047,156,364,104,52,62,22,20,12,40,2019
96,Garrett Temple,LAC,75,2041,106,248,70,36,34,24,12,6,30,2019
97,Kawhi Leonard,TOR,60,2040,199,501,96,103,68,19,9,42,61,2019
98,Kentavious Caldwell-Pope,LAL,82,2035,110,251,79,31,66,11,2,11,20,2019
99,Austin Rivers,HOU,76,2028,167,422,79,88,49,14,16,32,56,2019
100,Serge Ibaka,TOR,74,2010,99,257,40,59,26,3,11,18,41,2019
101,Dario Saric,MIN,81,2010,127,299,82,45,50,19,13,19,26,2019
102,Damyean Dotson,NYK,73,2004,135,337,68,67,43,16,9,16,51,2019
103,Jonathan Isaac,ORL,75,1996,80,183,57,23,28,15,14,5,18,2019
104,Lou Williams,LAC,75,1993,402,917,289,113,242,37,10,32,81,2019
105,Dorian Finney-Smith,DAL,81,1985,95,236,49,46,34,10,5,8,38,2019
106,Josh Jackson,PHX,79,1976,183,396,153,30,124,24,5,8,22,2019
107,Jusuf Nurkic,POR,72,1974,233,528,171,62,123,16,32,10,52,2019
108,Al Horford,BOS,68,1973,283,689,160,123,109,27,24,34,89,2019
109,Monte Morris,DEN,82,1970,297,717,174,123,123,39,12,29,94,2019
110,Ryan Arcidiacono,CHI,81,1961,269,633,174,95,102,45,27,28,67,2019
111,Justise Winslow,MIA,66,1960,282,680,166,116,119,35,12,36,80,2019
112,Bogdan Bogdanovic,SAC,70,1947,267,633,168,99,110,38,20,27,72,2019
113,LeBron James,LAL,55,1937,454,1054,308,146,245,45,18,41,105,2019
114,DeAndre' Bembry,ATL,82,1931,202,496,110,92,97,10,3,36,56,2019
115,Terrance Ferguson,OKC,74,1931,72,177,39,33,27,9,3,19,14,2019
116,Kelly Oubre Jr.,PHX,69,1923,84,196,56,28,31,17,8,5,23,2019
117,Spencer Dinwiddie,BKN,68,1914,311,747,186,125,130,46,10,46,79,2019
118,Jaylen Brown,BOS,74,1913,100,243,57,43,36,11,10,8,35,2019
119,Bam Adebayo,MIA,82,1913,184,458,94,90,53,20,21,28,62,2019
120,Patty Mills,SAS,82,1908,245,580,155,90,68,49,38,19,71,2019
121,Avery Bradley,MEM,63,1905,152,353,103,49,73,22,8,7,42,2019
122,Ricky Rubio,UTA,68,1899,416,979,269,147,215,30,24,54,93,2019
123,Paul Millsap,DEN,70,1895,141,342,81,60,54,13,14,12,48,2019
124,Rodney Hood,POR,72,1893,126,302,76,50,53,15,8,10,40,2019
125,Dwyane Wade,MIA,72,1885,301,704,199,102,148,41,10,33,69,2019
126,Reggie Bullock,LAL,63,1879,129,307,80,49,53,21,6,17,32,2019
127,Malik Beasley,DEN,81,1879,97,225,66,31,45,19,2,7,24,2019
128,Gordon Hayward,BOS,72,1863,244,592,140,104,91,28,21,26,78,2019
129,Chris Paul,HOU,58,1857,473,1181,238,235,195,28,15,75,160,2019
130,Anthony Davis,NOP,56,1850,218,516,138,80,100,26,12,16,64,2019
131,Rudy Gay,SAS,69,1842,182,421,125,57,62,43,20,17,40,2019
132,Domantas Sabonis,IND,74,1838,212,493,143,69,85,22,36,18,51,2019
133,Malcolm Brogdon,MIL,64,1832,205,500,115,90,91,19,5,29,61,2019
134,John Collins,ATL,61,1829,121,288,75,46,54,17,4,18,28,2019
135,Marco Belinelli,SAS,79,1815,132,321,75,57,41,20,14,19,38,2019
136,Kelly Olynyk,MIA,79,1812,140,348,72,68,50,15,7,28,40,2019
137,Landry Shamet,LAC,79,1802,117,275,76,41,52,15,9,11,30,2019
138,Larry Nance Jr.,CLE,67,1795,214,520,122,92,75,21,26,24,68,2019
139,Terry Rozier,BOS,79,1791,231,569,124,107,77,30,17,21,86,2019
140,Nemanja Bjelica,SAC,77,1788,147,350,91,56,61,16,14,21,35,2019
141,Derrick Favors,UTA,76,1766,89,222,45,44,36,5,4,18,26,2019
142,Brandon Ingram,LAL,52,1760,154,356,106,48,79,22,5,14,34,2019
143,Fred VanVleet,TOR,64,1760,307,731,190,117,97,56,37,47,70,2019
144,Darius Miller,NOP,69,1758,146,336,102,44,68,25,9,15,29,2019
145,Josh Okogie,MIN,74,1745,91,204,69,22,49,7,13,12,10,2019
146,Langston Galloway,DET,80,1745,85,205,50,35,33,13,4,15,20,2019
147,Mason Plumlee,DEN,82,1731,243,569,160,83,96,40,24,22,61,2019
148,Derrick White,SAS,67,1728,263,598,191,72,102,52,37,22,50,2019
149,Jabari Parker,WAS,64,1724,152,369,87,65,67,13,7,24,41,2019
150,Noah Vonleh,NYK,68,1722,129,315,72,57,31,10,31,4,53,2019
151,Josh Hart,LAL,67,1715,93,231,48,45,37,8,3,17,28,2019
152,DeMarre Carroll,BKN,67,1703,85,205,50,35,37,11,2,10,25,2019
153,Delon Wright,MEM,75,1698,248,622,122,126,64,35,23,49,77,2019
154,Miles Bridges,CHA,80,1696,95,224,61,34,40,17,4,7,27,2019
155,Taj Gibson,MIN,70,1686,84,200,52,32,28,15,9,5,27,2019
156,Otto Porter Jr.,CHI,56,1684,120,275,85,35,71,11,3,10,25,2019
157,Lauri Markkanen,CHI,52,1682,75,179,46,29,29,8,9,9,20,2019
158,Hassan Whiteside,MIA,72,1674,56,131,37,19,19,15,3,2,17,2019
159,Royce O'Neale,UTA,82,1671,124,307,65,59,55,5,5,26,33,2019
160,JaVale McGee,LAL,75,1671,52,124,32,20,24,3,5,4,16,2019
161,Dwight Powell,DAL,77,1662,112,271,65,47,33,13,19,11,36,2019
162,Kent Bazemore,ATL,67,1643,152,368,88,64,68,15,5,24,40,2019
163,Enes Kanter,POR,67,1640,116,273,75,41,42,14,19,5,36,2019
164,Gary Harris,DEN,57,1639,127,298,83,44,57,20,6,7,37,2019
165,Davis Bertans,SAS,76,1632,100,236,64,36,32,22,10,14,22,2019
166,Justin Jackson,DAL,81,1613,96,218,70,26,45,13,12,4,22,2019
167,Dewayne Dedmon,ATL,64,1609,90,214,56,34,41,10,5,7,27,2019
168,Emmanuel Mudiay,NYK,59,1607,228,564,120,108,94,15,11,27,81,2019
169,Robin Lopez,CHI,74,1606,89,207,60,29,32,9,19,8,21,2019
170,Evan Turner,POR,73,1606,283,696,153,130,113,19,21,19,111,2019
171,Jalen Brunson,DAL,73,1591,230,555,135,95,91,28,16,27,68,2019
172,Andre Iguodala,GSW,68,1578,216,505,143,73,90,20,33,23,50,2019
173,Marvin Bagley III,SAC,62,1567,62,146,40,22,26,10,4,6,16,2019
174,Tyus Jones,MIN,68,1560,327,781,200,127,121,33,46,23,104,2019
175,Taurean Prince,ATL,55,1552,118,283,71,47,52,14,5,25,22,2019
176,Rodney McGruder,MIA,66,1550,112,265,71,41,55,9,7,8,33,2019
177,Alex Len,ATL,77,1544,86,205,53,33,34,8,11,4,29,2019
178,Tyler Johnson,PHX,57,1529,166,396,102,64,64,28,10,25,39,2019
179,Jaren Jackson Jr.,MEM,58,1515,64,152,40,24,26,8,6,7,17,2019
180,Dennis Smith Jr.,NYK,53,1508,252,619,137,115,102,19,16,33,82,2019
181,Torrey Craig,DEN,75,1503,72,176,40,32,25,10,5,9,23,2019
182,Maxi Kleber,DAL,71,1502,70,180,30,40,24,6,0,9,31,2019
183,Thomas Bryant,WAS,72,1496,92,218,58,34,42,7,9,8,26,2019
184,Kevon Looney,GSW,80,1481,123,300,69,54,21,17,31,16,38,2019
185,Iman Shumpert,HOU,62,1481,112,266,70,42,46,11,13,14,28,2019
186,Gerald Green,HOU,73,1473,40,99,21,19,18,2,1,11,8,2019
187,T.J. McConnell,PHI,76,1470,258,615,159,99,116,24,19,21,78,2019
188,E'Twaun Moore,NOP,53,1463,102,235,71,31,49,11,11,7,24,2019
189,Allonzo Trier,NYK,64,1458,119,286,71,48,52,10,9,10,38,2019
190,Bruce Brown,DET,74,1449,91,228,45,46,33,8,4,12,34,2019
191,Ed Davis,BKN,81,1446,61,156,27,34,14,4,9,3,31,2019
192,Wayne Selden,CHI,75,1438,109,244,83,26,57,17,9,10,16,2019
193,Luke Kennard,DET,63,1437,114,285,57,57,42,12,3,19,38,2019
194,Jeremy Lin,TOR,74,1436,231,546,147,84,107,28,12,34,50,2019
195,Shaquille Harrison,CHI,73,1430,139,329,88,51,57,21,10,21,30,2019
196,Lonzo Ball,LAL,47,1423,255,571,194,61,160,20,14,16,45,2019
197,Maurice Harkless,POR,60,1415,74,175,47,27,24,14,9,7,20,2019
198,Tyreke Evans,IND,69,1402,166,374,124,42,76,22,26,19,23,2019
199,Seth Curry,POR,74,1399,66,161,37,29,23,7,7,6,23,2019
200,Mike Scott,PHI,79,1396,66,151,47,19,36,7,4,5,14,2019
201,Kris Dunn,CHI,46,1389,277,662,169,108,105,47,17,28,80,2019
202,Derrick Rose,MIN,51,1380,220,505,155,65,104,30,21,14,51,2019
203,Alec Burks,SAC,64,1375,128,303,81,47,57,16,8,16,31,2019
204,JaMychal Green,LAC,65,1371,50,111,39,11,25,10,4,2,9,2019
205,Rajon Rondo,LAL,46,1369,367,861,240,127,180,24,36,32,95,2019
206,Mitchell Robinson,NYK,66,1360,37,83,28,9,7,7,14,1,8,2019
207,Juancho Hernangomez,DEN,70,1358,55,135,30,25,19,9,2,6,19,2019
208,Zach Collins,POR,77,1356,71,166,47,24,33,5,9,3,21,2019
209,OG Anunoby,TOR,67,1352,47,113,28,19,18,8,2,8,11,2019
210,T.J. Warren,PHX,43,1348,64,159,33,31,26,2,5,10,21,2019
211,Doug McDermott,IND,77,1340,67,151,50,17,32,12,6,3,14,2019
212,Kyle Korver,UTA,70,1334,81,188,55,26,45,5,5,10,16,2019
213,Vince Carter,ATL,76,1330,87,209,52,35,39,11,2,8,27,2019
214,Jake Layman,POR,71,1327,53,132,27,26,18,6,3,7,19,2019
215,Mike Muscala,LAL,64,1306,76,186,42,34,32,3,7,5,29,2019
216,Tony Snell,MIL,74,1304,68,156,48,20,38,6,4,7,13,2019
217,George Hill,MIL,60,1302,135,316,89,46,60,17,12,17,29,2019
218,Bobby Portis,WAS,50,1298,72,161,55,17,39,6,10,4,13,2019
219,Wayne Ellington,DET,53,1297,72,165,51,21,40,9,2,8,13,2019
220,Rodions Kurucs,BKN,63,1294,52,123,33,19,28,4,1,3,16,2019
221,Kyle Anderson,MEM,43,1281,128,295,89,39,60,18,11,15,24,2019
222,Jakob Poeltl,SAS,77,1273,93,219,60,33,17,18,25,8,25,2019
223,Markieff Morris,OKC,58,1271,79,190,47,32,38,5,4,10,22,2019
224,Jeff Teague,MIN,42,1264,343,805,224,119,144,51,29,35,84,2019
225,Pat Connaughton,MIL,61,1261,122,297,69,53,48,11,10,14,39,2019
226,Malik Monk,CHA,73,1258,117,260,91,26,70,16,5,5,21,2019
227,Ish Smith,DET,56,1251,203,512,97,106,69,15,13,37,69,2019
228,Elfrid Payton,NOP,42,1250,320,743,217,103,138,57,22,22,81,2019
229,Shelvin Mack,CHA,57,1247,183,427,122,61,63,40,19,16,45,2019
230,Nikola Mirotic,MIL,46,1245,55,127,38,17,27,8,3,4,13,2019
231,Cody Zeller,CHA,49,1243,102,244,62,40,38,8,16,9,31,2019
232,Rondae Hollis-Jefferson,BKN,59,1234,96,246,42,54,36,3,3,16,38,2019
233,Wes Iwundu,ORL,68,1233,73,172,47,26,25,11,11,6,20,2019
234,Ersan Ilyasova,MIL,67,1231,52,129,27,25,21,3,3,6,19,2019
235,James Ennis III,PHI,58,1230,41,96,27,14,19,5,3,4,10,2019
236,Jared Dudley,BKN,59,1220,83,203,46,37,36,8,2,9,28,2019
237,Jonas Jerebko,GSW,73,1218,96,231,57,39,21,13,23,7,32,2019
238,Stanley Johnson,NOP,66,1207,88,220,44,44,28,8,8,15,29,2019
239,Mario Hezonja,NYK,58,1206,88,201,63,25,53,4,6,6,19,2019
240,Robert Covington,MIN,35,1203,46,109,29,17,19,7,3,7,10,2019
241,Jamal Crawford,PHX,64,1199,229,501,186,43,140,32,14,13,30,2019
242,Tristan Thompson,CLE,43,1198,86,203,55,31,27,11,17,2,29,2019
243,Will Barton,DEN,43,1189,124,286,86,38,51,24,11,15,23,2019
244,Richaun Holmes,PHX,70,1184,60,143,37,23,19,8,10,3,20,2019
245,Michael Kidd-Gilchrist,CHA,64,1179,61,159,24,37,19,3,2,6,31,2019
246,Wilson Chandler,LAC,51,1176,82,192,54,28,38,10,6,5,23,2019
247,Frank Jackson,NOP,61,1169,69,158,49,20,27,15,7,4,16,2019
248,James Johnson,MIA,55,1164,135,336,69,66,50,12,7,12,54,2019
249,Derrick Jones Jr.,MIA,60,1153,37,96,15,22,10,2,3,9,13,2019
250,Victor Oladipo,IND,36,1147,186,429,129,57,73,29,27,24,33,2019
251,Dion Waiters,MIA,44,1138,121,302,61,60,41,12,8,24,36,2019
252,Allen Crabbe,BKN,43,1133,46,107,31,15,21,7,3,5,10,2019
253,Norman Powell,TOR,60,1126,91,219,54,37,31,16,7,13,24,2019
254,Trey Burke,DAL,58,1124,159,386,91,68,58,16,17,10,58,2019
255,Lance Stephenson,LAL,68,1123,140,321,99,41,74,16,9,11,30,2019
256,Trey Lyles,DEN,63,1120,87,203,58,29,39,15,4,5,24,2019
257,Tim Frazier,MIL,59,1120,248,585,159,89,112,29,18,22,67,2019
258,Wendell Carter Jr.,CHI,44,1110,78,195,39,39,27,8,4,12,27,2019
259,John Wall,WAS,32,1104,279,659,178,101,122,23,33,33,68,2019
260,Jonas Valanciunas,MEM,49,1091,70,166,44,26,24,10,10,7,19,2019
261,Ante Zizic,CLE,59,1082,53,132,27,26,13,7,7,3,23,2019
262,Kenrich Williams,NOP,46,1079,83,196,53,30,36,13,4,9,21,2019
263,Devin Harris,DAL,68,1071,122,297,69,53,46,11,12,13,40,2019
264,Anthony Tolliver,MIN,65,1067,46,102,36,10,18,8,10,4,6,2019
265,Yogi Ferrell,SAC,71,1067,137,330,81,56,41,26,14,12,44,2019
266,Jonathon Simmons,PHI,56,1064,128,311,73,55,35,19,19,7,48,2019
267,Caris LeVert,BKN,40,1063,156,392,76,80,54,18,4,13,67,2019
268,Quinn Cook,GSW,74,1059,116,261,87,29,44,15,28,9,20,2019
269,Nerlens Noel,OKC,77,1055,45,112,23,22,19,2,2,4,18,2019
270,Ivica Zubac,LAC,59,1039,63,146,43,20,20,8,15,2,18,2019
271,Sterling Brown,MIL,58,1034,84,198,54,30,43,7,4,6,24,2019
272,Gorgui Dieng,MIN,76,1031,72,172,44,28,27,10,7,5,23,2019
273,Nik Stauskas,CLE,68,1015,81,193,50,31,38,10,2,15,16,2019
274,Alfonzo McKinnie,GSW,72,1003,31,76,17,14,11,1,5,2,12,2019
275,Tony Parker,CHA,56,1003,207,502,119,88,76,24,19,23,65,2019
276,Goran Dragic,MIA,36,991,174,404,118,56,87,25,6,13,43,2019
277,David Nwaba,CLE,51,984,54,132,30,24,22,7,1,4,20,2019
278,De'Anthony Melton,PHX,50,984,159,367,110,49,71,20,19,17,32,2019
279,Shabazz Napier,BKN,56,983,143,337,92,51,73,15,4,12,39,2019
280,Danuel House Jr.,HOU,39,979,40,101,19,21,16,3,0,8,13,2019
281,Ian Clark,NOP,60,973,94,210,72,22,46,19,7,8,14,2019
282,Thon Maker,DET,64,972,45,107,28,17,17,8,3,7,10,2019
283,Shaun Livingston,GSW,64,967,114,275,67,47,37,18,12,12,35,2019
284,Elie Okobo,PHX,53,958,127,298,83,44,55,16,12,7,37,2019
285,Jerian Grant,ORL,60,939,156,366,102,54,42,17,43,11,43,2019
286,Jahlil Okafor,NOP,59,935,40,89,31,9,20,7,4,4,5,2019
287,Dante Cunningham,SAS,64,928,50,113,37,13,17,9,11,1,12,2019
288,Daniel Theis,BOS,66,908,68,166,38,30,19,9,10,7,23,2019
289,Frank Ntilikina,NYK,43,904,121,284,79,42,51,15,13,7,35,2019
290,Cheick Diallo,NOP,64,896,33,81,18,15,13,2,3,3,12,2019
291,Chandler Hutchison,CHI,44,895,34,78,24,10,16,4,4,2,8,2019
292,D.J. Wilson,MIL,48,882,52,132,24,28,14,3,7,8,20,2019
293,Solomon Hill,NOP,44,878,55,129,36,19,23,11,2,1,18,2019
294,Zaza Pachulia,DET,68,878,91,206,67,24,33,13,21,4,20,2019
295,Meyers Leonard,POR,61,878,75,181,44,31,25,9,10,5,26,2019
296,Tyson Chandler,LAL,55,875,37,88,23,14,11,4,8,4,10,2019
297,Patrick Patterson,OKC,63,861,31,72,21,10,14,1,6,0,10,2019
298,CJ Miles,MEM,53,856,36,78,30,6,23,4,3,2,4,2019
299,Antonio Blakeney,CHI,57,829,42,101,25,17,15,6,4,0,17,2019
300,Dragan Bender,PHX,46,826,56,138,30,26,20,7,3,4,22,2019
301,Aron Baynes,BOS,51,821,57,144,27,30,7,9,11,1,29,2019
302,Harry Giles III,SAC,58,820,85,190,65,20,46,10,9,6,14,2019
303,Matthew Dellavedova,CLE,48,812,181,416,127,54,101,17,9,15,39,2019
304,Willy Hernangomez,CHA,58,812,60,144,36,24,26,5,5,8,16,2019
305,Omari Spellman,ATL,46,805,47,116,25,22,20,2,3,4,18,2019
306,Bruno Caboclo,MEM,34,800,50,120,30,20,20,8,2,5,15,2019
307,Dirk Nowitzki,DAL,51,795,35,83,22,13,12,7,3,4,9,2019
308,Sam Dekker,WAS,47,789,46,107,31,15,18,8,5,2,13,2019
309,Jordan Bell,GSW,68,788,76,181,47,29,21,9,17,11,18,2019
310,Luke Kornet,NYK,46,784,54,126,36,18,20,7,9,5,13,2019
311,Lance Thomas,NYK,46,783,27,63,18,9,13,2,3,2,7,2019
312,Bismack Biyombo,CHA,54,783,33,78,21,12,6,5,10,3,9,2019
313,DeMarcus Cousins,GSW,30,771,107,255,66,41,47,6,13,5,36,2019
314,Mo Bamba,ORL,47,766,39,89,28,11,5,10,13,1,10,2019
315,Troy Daniels,PHX,51,760,26,59,19,7,14,5,0,2,5,2019
316,Dwayne Bacon,CHA,43,759,47,120,21,26,14,4,3,7,19,2019
317,Frank Kaminsky,CHA,47,755,63,150,39,24,24,5,10,12,12,2019
318,J.J. Barea,DAL,38,752,211,500,133,78,112,15,6,17,61,2019
319,Marcin Gortat,LAC,47,751,65,148,47,18,25,4,18,4,14,2019
320,Cristiano Felicio,CHI,60,746,37,84,27,10,14,6,7,2,8,2019
321,Chasson Randle,WAS,49,743,97,228,63,34,42,13,8,9,25,2019
322,Brandon Knight,CLE,39,737,71,179,34,37,21,8,5,11,26,2019
323,Troy Brown Jr.,WAS,52,730,80,183,57,23,39,10,8,4,19,2019
324,Kenneth Faried,HOU,37,728,20,53,7,13,5,2,0,4,9,2019
325,Ivan Rabb,MEM,49,721,54,128,34,20,27,1,6,4,16,2019
326,Treveon Graham,BKN,35,715,34,83,19,15,13,5,1,4,11,2019
327,Cameron Payne,CLE,40,712,106,243,75,31,54,9,12,15,16,2019
328,Tyler Dorsey,MEM,48,698,56,138,30,26,24,5,1,11,15,2019
329,Abdel Nader,OKC,61,694,20,46,14,6,8,5,1,1,5,2019
330,Joakim Noah,MEM,42,693,89,200,67,22,37,13,17,7,15,2019
331,Boban Marjanovic,PHI,57,681,54,119,43,11,26,11,6,3,8,2019
332,Furkan Korkmaz,PHI,48,679,52,126,30,22,21,8,1,6,16,2019
333,Devonte' Graham,CHA,46,676,121,278,85,36,59,18,8,9,27,2019
334,Timothe Luwawu-Cabarrot,CHI,50,669,26,54,24,2,15,8,1,2,0,2019
335,Dante Exum,UTA,42,664,110,260,70,40,57,4,9,13,27,2019
336,Jerryd Bayless,MIN,34,657,119,289,68,51,47,10,11,11,40,2019
337,Aaron Holiday,IND,50,646,87,195,66,21,39,18,9,9,12,2019
338,Khem Birch,ORL,50,643,38,88,26,12,11,6,9,3,9,2019
339,Gary Clark,HOU,51,641,18,48,6,12,6,0,0,3,9,2019
340,Jonah Bolden,PHI,44,639,40,97,23,17,11,7,5,1,16,2019
341,Jose Calderon,DET,48,632,115,282,63,52,45,13,5,21,31,2019
342,Isaiah Canaan,MIL,30,628,84,198,54,30,29,12,13,10,20,2019
343,Tyrone Wallace,LAC,62,628,42,98,28,14,18,6,4,3,11,2019
344,Glenn Robinson III,DET,47,610,21,56,7,14,4,2,1,5,9,2019
345,Thabo Sefolosha,UTA,50,609,27,70,11,16,11,0,0,3,13,2019
346,Kevin Love,CLE,22,598,48,112,32,16,25,6,1,4,12,2019
347,Semi Ojeleye,BOS,56,594,23,58,11,12,6,2,3,2,10,2019
348,Alex Abrines,OKC,31,588,20,52,8,12,5,2,1,3,9,2019
349,Jevon Carter,MEM,39,577,69,165,42,27,27,8,7,3,24,2019
350,Isaiah Briscoe,ORL,39,559,87,221,40,47,20,7,13,8,39,2019
351,Nene,HOU,42,546,26,70,8,18,4,2,2,5,13,2019
352,Wesley Johnson,WAS,38,534,23,49,20,3,12,2,6,1,2,2019
353,Alex Caruso,LAL,25,531,77,173,58,19,41,10,7,3,16,2019
354,Amir Johnson,PHI,51,529,60,143,37,23,13,9,15,7,16,2019
355,Hamidou Diallo,OKC,51,526,17,42,9,8,8,1,0,4,4,2019
356,TJ Leaf,IND,58,522,24,57,15,9,8,6,1,3,6,2019
357,Omri Casspi,MEM,36,520,26,58,20,6,11,4,5,3,3,2019
358,Georges Niang,UTA,59,516,35,81,24,11,19,3,2,3,8,2019
359,Keita Bates-Diop,MIN,30,503,17,37,14,3,9,3,2,1,2,2019
360,Kosta Koufos,SAC,42,502,36,94,14,22,3,8,3,7,15,2019
361,Marquese Chriss,CLE,43,499,22,56,10,12,6,2,2,1,11,2019
362,Ian Mahinmi,WAS,34,498,25,58,17,8,12,2,3,2,6,2019
363,Chandler Parsons,MEM,25,496,43,104,25,18,16,5,4,10,8,2019
364,Corey Brewer,SAC,31,492,39,90,27,12,16,8,3,2,10,2019
365,Greg Monroe,PHI,43,480,24,54,18,6,13,3,2,3,3,2019
366,Raul Neto,UTA,37,474,93,231,48,45,37,4,7,17,28,2019
367,Justin Anderson,ATL,48,463,23,57,12,11,7,3,2,3,8,2019
368,Ryan Broekhoff,DAL,42,453,22,52,14,8,11,2,1,2,6,2019
369,Moritz Wagner,LAL,43,446,24,57,15,9,9,3,3,3,6,2019
370,Svi Mykhailiuk,DET,42,440,37,81,30,7,22,7,1,3,4,2019
371,Jaron Blossomgame,CLE,27,439,13,34,5,8,4,1,0,0,8,2019
372,Frank Mason,SAC,38,435,84,196,56,28,31,16,9,2,26,2019
373,Courtney Lee,DAL,34,428,37,95,16,21,8,5,3,6,15,2019
374,Jaylen Adams,ATL,34,428,65,164,31,34,25,4,2,10,24,2019
375,Markelle Fultz,PHI,19,427,59,145,32,27,20,6,6,7,20,2019
376,Grayson Allen,UTA,38,416,25,58,17,8,10,5,2,2,6,2019
377,Kadeem Allen,NYK,19,416,76,187,41,35,28,3,10,7,28,2019
378,Donte DiVincenzo,MIL,27,411,31,72,21,10,17,3,1,2,8,2019
379,Damian Jones,GSW,24,410,28,62,22,6,5,3,14,3,3,2019
380,Jon Leuer,DET,41,402,14,32,10,4,3,2,5,1,3,2019
381,Salah Mejri,DAL,36,399,35,81,24,11,7,6,11,3,8,2019
382,Patrick McCaw,TOR,29,397,29,78,9,20,7,0,2,4,16,2019
383,MarShon Brooks,MEM,29,387,25,57,18,7,15,1,2,0,7,2019
384,Luol Deng,MIN,22,380,18,40,14,4,10,3,1,2,2,2019
385,Raymond Felton,OKC,33,379,52,126,30,22,25,4,1,7,15,2019
386,Damion Lee,GSW,32,375,13,32,7,6,6,0,1,0,6,2019
387,Michael Carter-Williams,ORL,28,372,70,174,36,34,23,9,4,5,29,2019
388,Johnathan Williams,LAL,24,372,13,32,7,6,6,0,1,1,5,2019
389,Kyle O'Quinn,IND,45,371,56,129,39,17,28,7,4,3,14,2019
390,Pau Gasol,MIL,30,361,52,120,36,16,17,7,12,6,10,2019
391,Brad Wanamaker,BOS,36,343,56,129,39,17,21,9,9,6,11,2019
392,Channing Frye,CLE,36,341,20,49,11,9,7,4,0,1,8,2019
393,John Jenkins,NYK,26,333,22,51,15,7,12,1,2,2,5,2019
394,Jordan McRae,WAS,27,333,30,69,21,9,19,1,1,2,7,2019
395,Dillon Brooks,MEM,18,330,16,40,8,8,7,0,1,1,7,2019
396,Jarell Martin,ORL,42,328,18,43,11,7,5,3,3,3,4,2019
397,Ryan Anderson,MIA,25,321,19,45,12,7,9,2,1,3,4,2019
398,Jerome Robinson,LAC,33,320,19,44,13,6,9,4,0,4,2,2019
399,Ekpe Udoh,UTA,51,320,28,71,13,15,7,4,2,6,9,2019
400,Sindarius Thornwell,LAC,64,313,18,43,11,7,7,4,0,1,6,2019
401,Troy Williams,SAC,21,312,11,26,7,4,1,3,3,2,2,2019
402,Alex Poythress,ATL,21,305,17,45,6,11,2,3,1,2,9,2019
403,Carmelo Anthony,HOU,10,294,5,13,2,3,2,0,0,3,0,2019
404,Quincy Pondexter,SAS,53,292,24,54,18,6,8,8,2,1,5,2019
405,Robert Williams III,BOS,32,283,7,15,6,1,4,0,2,1,0,2019
406,Michael Beasley,LAL,26,277,25,56,19,6,16,2,1,6,0,2019
407,Shake Milton,PHI,20,268,18,39,15,3,10,5,0,0,3,2019
408,Cameron Reynolds,MIN,19,259,13,31,8,5,5,2,1,1,4,2019
409,Henry Ellenson,NYK,19,259,16,40,8,8,7,0,1,0,8,2019
410,Julian Washburn,MEM,18,254,14,33,9,5,7,1,1,2,3,2019
411,Guerschon Yabusele,BOS,41,251,15,38,7,8,5,0,2,1,7,2019
412,Christian Wood,NOP,21,250,8,20,4,4,3,1,0,1,3,2019
413,Deonte Burton,OKC,32,240,9,25,2,7,2,0,0,5,2,2019
414,Dwight Howard,WAS,9,230,4,8,4,0,2,0,2,0,0,2019
415,JR Smith,CLE,11,222,21,46,17,4,13,1,3,2,2,2019
416,Isaiah Hartenstein,HOU,28,221,15,41,4,11,3,0,1,3,8,2019
417,Brandon Sampson,CHI,14,214,10,26,4,6,3,0,1,1,5,2019
418,Jalen Jones,CLE,16,214,7,19,2,5,2,0,0,2,3,2019
419,Lorenzo Brown,TOR,26,212,28,69,15,13,13,2,0,2,11,2019
420,Theo Pinson,BKN,18,211,21,49,14,7,7,6,1,1,6,2019
421,Edmond Sumner,IND,23,210,10,21,9,1,4,2,3,1,0,2019
422,Daniel Hamilton,ATL,19,204,22,50,16,6,13,1,2,0,6,2019
423,Jacob Evans,GSW,30,204,23,52,17,6,7,3,7,1,5,2019
424,Khyri Thomas,DET,26,195,8,19,5,3,5,0,0,1,2,2019
425,Deng Adel,CLE,19,194,5,12,3,2,0,3,0,0,2,2019
426,Jason Smith,NOP,20,191,14,34,8,6,3,4,1,0,6,2019
427,John Henson,MIL,14,188,14,32,10,4,10,0,0,0,4,2019
428,Andrew Harrison,NOP,17,186,24,57,15,9,11,4,0,2,7,2019
429,Isaiah Thomas,DEN,12,181,23,53,16,7,10,6,0,2,5,2019
430,Caleb Swanigan,SAC,21,178,11,27,6,5,3,2,1,1,4,2019
431,Skal Labissiere,POR,22,176,11,28,5,6,3,0,2,2,4,2019
432,Yuta Watanabe,MEM,15,174,8,20,4,4,4,0,0,1,3,2019
433,Miles Plumlee,ATL,18,173,17,40,11,6,6,2,3,1,5,2019
434,Walter Lemon Jr.,CHI,6,167,30,72,18,12,15,3,0,3,9,2019
435,Dairis Bertans,NOP,12,167,10,23,7,3,5,1,1,0,3,2019
436,Chris Boucher,TOR,28,163,2,5,1,1,0,0,1,0,1,2019
437,Duncan Robinson,MIA,15,161,5,10,5,0,3,2,0,0,0,2019
438,Ben McLemore,SAC,19,158,4,11,1,3,0,1,0,1,2,2019
439,Johnathan Motley,LAC,22,156,11,24,9,2,4,4,1,1,1,2019
440,Ron Baker,WAS,15,152,15,36,9,6,7,0,2,1,5,2019
441,Milos Teodosic,LAC,15,150,32,75,21,11,14,4,3,4,7,2019
442,Ray Spalding,PHX,14,148,5,13,2,3,1,1,0,0,3,2019
443,Chimezie Metu,SAS,29,145,13,31,8,5,4,4,0,2,3,2019
444,Jemerrio Jones,LAL,6,143,13,34,5,8,3,1,1,0,8,2019
445,Anfernee Simons,POR,20,140,13,30,9,4,5,0,4,0,4,2019
446,Andrew Bogut,GSW,11,134,11,25,8,3,6,2,0,0,3,2019
447,C.J. Williams,MIN,15,128,12,27,9,3,4,2,3,1,2,2019
448,JaKarr Sampson,CHI,4,127,4,8,4,0,2,1,1,0,0,2019
449,Quincy Acy,PHX,10,123,8,21,3,5,2,0,1,1,4,2019
450,Rawle Alkins,CHI,10,120,13,31,8,5,6,2,0,2,3,2019
451,Isaac Bonga,LAL,22,120,15,34,11,4,8,2,1,0,4,2019
452,Deyonta Davis,ATL,9,118,5,12,3,2,1,0,2,0,2,2019
453,Lonnie Walker IV,SAS,17,118,9,20,7,2,5,2,0,1,1,2019
454,Drew Eubanks,SAS,23,113,7,14,7,0,2,1,4,0,0,2019
455,Jared Terrell,MIN,14,111,12,31,5,7,5,0,0,2,5,2019
456,Zhaire Smith,PHI,6,111,10,23,7,3,4,3,0,0,3,2019
457,Gary Trent Jr.,POR,15,111,5,11,4,1,2,1,1,1,0,2019
458,Jodie Meeks,TOR,8,104,8,19,5,3,5,0,0,1,2,2019
459,Malachi Richardson,TOR,22,103,0,0,0,0,0,0,0,0,0,2019
460,James Nunnally,HOU,15,102,7,17,4,3,1,2,1,2,1,2019
461,Bonzie Colson,MIL,8,98,3,6,3,0,3,0,0,0,0,2019
462,Devin Robinson,WAS,7,95,6,15,3,3,2,0,1,0,3,2019
463,Wade Baldwin IV,POR,16,94,12,28,8,4,5,2,1,0,4,2019
464,Tyler Lydon,DEN,25,94,6,17,1,5,0,0,1,2,3,2019
465,Tyler Zeller,MEM,6,93,4,8,4,0,3,1,0,0,0,2019
466,Daryl Macon,DAL,8,90,7,17,4,3,3,0,1,0,3,2019
467,Naz Mitrou-Long,UTA,14,84,15,35,10,5,9,0,1,3,2,2019
468,Udonis Haslem,MIA,10,74,2,4,2,0,2,0,0,0,0,2019
469,Jarred Vanderbilt,DEN,17,69,3,6,3,0,2,0,1,0,0,2019
470,Amile Jefferson,ORL,12,68,3,7,2,1,0,1,1,0,1,2019
471,Marcus Derrickson,GSW,11,67,1,3,0,1,0,0,0,0,1,2019
472,Malcolm Miller,TOR,10,67,1,3,0,1,0,0,0,0,1,2019
473,Jimmer Fredette,PHX,6,65,8,18,6,2,5,1,0,0,2,2019
474,Alize Johnson,IND,14,64,1,2,1,0,1,0,0,0,0,2019
475,Jawun Evans,OKC,8,64,10,22,8,2,5,3,0,1,1,2019
476,Billy Garrett,NYK,4,63,7,17,4,3,3,1,0,1,2,2019
477,Luc Mbah a Moute,LAC,4,61,2,4,2,0,2,0,0,0,0,2019
478,Brandon Goodwin,DEN,16,57,14,36,6,8,3,1,2,3,5,2019
479,Isaac Humphries,ATL,5,56,0,0,0,0,0,0,0,0,0,2019
480,Jordan Loyd,TOR,12,55,6,16,2,4,1,1,0,2,2,2019
481,PJ Dozier,BOS,6,51,5,11,4,1,3,1,0,1,0,2019
482,BJ Johnson,SAC,7,49,0,0,0,0,0,0,0,0,0,2019
483,Mitchell Creek,MIN,5,47,6,14,4,2,2,2,0,0,2,2019
484,Davon Reed,IND,10,47,3,8,1,2,0,0,1,1,1,2019
485,Melvin Frazier Jr.,ORL,10,44,1,3,0,1,0,0,0,0,1,2019
486,Eric Moreland,TOR,5,43,4,10,2,2,1,0,1,0,2,2019
487,Haywood Highsmith,PHI,5,40,2,4,2,0,2,0,0,0,0,2019
488,Tyler Cavanaugh,UTA,11,39,1,2,1,0,0,1,0,0,0,2019
489,Demetrius Jackson,PHI,6,39,5,14,1,4,0,1,0,1,3,2019
490,Dzanan Musa,BKN,9,39,2,5,1,1,1,0,0,0,1,2019
491,Nick Young,DEN,4,37,2,5,1,1,0,1,0,0,1,2019
492,Thomas Welsh,DEN,11,36,5,11,4,1,2,0,2,0,1,2019
493,Tony Bradley,UTA,3,36,1,3,0,1,0,0,0,0,1,2019
494,Chris Chiozza,HOU,7,33,4,10,2,2,1,1,0,0,2,2019
495,Isaiah Hicks,NYK,3,32,2,5,1,1,1,0,0,0,1,2019
496,Jaylen Morris,MIL,4,28,4,10,2,2,2,0,0,1,1,2019
497,Dusty Hannahs,MEM,2,26,5,11,4,1,3,1,0,0,1,2019
498,RJ Hunter,BOS,1,26,3,8,1,2,1,0,0,0,2,2019
499,Alan Williams,BKN,5,26,3,8,1,2,1,0,0,1,1,2019
0,LeBron James,CLE,82,3026,747,1838,403,344,285,55,63,130,214,2018
1,Khris Middleton,MIL,82,2982,328,758,226,102,174,31,21,38,64,2018
2,Andrew Wiggins,MIN,82,2979,160,381,99,61,56,22,21,23,38,2018
3,Bradley Beal,WAS,82,2977,373,878,241,132,121,75,45,37,95,2018
4,Jrue Holiday,NOP,81,2927,486,1140,318,168,208,70,40,49,119,2018
5,CJ McCollum,POR,81,2923,272,649,167,105,108,29,30,32,73,2018
6,Karl-Anthony Towns,MIN,82,2918,199,456,141,58,81,31,29,18,40,2018
7,Russell Westbrook,OKC,80,2914,820,1950,510,310,371,83,56,86,224,2018
8,Paul George,OKC,79,2891,263,626,163,100,112,29,22,40,60,2018
9,Giannis Antetokounmpo,MIL,75,2756,361,894,189,172,122,34,33,59,113,2018
10,Kemba Walker,CHA,80,2736,444,1035,297,147,171,66,60,33,114,2018
11,Ben Simmons,PHI,81,2732,661,1624,359,302,250,52,57,46,256,2018
12,Anthony Davis,NOP,75,2727,174,423,99,75,59,27,13,23,52,2018
13,Taj Gibson,MIN,82,2727,99,237,60,39,35,10,15,9,30,2018
14,DeMar DeRozan,TOR,80,2712,417,1035,216,201,136,54,26,56,145,2018
15,Josh Richardson,MIA,81,2689,231,550,143,88,96,28,19,26,62,2018
16,Will Barton,DEN,81,2683,331,782,211,120,151,39,21,26,94,2018
17,Damian Lillard,POR,73,2670,481,1110,333,148,219,75,39,40,108,2018
18,Tobias Harris,LAC,80,2668,192,473,103,89,76,16,11,30,59,2018
19,Donovan Mitchell,UTA,79,2638,291,712,161,130,123,19,19,53,77,2018
20,Harrison Barnes,DAL,77,2634,152,391,65,87,38,12,15,23,64,2018
21,Andre Drummond,DET,78,2625,237,526,185,52,94,44,47,12,40,2018
22,Thaddeus Young,IND,81,2607,152,367,89,63,59,11,19,25,38,2018
23,Lou Williams,LAC,79,2589,417,929,322,95,264,41,17,34,61,2018
24,E'Twaun Moore,NOP,82,2586,187,430,131,56,80,34,17,16,40,2018
25,Joe Ingles,UTA,82,2579,392,886,290,102,210,44,36,41,61,2018
26,Jamal Murray,DEN,81,2565,274,653,169,105,91,44,34,17,88,2018
27,Victor Oladipo,IND,75,2552,323,751,218,105,140,31,47,33,72,2018
28,James Harden,HOU,72,2551,630,1501,389,241,359,16,14,76,165,2018
29,Robert Covington,PHI,80,2531,156,367,101,55,73,15,13,14,41,2018
30,Kyle Lowry,TOR,78,2510,537,1209,402,135,268,76,58,46,89,2018
31,LaMarcus Aldridge,SAS,75,2509,152,373,83,69,35,19,29,17,52,2018
32,Klay Thompson,GSW,73,2504,185,412,143,42,105,23,15,12,30,2018
33,Carmelo Anthony,OKC,78,2501,103,262,47,56,33,4,10,21,35,2018
34,Steven Adams,OKC,76,2487,88,213,51,37,32,6,13,11,26,2018
35,Bojan Bogdanovic,IND,80,2464,119,278,79,40,47,13,19,13,27,2018
36,Taurean Prince,ATL,82,2464,214,504,138,76,94,20,24,43,33,2018
37,Dwight Howard,CHA,81,2463,105,250,65,40,33,11,21,6,34,2018
38,Kentavious Caldwell-Pope,LAL,74,2458,162,378,108,54,83,17,8,11,43,2018
39,Jayson Tatum,BOS,80,2443,128,317,67,61,37,19,11,17,44,2018
40,Nikola Jokic,DEN,75,2443,458,1062,312,146,221,67,24,30,116,2018
41,Otto Porter Jr.,WAS,77,2432,157,365,106,51,50,41,15,11,40,2018
42,DeAndre Jordan,LAC,77,2424,117,270,81,36,46,11,24,10,26,2018
43,Marc Gasol,MEM,73,2408,305,741,174,131,126,16,32,33,98,2018
44,Kyle Kuzma,LAL,77,2401,141,331,92,49,79,7,6,13,36,2018
45,Goran Dragic,MIA,75,2378,359,845,232,127,155,50,27,52,75,2018
46,Dillon Brooks,MEM,82,2350,135,313,92,43,50,14,28,11,32,2018
47,Wilson Chandler,DEN,74,2346,159,401,76,83,47,20,9,33,50,2018
48,Kevin Durant,GSW,68,2325,366,863,235,131,166,32,37,27,104,2018
49,Eric Bledsoe,MIL,74,2322,370,840,270,100,183,47,40,36,64,2018
50,Jeff Teague,MIN,70,2311,492,1101,375,117,212,96,67,40,77,2018
51,Dario Saric,PHI,78,2310,202,476,130,72,91,23,16,10,62,2018
52,Courtney Lee,NYK,76,2310,180,413,127,53,68,31,28,9,44,2018
53,Spencer Dinwiddie,BKN,80,2306,524,1275,297,227,209,70,18,68,159,2018
54,Gary Harris,DEN,67,2304,194,469,113,81,77,25,11,14,67,2018
55,Draymond Green,GSW,70,2287,508,1165,359,149,203,55,101,33,116,2018
56,Yogi Ferrell,DAL,82,2281,201,492,111,90,58,26,27,25,65,2018
57,PJ Tucker,HOU,82,2281,77,190,41,36,36,2,3,11,25,2018
58,Al Horford,BOS,72,2277,339,824,193,146,117,30,46,43,103,2018
59,Trevor Ariza,HOU,67,2269,105,269,46,59,39,5,2,30,29,2018
60,Justin Holiday,CHI,72,2265,153,351,108,45,60,28,20,11,34,2018
61,Ricky Rubio,UTA,77,2254,410,978,252,158,190,36,26,72,86,2018
62,JR Smith,CLE,80,2244,141,345,78,63,61,6,11,28,35,2018
63,Kelly Oubre Jr.,WAS,81,2231,98,229,65,33,35,15,15,5,28,2018
64,Cory Joseph,IND,82,2210,260,610,170,90,84,35,51,23,67,2018
65,Allen Crabbe,BKN,75,2192,117,277,74,43,53,16,5,11,32,2018
66,Julius Randle,LAL,82,2190,210,519,111,99,76,17,18,22,77,2018
67,DeMarre Carroll,BKN,73,2180,147,362,79,68,50,20,9,18,50,2018
68,Bogdan Bogdanovic,SAC,78,2175,258,600,174,84,109,34,31,18,66,2018
69,Jimmy Butler,MIN,59,2164,288,650,214,74,118,47,49,22,52,2018
70,Eric Gordon,HOU,69,2154,154,384,78,76,64,7,7,38,38,2018
71,Derrick Favors,UTA,77,2153,102,254,52,50,36,6,10,16,34,2018
72,Jaylen Brown,BOS,70,2152,114,268,74,40,38,16,20,16,24,2018
73,T.J. Warren,PHX,65,2142,85,208,47,38,28,15,4,8,30,2018
74,Wesley Matthews,DAL,63,2131,172,429,87,85,57,9,21,16,69,2018
75,JJ Redick,PHI,70,2116,210,494,136,74,106,21,9,10,64,2018
76,Patty Mills,SAS,82,2107,229,533,154,75,69,41,44,24,51,2018
77,Denzel Valentine,CHI,77,2095,244,581,151,93,101,24,26,25,68,2018
78,Serge Ibaka,TOR,76,2093,62,153,33,29,21,5,7,11,18,2018
79,Jae Crowder,UTA,80,2090,99,243,54,45,40,7,7,11,34,2018
80,Jusuf Nurkic,POR,79,2088,143,338,91,52,64,10,17,14,38,2018
81,Dennis Schroder,ATL,67,2078,417,1004,247,170,153,50,44,55,115,2018
82,Marcin Gortat,WAS,82,2075,151,361,92,59,47,15,30,13,46,2018
83,Al-Farouq Aminu,POR,69,2072,84,197,55,29,35,5,15,5,24,2018
84,Dragan Bender,PHX,82,2069,130,299,91,39,47,23,21,9,30,2018
85,Terry Rozier,BOS,80,2068,232,565,131,101,71,26,34,25,76,2018
86,Austin Rivers,LAC,61,2057,242,587,139,103,97,28,14,26,77,2018
87,Tony Snell,MIL,75,2053,98,230,64,34,36,13,15,7,27,2018
88,Tyler Johnson,MIA,72,2052,165,410,85,80,59,11,15,24,56,2018
89,Dennis Smith Jr.,DAL,69,2049,358,891,183,175,104,27,52,52,123,2018
90,Willie Cauley-Stein,SAC,73,2044,172,386,130,42,78,25,27,11,31,2018
91,Ish Smith,DET,82,2043,360,909,171,189,116,28,27,49,140,2018
92,Wayne Ellington,MIA,77,2041,79,188,49,30,36,9,4,12,18,2018
93,Clint Capela,HOU,74,2034,68,174,30,38,25,1,4,19,19,2018
94,Evan Turner,POR,79,2034,173,412,107,66,66,18,23,11,55,2018
95,Jonathon Simmons,ORL,69,2029,171,430,83,88,45,19,19,17,71,2018
96,De'Aaron Fox,SAC,73,2026,320,755,205,115,111,53,41,33,82,2018
97,Buddy Hield,SAC,80,2024,155,359,106,49,61,24,21,13,36,2018
98,Lauri Markkanen,CHI,68,2020,79,196,41,38,22,14,5,10,28,2018
99,Darren Collison,IND,69,2018,368,847,257,111,118,50,89,23,88,2018
100,Marvin Williams,CHA,78,2006,96,221,67,29,38,12,17,4,25,2018
101,Nicolas Batum,CHA,64,1981,349,805,242,107,150,46,46,11,96,2018
102,Kyle Anderson,SAS,74,1978,202,481,125,77,81,22,22,15,62,2018
103,Brandon Ingram,LAL,59,1975,230,559,131,99,97,23,11,24,75,2018
104,Joe Harris,BKN,78,1975,128,311,73,55,51,19,3,15,40,2018
105,Blake Griffin,DET,58,1970,334,809,193,141,114,39,40,30,111,2018
106,John Henson,MIL,76,1970,114,261,81,33,45,11,25,11,22,2018
107,Markieff Morris,WAS,73,1968,142,330,96,46,51,26,19,12,34,2018
108,Jeremy Lamb,CHA,80,1967,186,442,116,70,75,28,13,13,57,2018
109,Josh Jackson,PHX,77,1959,119,282,75,44,64,8,3,24,20,2018
110,Marco Belinelli,PHI,80,1947,148,350,94,54,51,15,28,22,32,2018
111,Darius Miller,NOP,82,1944,111,261,72,39,46,15,11,11,28,2018
112,James Johnson,MIA,73,1943,280,706,134,146,101,19,14,37,109,2018
113,Kyrie Irving,BOS,60,1931,306,739,179,127,104,42,33,36,91,2018
114,Rondae Hollis-Jefferson,BKN,68,1921,167,440,61,106,42,10,9,23,83,2018
115,Joel Embiid,PHI,63,1912,199,471,126,73,71,16,39,18,55,2018
116,Aaron Gordon,ORL,58,1909,136,312,96,40,70,16,10,11,29,2018
117,Dirk Nowitzki,DAL,77,1900,120,283,77,43,48,19,10,15,28,2018
118,Stanley Johnson,DET,69,1894,112,277,59,53,48,6,5,15,38,2018
119,Jordan Clarkson,CLE,81,1887,221,519,144,77,108,19,17,14,63,2018
120,Tim Hardaway Jr.,NYK,57,1885,155,367,98,57,52,24,22,19,38,2018
121,Devin Booker,PHX,54,1865,253,594,165,88,133,21,11,29,59,2018
122,Caris LeVert,BKN,71,1864,299,716,181,118,131,37,13,32,86,2018
123,Michael Kidd-Gilchrist,CHA,74,1850,71,176,37,34,19,9,9,7,27,2018
124,Lance Stephenson,IND,82,1850,235,521,184,51,110,31,43,14,37,2018
125,Chris Paul,HOU,58,1847,457,1178,193,264,163,21,9,69,195,2018
126,Evan Fournier,ORL,57,1837,165,392,103,62,66,18,19,23,39,2018
127,Myles Turner,IND,65,1836,87,212,49,38,34,5,10,18,20,2018
128,Frank Kaminsky,CHA,79,1835,129,308,79,50,45,12,22,16,34,2018
129,Enes Kanter,NYK,71,1830,105,241,74,31,30,18,26,2,29,2018
130,Jeff Green,CLE,78,1828,99,242,55,44,40,3,12,7,37,2018
131,Rudy Gobert,UTA,56,1816,80,190,50,30,26,4,20,5,25,2018
132,George Hill,CLE,67,1812,186,446,112,74,57,29,26,19,55,2018
133,Pau Gasol,SAS,77,1812,238,526,188,50,117,30,41,6,44,2018
134,Domantas Sabonis,IND,74,1810,151,371,82,69,37,8,37,20,49,2018
135,Elfrid Payton,PHX,63,1809,393,933,246,147,159,47,40,31,116,2018
136,Danny Green,SAS,70,1791,110,247,83,27,34,22,27,14,13,2018
137,Kent Bazemore,ATL,65,1789,228,519,165,63,123,20,22,23,40,2018
138,John Collins,ATL,74,1785,98,238,56,42,33,3,20,9,33,2018
139,Lonzo Ball,LAL,52,1780,376,870,258,118,180,47,31,30,88,2018
140,Kelly Olynyk,MIA,76,1779,207,519,102,105,72,11,19,33,72,2018
141,Doug McDermott,DAL,81,1768,79,189,48,31,22,14,12,7,24,2018
142,D.J. Augustin,ORL,75,1760,287,666,195,92,107,51,37,27,65,2018
143,Anthony Tolliver,DET,79,1757,90,205,65,25,39,11,15,7,18,2018
144,Dejounte Murray,SAS,81,1743,231,540,153,78,70,44,39,26,52,2018
145,DeMarcus Cousins,NOP,48,1737,257,598,173,84,111,36,26,42,42,2018
146,Brook Lopez,LAL,74,1735,126,288,90,36,55,16,19,9,27,2018
147,Reggie Bullock,DET,62,1732,95,229,56,39,35,14,7,12,27,2018
148,Ersan Ilyasova,PHI,69,1730,90,212,58,32,28,10,20,13,19,2018
149,Jonas Valanciunas,TOR,77,1727,81,202,41,40,27,8,6,8,32,2018
150,Ryan Anderson,HOU,66,1725,60,155,25,35,22,1,2,8,27,2018
151,T.J. McConnell,PHI,76,1706,303,727,182,121,130,22,30,29,92,2018
152,Frank Ntilikina,NYK,78,1706,250,583,167,83,100,37,30,13,70,2018
153,Rajon Rondo,NOP,65,1705,533,1209,390,143,248,88,54,35,108,2018
154,Robin Lopez,CHI,64,1690,124,300,72,52,37,12,23,7,45,2018
155,Jerian Grant,CHI,74,1686,342,824,202,140,106,50,46,34,106,2018
156,Nikola Vucevic,ORL,57,1683,191,456,117,74,83,16,18,15,59,2018
157,Justise Winslow,MIA,68,1680,148,351,93,55,66,15,12,18,37,2018
158,Pascal Siakam,TOR,81,1679,159,387,90,69,75,11,4,20,49,2018
159,Dwight Powell,DAL,79,1672,91,225,48,43,31,8,9,4,39,2018
160,Jarell Martin,MEM,73,1661,73,173,46,27,26,7,13,7,20,2018
161,Tyler Ulis,PHX,71,1658,311,737,196,115,157,20,19,28,87,2018
162,Mario Hezonja,ORL,75,1657,106,241,77,29,57,14,6,6,23,2018
163,Michael Beasley,NYK,74,1653,123,285,84,39,52,8,24,16,23,2018
164,Jamal Crawford,MIN,80,1653,185,408,147,38,102,22,23,6,32,2018
165,Kevin Love,CLE,59,1651,103,242,67,36,56,6,5,12,24,2018
166,Jerami Grant,OKC,81,1647,57,153,18,39,13,2,3,13,26,2018
167,David Nwaba,CHI,70,1646,104,246,66,38,46,10,10,6,32,2018
168,Tomas Satoransky,WAS,73,1643,286,660,198,88,86,60,52,21,67,2018
169,Bobby Portis,CHI,73,1642,123,304,65,58,37,15,13,10,48,2018
170,Stephen Curry,GSW,51,1631,310,713,217,93,152,31,34,21,72,2018
171,Andre Iguodala,GSW,64,1622,210,485,145,65,81,28,36,11,54,2018
172,Troy Daniels,PHX,79,1622,48,111,33,15,19,11,3,4,11,2018
173,Rodney Hood,CLE,60,1615,95,235,50,45,36,11,3,23,22,2018
174,Garrett Temple,SAC,65,1615,124,281,91,33,59,21,11,14,19,2018
175,Marcus Smart,BOS,54,1614,259,611,166,93,112,20,34,30,63,2018
176,Tyreke Evans,MEM,52,1607,269,630,177,92,124,25,28,23,69,2018
177,James Ennis III,DET,72,1604,71,162,51,20,35,11,5,7,13,2018
178,J.J. Barea,DAL,69,1603,434,995,307,127,194,41,72,26,101,2018
179,Kyle Korver,CLE,73,1574,88,196,68,20,54,8,6,7,13,2018
180,Luc Mbah a Moute,HOU,61,1564,55,139,26,29,20,5,1,14,15,2018
181,Dante Cunningham,BKN,73,1562,48,124,20,28,17,3,0,6,22,2018
182,Kristaps Porzingis,NYK,48,1553,57,140,31,26,14,7,10,6,20,2018
183,Jarrett Jack,NYK,62,1548,348,794,250,98,142,59,49,34,64,2018
184,Dewayne Dedmon,ATL,62,1542,90,223,47,43,24,5,18,9,34,2018
185,JaMychal Green,MEM,55,1542,79,180,57,22,36,10,11,4,18,2018
186,Dwyane Wade,MIA,67,1536,228,540,144,84,110,11,23,24,60,2018
187,Shabazz Napier,POR,74,1535,150,366,84,66,56,12,16,15,51,2018
188,Marquese Chriss,PHX,72,1527,83,193,56,27,22,14,20,6,21,2018
189,Kris Dunn,CHI,52,1525,310,740,190,120,106,40,44,27,93,2018
190,Jakob Poeltl,TOR,82,1524,57,147,24,33,15,5,4,11,22,2018
191,Fred VanVleet,TOR,76,1520,243,573,156,87,115,31,10,37,50,2018
192,Bryn Forbes,SAS,80,1517,80,191,49,31,25,12,12,11,20,2018
193,Zach Randolph,SAC,59,1508,127,291,90,37,50,22,18,9,28,2018
194,Justin Jackson,SAC,68,1506,74,182,40,34,23,11,6,14,20,2018
195,Bismack Biyombo,ORL,82,1495,66,148,50,16,23,8,19,3,13,2018
196,Nikola Mirotic,NOP,55,1494,80,181,59,21,35,9,15,4,17,2018
197,Pat Connaughton,POR,82,1488,91,225,48,43,22,16,10,10,33,2018
198,Wesley Johnson,LAC,74,1486,61,147,36,25,31,3,2,6,19,2018
199,Aron Baynes,BOS,81,1485,93,226,53,40,27,11,15,8,32,2018
200,OG Anunoby,TOR,74,1482,55,135,30,25,17,9,4,9,16,2018
201,Ed Davis,POR,78,1471,40,104,16,24,8,3,5,8,16,2018
202,Tyus Jones,MIN,82,1467,232,545,151,81,82,35,34,26,55,2018
203,Luke Kennard,DET,73,1463,124,304,68,56,45,15,8,18,38,2018
204,Josh Hart,LAL,63,1460,80,196,44,36,32,10,2,7,29,2018
205,Ian Clark,NOP,74,1454,110,255,75,35,55,9,11,6,29,2018
206,Marcus Morris,BOS,54,1442,72,174,42,30,27,9,6,11,19,2018
207,Jarrett Allen,BKN,72,1441,49,122,25,24,16,6,3,6,18,2018
208,Mason Plumlee,DEN,74,1440,142,336,90,52,69,14,7,16,36,2018
209,Malcolm Brogdon,MIL,48,1436,152,348,108,44,61,21,26,11,33,2018
210,Avery Bradley,LAC,46,1433,94,226,56,38,38,13,5,9,29,2018
211,Delon Wright,TOR,69,1433,200,497,103,97,76,19,8,35,62,2018
212,Mario Chalmers,MEM,66,1421,197,454,137,60,102,15,20,8,52,2018
213,Larry Nance Jr.,CLE,66,1421,82,196,50,32,33,8,9,7,25,2018
214,John Wall,WAS,41,1410,393,930,249,144,149,49,51,32,112,2018
215,Mike Scott,WAS,76,1406,80,192,48,32,30,10,8,8,24,2018
216,Alex Len,PHX,69,1395,82,196,50,32,25,8,17,10,22,2018
217,Nick Young,GSW,80,1393,36,87,21,15,9,8,4,4,11,2018
218,Kosta Koufos,SAC,71,1391,87,209,52,35,13,10,29,6,29,2018
219,Trey Lyles,DEN,73,1391,91,221,52,39,37,10,5,4,35,2018
220,Kyle O'Quinn,NYK,77,1387,158,340,134,24,95,16,23,5,19,2018
221,Nemanja Bjelica,MIN,67,1371,86,195,63,23,35,16,12,10,13,2018
222,Bam Adebayo,MIA,69,1368,101,260,43,58,19,5,19,14,44,2018
223,Shelvin Mack,ORL,69,1365,272,648,168,104,101,37,30,17,87,2018
224,Raymond Felton,OKC,82,1365,203,493,116,87,84,14,18,28,59,2018
225,Hassan Whiteside,MIA,54,1364,54,130,32,22,14,11,7,2,20,2018
226,Quincy Acy,BKN,70,1359,57,145,26,31,16,4,6,6,25,2018
227,Lance Thomas,NYK,73,1353,44,103,29,15,12,8,9,5,10,2018
228,Devin Harris,DEN,71,1340,152,357,99,53,63,17,19,12,41,2018
229,CJ Miles,TOR,70,1336,55,121,44,11,36,2,6,5,6,2018
230,Gorgui Dieng,MIN,79,1333,71,175,38,33,22,8,8,7,26,2018
231,Andrew Harrison,MEM,56,1326,177,415,116,61,57,18,41,14,47,2018
232,Manu Ginobili,SAS,65,1299,163,373,116,47,78,23,15,14,33,2018
233,Montrezl Harrell,LAC,76,1293,74,170,52,22,30,11,11,6,16,2018
234,Patrick Patterson,OKC,82,1270,57,151,20,37,15,1,4,7,30,2018
235,Maurice Harkless,POR,59,1264,53,131,28,25,16,6,6,7,18,2018
236,Emmanuel Mudiay,NYK,64,1244,206,485,133,73,81,27,25,23,50,2018
237,Skal Labissiere,SAC,60,1240,72,177,39,33,16,5,18,8,25,2018
238,Thon Maker,MIL,74,1238,46,104,34,12,28,0,6,4,8,2018
239,D'Angelo Russell,BKN,48,1234,249,595,152,97,122,19,11,19,78,2018
240,Rudy Gay,SAS,57,1231,73,174,45,28,32,9,4,8,20,2018
241,Corey Brewer,OKC,72,1208,65,151,44,21,33,4,7,3,18,2018
242,Maxi Kleber,DAL,72,1206,51,133,20,31,8,4,8,5,26,2018
243,Joe Johnson,HOU,55,1205,83,210,39,44,32,2,5,20,24,2018
244,Reggie Jackson,DET,45,1201,238,582,132,106,88,22,22,32,74,2018
245,Amir Johnson,PHI,74,1170,118,269,85,33,44,9,32,2,31,2018
246,Isaiah Taylor,ATL,67,1167,206,522,96,110,58,18,20,28,82,2018
247,Trevor Booker,IND,68,1158,82,210,36,46,18,8,10,9,37,2018
248,Sindarius Thornwell,LAC,73,1156,68,149,55,13,43,4,8,2,11,2018
249,Tyson Chandler,PHX,46,1151,53,114,45,8,17,12,16,1,7,2018
250,Semi Ojeleye,BOS,73,1150,20,47,13,7,7,1,5,0,7,2018
251,Royce O'Neale,UTA,69,1149,95,228,57,38,38,9,10,19,19,2018
252,Ian Mahinmi,WAS,77,1145,53,120,39,14,21,7,11,2,12,2018
253,Paul Millsap,DEN,38,1144,105,260,55,50,36,11,8,11,39,2018
254,Milos Teodosic,LAC,45,1134,209,479,148,61,117,21,10,16,45,2018
255,Alex Abrines,OKC,75,1134,28,66,18,10,11,5,2,3,7,2018
256,Jonas Jerebko,UTA,74,1134,42,104,22,20,12,6,4,2,18,2018
257,Shaun Livingston,GSW,71,1129,140,323,97,43,47,21,29,8,35,2018
258,Jodie Meeks,WAS,77,1119,70,158,52,18,22,16,14,4,14,2018
259,Tyler Zeller,MIL,66,1113,47,118,23,24,14,6,3,5,19,2018
260,Ben McLemore,MEM,56,1091,51,119,34,17,15,10,9,3,14,2018
261,Davis Bertans,SAS,77,1086,74,176,46,28,27,10,9,12,16,2018
262,Tristan Thompson,CLE,53,1072,33,77,22,11,9,6,7,3,8,2018
263,Tony Parker,SAS,55,1071,195,463,122,73,56,25,41,26,47,2018
264,Norman Powell,TOR,70,1061,89,218,49,40,33,7,9,14,26,2018
265,Mike Muscala,ATL,53,1060,51,130,23,28,14,4,5,7,21,2018
266,Alec Burks,UTA,64,1059,67,160,41,26,28,4,9,11,15,2018
267,Treveon Graham,CHA,63,1049,59,139,38,21,20,11,7,8,13,2018
268,Zach Collins,POR,66,1046,52,125,31,21,15,10,6,6,15,2018
269,Greg Monroe,BOS,51,1041,114,266,76,38,55,8,13,8,30,2018
270,Andre Roberson,OKC,39,1037,46,107,31,15,19,6,6,5,10,2018
271,Vince Carter,SAC,58,1026,69,162,45,24,29,9,7,5,19,2018
272,Wes Iwundu,ORL,62,1020,57,138,33,24,23,4,6,2,22,2018
273,Malcolm Delaney,ATL,54,1014,163,394,95,68,49,23,23,33,35,2018
274,Jameer Nelson,DET,50,1013,179,433,104,75,66,19,19,21,54,2018
275,David West,GSW,73,999,138,307,107,31,64,24,19,10,21,2018
276,Frank Mason,SAC,52,984,147,346,95,52,47,22,26,21,31,2018
277,Josh Huestis,OKC,69,981,20,52,8,12,5,1,2,3,9,2018
278,Cristiano Felicio,CHI,55,977,55,134,31,24,19,6,6,5,19,2018
279,Tyler Dorsey,ATL,56,974,79,190,47,32,18,17,12,10,22,2018
280,Zaza Pachulia,GSW,69,972,109,264,63,46,34,10,19,7,39,2018
281,Patrick McCaw,GSW,57,961,81,194,49,32,23,11,15,7,25,2018
282,Deyonta Davis,MEM,62,943,40,100,20,20,10,2,8,2,18,2018
283,Daniel Theis,BOS,63,936,56,141,27,29,15,7,5,5,24,2018
284,Gerald Green,HOU,41,929,25,62,13,12,11,2,0,4,8,2018
285,Jerryd Bayless,PHI,39,925,54,128,34,20,15,9,10,4,16,2018
286,Dion Waiters,MIA,30,918,113,284,55,58,40,6,9,19,39,2018
287,Miles Plumlee,ATL,55,918,45,105,30,15,10,6,14,4,11,2018
288,Jose Calderon,CLE,57,914,117,278,73,44,55,12,6,13,31,2018
289,Kevon Looney,GSW,66,910,42,100,26,16,15,4,7,3,13,2018
290,Sam Dekker,LAC,73,883,38,84,30,8,23,5,2,3,5,2018
291,Noah Vonleh,CHI,54,876,34,82,20,14,11,4,5,0,14,2018
292,Langston Galloway,DET,58,863,58,144,30,28,19,6,5,5,23,2018
293,Isaiah Thomas,LAL,32,862,153,360,99,54,77,13,9,17,37,2018
294,Malik Monk,CHA,63,853,91,201,72,19,40,22,10,5,14,2018
295,Tyrone Wallace,LAC,30,851,71,159,54,17,41,10,3,6,11,2018
296,Tim Frazier,WAS,59,838,194,457,125,69,55,29,41,14,55,2018
297,Michael Carter-Williams,CHA,52,835,116,276,72,44,39,16,17,10,34,2018
298,Paul Zipser,CHI,54,824,46,115,23,23,13,5,5,12,11,2018
299,Jason Terry,MIL,51,814,59,136,41,18,26,9,6,7,11,2018
300,Ekpe Udoh,UTA,63,810,53,133,26,27,15,4,7,9,18,2018
301,Jordan Bell,GSW,57,809,102,230,76,26,40,15,21,2,24,2018
302,Timothe Luwawu-Cabarrot,PHI,52,807,54,122,40,14,29,7,4,3,11,2018
303,Thabo Sefolosha,UTA,38,806,33,79,20,13,18,1,1,6,7,2018
304,Eric Moreland,DET,67,805,78,186,48,30,21,11,16,4,26,2018
305,Trey Burke,NYK,36,785,170,394,116,54,77,23,16,17,37,2018
306,Jawun Evans,LAC,48,778,100,224,76,24,56,11,9,8,16,2018
307,Sterling Brown,MIL,54,776,25,64,11,14,8,0,3,5,9,2018
308,Shane Larkin,BOS,54,775,98,233,61,37,29,11,21,6,31,2018
309,Terrance Ferguson,OKC,61,763,19,46,11,8,7,2,2,3,5,2018
310,Nene,HOU,52,758,45,118,17,28,16,1,0,8,20,2018
311,Richaun Holmes,PHI,48,746,61,143,40,21,18,4,18,1,20,2018
312,Jabari Parker,MIL,31,743,59,133,44,15,30,6,8,4,11,2018
313,Omri Casspi,GSW,53,742,51,115,38,13,19,8,11,1,12,2018
314,Quinn Cook,GSW,33,740,89,207,60,29,28,15,17,5,24,2018
315,Salah Mejri,DAL,61,729,35,89,16,19,5,2,9,3,16,2018
316,DeAndre Liggins,NOP,57,723,48,114,30,18,20,2,8,5,13,2018
317,Luke Babbitt,MIA,50,715,31,80,13,18,7,3,3,7,11,2018
318,Dwayne Bacon,CHA,53,713,38,99,15,23,12,2,1,4,19,2018
319,Matthew Dellavedova,MIL,38,712,145,331,104,41,77,16,11,13,28,2018
320,C.J. Williams,LAC,38,706,43,97,32,11,20,6,6,3,8,2018
321,Channing Frye,LAL,53,695,38,96,18,20,16,1,1,5,15,2018
322,Chandler Parsons,MEM,36,691,69,160,47,22,33,7,7,3,19,2018
323,Wayne Selden,MEM,35,691,66,147,51,15,33,6,12,4,11,2018
324,Mike James,NOP,36,686,126,303,75,51,52,12,11,14,37,2018
325,Jared Dudley,PHX,48,686,78,182,52,26,37,7,8,7,19,2018
326,Tyler Ennis,LAL,54,683,105,249,66,39,39,12,15,10,29,2018
327,Arron Afflalo,ORL,53,682,30,76,14,16,9,2,3,5,11,2018
328,Marreese Speights,ORL,52,675,40,93,27,13,20,3,4,4,9,2018
329,Cedi Osman,CLE,61,672,41,100,23,18,17,4,2,6,12,2018
330,Danilo Gallinari,LAC,21,671,41,94,29,12,21,4,4,5,7,2018
331,Zach LaVine,CHI,24,656,72,169,47,25,28,16,3,8,17,2018
332,Kobi Simmons,MEM,32,643,68,161,43,25,25,5,13,7,18,2018
333,Sean Kilpatrick,CHI,52,640,46,116,22,24,13,5,4,10,14,2018
334,Torrey Craig,DEN,39,629,25,59,16,9,10,4,2,1,8,2018
335,Cody Zeller,CHA,33,627,31,75,18,13,8,5,5,2,11,2018
336,JaVale McGee,GSW,65,616,33,77,22,11,9,4,9,2,9,2018
337,Terrence Ross,ORL,24,600,38,89,25,13,15,7,3,3,10,2018
338,Malik Beasley,DEN,62,583,31,79,14,17,13,1,0,4,13,2018
339,Cameron Payne,CHI,25,582,113,278,61,52,47,6,8,9,43,2018
340,Cheick Diallo,NOP,52,581,19,45,12,7,7,4,1,1,6,2018
341,Khem Birch,ORL,42,578,34,82,20,14,8,7,5,0,14,2018
342,Brandon Paul,SAS,64,576,37,88,23,14,13,4,6,6,8,2018
343,Alex Caruso,LAL,37,562,75,175,50,25,40,7,3,4,21,2018
344,Joe Young,IND,53,558,39,91,26,13,16,8,2,6,7,2018
345,Tarik Black,HOU,51,536,13,32,7,6,4,2,1,1,5,2018
346,Jonathan Isaac,ORL,27,535,18,44,10,8,3,5,2,2,6,2018
347,Joffrey Lauvergne,SAS,55,534,41,93,30,11,18,7,5,5,6,2018
348,Nik Stauskas,BKN,41,523,39,95,22,17,13,5,4,7,10,2018
349,Abdel Nader,BOS,48,522,26,63,15,11,8,3,4,4,7,2018
350,Justin Anderson,PHI,38,519,25,58,17,8,13,1,3,1,7,2018
351,Tyler Cavanaugh,ATL,39,518,27,69,12,15,4,1,7,3,12,2018
352,Ivan Rabb,MEM,36,516,32,71,25,7,16,1,8,1,6,2018
353,Raul Neto,UTA,41,498,75,185,40,35,26,6,8,13,22,2018
354,Willy Hernangomez,CHA,48,494,33,81,18,15,7,5,6,4,11,2018
355,Al Jefferson,IND,36,484,30,68,22,8,9,5,8,4,4,2018
356,Kyle Collinsworth,DAL,32,480,56,132,36,20,23,6,7,6,14,2018
357,Damyean Dotson,NYK,44,474,31,72,21,10,16,4,1,1,9,2018
358,Nerlens Noel,DAL,29,472,20,46,14,6,7,4,3,1,5,2018
359,Kenneth Faried,DEN,32,461,18,42,12,6,7,3,2,1,5,2018
360,TJ Leaf,IND,53,459,9,22,5,4,1,2,2,1,3,2018
361,DeAndre' Bembry,ATL,26,455,49,115,32,17,20,7,5,8,9,2018
362,Dorian Finney-Smith,DAL,21,448,26,66,12,14,6,4,2,5,9,2018
363,Willie Reed,DET,42,428,10,22,8,2,4,1,3,2,0,2018
364,Dwight Buycks,DET,29,427,59,144,33,26,16,12,5,9,17,2018
365,Isaiah Canaan,PHX,20,422,76,187,41,35,32,6,3,16,19,2018
366,Derrick Rose,MIN,25,419,37,87,24,13,14,5,5,5,8,2018
367,Shabazz Muhammad,MIL,43,418,14,34,8,6,4,2,2,0,6,2018
368,Lucas Nogueira,TOR,49,418,22,56,10,12,8,0,2,4,8,2018
369,Ivica Zubac,LAL,43,410,25,58,17,8,7,5,5,0,8,2018
370,Damion Lee,ATL,15,404,29,71,16,13,11,5,0,1,12,2018
371,Danuel House Jr.,PHX,23,403,25,61,14,11,11,1,2,1,10,2018
372,Ramon Sessions,WAS,28,392,77,181,50,27,23,20,7,6,21,2018
373,Ron Baker,NYK,29,385,47,104,37,10,27,7,3,2,8,2018
374,Shaquille Harrison,PHX,23,384,55,134,31,24,22,5,4,4,20,2018
375,Brandan Wright,HOU,28,381,13,31,8,5,3,2,3,1,4,2018
376,Johnny O'Bryant III,CHA,36,379,14,35,7,7,5,1,1,2,5,2018
377,Myke Henry,MEM,20,378,22,51,15,7,7,5,3,3,4,2018
378,Mike Conley,MEM,12,373,49,120,27,22,17,6,4,6,16,2018
379,Timofey Mozgov,BKN,31,359,11,27,6,5,2,4,0,2,3,2018
380,Emeka Okafor,NOP,26,353,8,22,2,6,0,1,1,0,6,2018
381,Jahlil Okafor,BKN,28,353,12,33,3,9,2,0,1,1,8,2018
382,JaKarr Sampson,SAC,22,344,9,22,5,4,1,3,1,0,4,2018
383,Boban Marjanovic,LAC,37,338,22,47,19,3,13,3,3,1,2,2018
384,Glenn Robinson III,IND,23,338,17,37,14,3,8,4,2,0,3,2018
385,Patrick Beverley,LAC,11,334,32,73,23,9,12,5,6,3,6,2018
386,Henry Ellenson,DET,38,329,20,54,6,14,4,1,1,3,11,2018
387,Luke Kornet,NYK,20,326,26,60,18,8,11,2,5,0,8,2018
388,Malachi Richardson,TOR,26,323,13,30,9,4,7,0,2,2,2,2018
389,Antonio Blakeney,CHI,19,314,20,49,11,9,8,0,3,2,7,2018
390,Troy Williams,NYK,21,307,16,37,11,5,5,0,6,1,4,2018
391,Ryan Arcidiacono,CHI,24,304,35,85,20,15,17,1,2,2,13,2018
392,Rodney McGruder,MIA,18,299,17,42,9,8,6,1,2,2,6,2018
393,Rodney Purvis,ORL,16,290,17,40,11,6,9,2,0,2,4,2018
394,Jason Smith,WAS,33,285,14,35,7,7,5,0,2,1,6,2018
395,Jordan Mickey,MIA,23,284,9,22,5,4,1,1,3,0,4,2018
396,Jamel Artis,ORL,15,279,18,47,7,11,5,2,0,3,8,2018
397,Juancho Hernangomez,DEN,25,277,12,31,5,7,4,1,0,4,3,2018
398,Iman Shumpert,CLE,14,276,17,42,9,8,5,1,3,0,8,2018
399,Jamil Wilson,LAC,15,274,10,24,6,4,5,1,0,1,3,2018
400,Tony Allen,NOP,22,272,9,20,7,2,6,1,0,2,0,2018
401,Meyers Leonard,POR,33,254,17,45,6,11,4,0,2,3,8,2018
402,Markelle Fultz,PHI,14,253,53,129,30,23,20,6,4,7,16,2018
403,Derrick Jones Jr.,MIA,20,245,9,22,5,4,3,0,2,3,1,2018
404,Davon Reed,PHX,21,242,13,31,8,5,6,1,1,0,5,2018
405,Isaiah Hicks,NYK,18,239,16,42,6,10,1,3,2,2,8,2018
406,Briante Weber,MEM,18,237,22,56,10,12,7,1,2,3,9,2018
407,Guerschon Yabusele,BOS,33,235,16,41,7,9,5,2,0,3,6,2018
408,Dante Exum,UTA,14,235,43,100,29,14,18,6,5,2,12,2018
409,Aaron Harrison,DAL,9,233,11,29,4,7,2,2,0,1,6,2018
410,Travis Wear,LAL,17,228,7,19,2,5,1,1,0,0,5,2018
411,Alec Peters,PHX,20,225,12,29,7,5,5,2,0,1,4,2018
412,Marcus Georges-Hunt,MIN,42,224,7,18,3,4,2,0,1,2,2,2018
413,Gary Payton II,LAL,23,221,21,51,12,9,5,4,3,2,7,2018
414,Andrew Bogut,LAL,23,216,15,35,10,5,7,2,1,0,5,2018
415,Josh Magette,ATL,18,216,57,136,35,22,25,5,5,5,17,2018
416,Ante Zizic,CLE,32,214,5,12,3,2,1,0,2,1,1,2018
417,Rashad Vaughn,ORL,28,212,13,30,9,4,5,3,1,1,3,2018
418,Kawhi Leonard,SAS,9,210,21,49,14,7,5,5,4,4,3,2018
419,Andrew White III,ATL,15,209,6,16,2,4,1,0,1,2,2,2018
420,Brandon Jennings,MIL,14,205,44,93,39,5,24,12,3,2,3,2018
421,Quincy Pondexter,CHI,23,196,9,23,4,5,3,0,1,3,2,2018
422,MarShon Brooks,MEM,7,193,25,59,16,9,11,2,3,6,3,2018
423,Aaron Brooks,MIN,32,189,20,48,12,8,4,4,4,1,7,2018
424,Caleb Swanigan,POR,27,189,14,35,7,7,7,0,0,1,6,2018
425,Solomon Hill,NOP,12,187,22,53,13,9,7,6,0,4,5,2018
426,Omer Asik,CHI,18,182,3,6,3,0,0,1,2,0,0,2018
427,Jalen Jones,DAL,15,181,4,10,2,2,2,0,0,1,1,2018
428,Isaiah Whitehead,BKN,16,180,20,45,15,5,13,2,0,1,4,2018
429,Johnathan Motley,DAL,11,176,7,16,5,2,3,2,0,0,2,2018
430,Julyan Stone,CHA,23,175,26,62,16,10,11,2,3,2,8,2018
431,John Holland,CLE,24,174,5,10,5,0,4,1,0,0,0,2018
432,Richard Jefferson,DEN,20,163,15,39,6,9,6,0,0,3,6,2018
433,Dakari Johnson,OKC,31,161,8,21,3,5,2,0,1,2,3,2018
434,Jake Layman,POR,34,160,11,28,5,6,1,1,3,2,4,2018
435,Mirza Teletovic,MIL,10,159,10,25,5,5,4,1,0,3,2,2018
436,Damien Wilkins,IND,19,152,9,22,5,4,3,1,1,3,1,2018
437,Derrick Walton Jr.,MIA,16,147,16,39,9,7,4,3,2,1,6,2018
438,Darrell Arthur,DEN,19,141,9,23,4,5,4,0,0,0,5,2018
439,Kay Felder,DET,16,140,20,47,13,7,9,3,1,3,4,2018
440,Derrick White,SAS,17,139,9,20,7,2,6,1,0,0,2,2018
441,Lorenzo Brown,TOR,14,139,13,35,4,9,3,1,0,2,7,2018
442,Jon Leuer,DET,8,136,5,10,5,0,2,2,1,0,0,2018
443,Malcolm Miller,TOR,15,126,3,7,2,1,1,1,0,0,1,2018
444,Milton Doyle,BKN,10,125,10,24,6,4,6,0,0,0,4,2018
445,Zhou Qi,HOU,18,124,2,5,1,1,1,0,0,1,0,2018
446,Antonius Cleveland,ATL,17,122,2,5,1,1,1,0,0,0,1,2018
447,Nigel Hayes,SAC,9,122,6,17,1,5,0,0,1,0,5,2018
448,Georgios Papagiannis,POR,17,122,9,23,4,5,1,1,2,0,5,2018
449,James Webb III,BKN,10,120,4,11,1,3,1,0,0,2,1,2018
450,Xavier Rathan-Mayes,MEM,5,118,18,43,11,7,5,4,2,2,5,2018
451,Bobby Brown,HOU,20,115,11,30,3,8,3,0,0,3,5,2018
452,Jabari Bird,BOS,13,115,8,19,5,3,3,1,1,2,1,2018
453,Kadeem Allen,BOS,18,107,12,27,9,3,6,1,2,2,1,2018
454,Bruno Caboclo,SAC,12,106,4,9,3,1,2,1,0,0,1,2018
455,Alex Poythress,IND,25,104,2,5,1,1,0,1,0,0,1,2018
456,Jaylen Morris,ATL,6,98,7,16,5,2,3,1,1,0,2,2018
457,Brice Johnson,MEM,18,98,2,5,1,1,1,0,0,0,1,2018
458,Darrun Hilliard,SAS,14,95,11,27,6,5,4,2,0,1,4,2018
459,Chris McCullough,WAS,19,90,4,9,3,1,2,0,1,0,1,2018
460,Damian Jones,GSW,15,89,2,4,2,0,2,0,0,0,0,2018
461,Jack Cooley,SAC,7,87,6,13,5,1,2,2,1,0,1,2018
462,Josh Gray,PHX,5,86,12,30,6,6,4,0,2,1,5,2018
463,Wade Baldwin IV,POR,7,80,5,11,4,1,2,1,1,0,1,2018
464,Demetrius Jackson,PHI,15,80,9,21,6,3,3,2,1,0,3,2018
465,Furkan Korkmaz,PHI,14,80,4,8,4,0,4,0,0,0,0,2018
466,Okaro White,MIA,6,80,2,5,1,1,0,0,1,0,1,2018
467,Omari Johnson,MEM,4,75,7,17,4,3,1,0,3,1,2,2018
468,Nick Collison,OKC,15,75,4,9,3,1,1,0,2,0,1,2018
469,Marquis Teague,MEM,3,74,13,31,8,5,1,4,3,0,5,2018
470,Thomas Bryant,LAL,15,72,6,14,4,2,3,1,0,1,1,2018
471,Udonis Haslem,MIA,14,72,5,12,3,2,1,1,1,0,2,2018
472,D.J. Wilson,MIL,22,71,3,6,3,0,2,0,1,0,0,2018
473,Alan Williams,PHX,5,70,8,23,1,7,1,0,0,3,4,2018
474,Larry Drew II,NOP,10,70,10,23,7,3,4,2,1,2,1,2018
475,London Perrantes,CLE,14,66,5,13,2,3,2,0,0,2,1,2018
476,Andre Ingram,LAL,2,64,7,18,3,4,1,2,0,1,3,2018
477,Gian Clavell,DAL,7,64,3,9,0,3,0,0,0,0,3,2018
478,James Young,PHI,6,61,2,5,1,1,0,0,1,0,1,2018
479,Kyle Singler,OKC,12,59,2,6,0,2,0,0,0,1,1,2018
480,Alfonzo McKinnie,TOR,14,53,1,3,0,1,0,0,0,0,1,2018
481,Jordan Crawford,NOP,5,53,13,33,6,7,4,0,2,2,5,2018
482,Marshall Plumlee,MIL,8,52,2,5,1,1,0,0,1,1,0,2018
483,Cole Aldrich,MIN,21,49,3,7,2,1,1,0,1,1,0,2018
484,RJ Hunter,HOU,5,45,3,7,2,1,2,0,0,1,0,2018
485,Vander Blue,LAL,5,45,3,8,1,2,0,1,0,1,1,2018
486,Adreian Payne,ORL,5,43,0,0,0,0,0,0,0,0,0,2018
487,Joakim Noah,NYK,7,40,4,10,2,2,1,0,1,0,2,2018
488,Jonathan Gibson,BOS,4,40,4,9,3,1,2,0,1,1,0,2018
489,Jeff Withey,DAL,9,39,0,0,0,0,0,0,0,0,0,2018
490,Charles Cooke,NOP,13,38,1,3,0,1,0,0,0,0,1,2018
491,Joel Bolomboy,MIL,6,38,0,0,0,0,0,0,0,0,0,2018
492,Walter Lemon Jr.,NOP,5,35,5,12,3,2,2,1,0,1,1,2018
493,Aaron Jackson,HOU,1,34,1,3,0,1,0,0,0,1,0,2018
494,Jacob Wiley,BKN,5,33,2,4,2,0,1,0,1,0,0,2018
495,Matt Costello,SAS,4,32,2,6,0,2,0,0,0,0,2,2018
496,Georges Niang,UTA,9,32,3,6,3,0,2,1,0,0,0,2018
497,Markel Brown,HOU,4,31,2,4,2,0,2,0,0,0,0,2018
498,Ike Anigbogu,IND,11,30,0,0,0,0,0,0,0,0,0,2018
499,Tony Bradley,UTA,9,29,1,2,1,0,1,0,0,0,0,2018
0,Andrew Wiggins,MIN,82,3048,189,441,126,63,61,21,44,29,34,2017
1,Karl-Anthony Towns,MIN,82,3030,220,507,153,67,83,26,44,12,55,2017
2,James Harden,HOU,81,2947,907,2182,539,368,481,41,17,96,272,2017
3,Giannis Antetokounmpo,MIL,80,2845,434,1060,242,192,151,52,39,48,144,2017
4,John Wall,WAS,78,2836,831,1950,543,288,345,101,97,81,207,2017
5,Jimmy Butler,CHI,76,2809,417,959,292,125,115,80,97,50,75,2017
6,Harrison Barnes,DAL,79,2804,116,322,26,90,11,5,10,21,69,2017
7,Russell Westbrook,OKC,81,2802,840,1886,634,206,471,97,66,76,130,2017
8,CJ McCollum,POR,80,2796,285,692,163,122,94,31,38,36,86,2017
9,LeBron James,CLE,74,2795,646,1641,297,349,199,40,58,161,188,2017
10,Trevor Ariza,HOU,80,2773,175,426,99,76,69,20,10,28,48,2017
11,Rudy Gobert,UTA,81,2744,97,232,59,38,42,5,12,2,36,2017
12,Kemba Walker,CHA,79,2739,434,1021,281,153,152,60,69,20,133,2017
13,Devin Booker,PHX,78,2731,268,630,174,94,119,23,32,33,61,2017
14,Anthony Davis,NOP,75,2708,157,378,93,64,70,13,10,26,38,2017
15,Damian Lillard,POR,75,2693,440,1039,281,159,183,57,41,46,113,2017
16,Paul George,IND,75,2689,251,586,167,84,94,34,39,37,47,2017
17,Bradley Beal,WAS,77,2684,267,619,182,85,88,44,50,28,57,2017
18,Jeff Teague,IND,82,2657,639,1456,461,178,218,77,166,44,134,2017
19,Gorgui Dieng,MIN,82,2653,158,371,103,55,61,12,30,19,36,2017
20,Klay Thompson,GSW,78,2649,160,365,115,45,88,15,12,16,29,2017
21,Stephen Curry,GSW,79,2639,524,1211,361,163,270,37,54,50,113,2017
22,DeMar DeRozan,TOR,74,2620,290,712,158,132,85,28,45,46,86,2017
23,Nicolas Batum,CHA,77,2617,456,1049,319,137,218,66,35,28,109,2017
24,Otto Porter Jr.,WAS,80,2605,121,275,88,33,47,13,28,13,20,2017
25,DeAndre Jordan,LAC,81,2571,96,234,54,42,16,5,33,12,30,2017
26,Isaiah Thomas,BOS,76,2570,449,1090,257,192,171,35,51,59,133,2017
27,Tobias Harris,DET,82,2566,142,334,92,50,45,29,18,17,33,2017
28,Marcus Morris,DET,79,2565,160,351,129,31,65,35,29,10,21,2017
29,Marcin Gortat,WAS,82,2556,121,297,66,55,38,6,22,15,40,2017
30,Myles Turner,IND,81,2541,106,260,58,48,36,11,11,24,24,2017
31,Carmelo Anthony,NYK,74,2538,213,499,140,73,75,32,33,31,42,2017
32,Marc Gasol,MEM,74,2531,338,803,211,127,139,36,36,37,90,2017
33,Kentavious Caldwell-Pope,DET,76,2529,193,443,136,57,78,37,21,10,47,2017
34,Kyrie Irving,CLE,72,2525,418,1013,241,177,162,50,29,56,121,2017
35,Gordon Hayward,UTA,73,2516,252,611,145,107,107,22,16,47,60,2017
36,Hassan Whiteside,MIA,77,2514,57,128,43,14,28,6,9,2,12,2017
37,Wesley Matthews,DAL,73,2495,210,521,109,101,37,21,51,22,79,2017
38,Dennis Schroder,ATL,79,2485,499,1158,339,160,216,54,69,40,120,2017
39,Kawhi Leonard,SAS,74,2475,260,644,136,124,72,25,39,51,73,2017
40,Draymond Green,GSW,76,2471,533,1248,351,182,224,48,79,36,146,2017
41,Ricky Rubio,MIN,75,2469,682,1513,533,149,322,108,103,64,85,2017
42,DeMarcus Cousins,NOP,72,2466,332,798,198,134,129,30,39,57,77,2017
43,Goran Dragic,MIA,73,2460,423,1029,240,183,129,55,56,72,111,2017
44,Courtney Lee,NYK,77,2459,179,418,119,60,58,28,33,21,39,2017
45,Serge Ibaka,TOR,79,2422,75,181,44,31,23,10,11,6,25,2017
46,Elfrid Payton,ORL,82,2412,529,1206,381,148,196,79,106,30,118,2017
47,Andre Drummond,DET,81,2410,90,212,58,32,26,10,22,9,23,2017
48,Marcus Smart,BOS,79,2399,364,869,223,141,163,27,33,37,104,2017
49,Jordan Clarkson,LAL,82,2397,213,477,162,51,112,35,15,16,35,2017
50,Steven Adams,OKC,80,2389,86,217,41,45,33,2,6,5,40,2017
51,Andre Roberson,OKC,79,2376,79,190,47,32,29,4,14,15,17,2017
52,Markieff Morris,WAS,76,2374,126,288,90,36,54,14,22,12,24,2017
53,Solomon Hill,NOP,80,2374,141,325,98,43,63,18,17,12,31,2017
54,Michael Kidd-Gilchrist,CHA,81,2350,114,280,62,52,30,17,15,10,42,2017
55,Paul Millsap,ATL,69,2343,252,600,156,96,111,9,36,42,54,2017
56,Tristan Thompson,CLE,78,2337,77,193,38,39,23,3,12,12,27,2017
57,Tony Snell,MIL,80,2336,96,221,67,29,42,15,10,10,19,2017
58,Jae Crowder,BOS,72,2335,155,373,92,63,58,17,17,19,44,2017
59,LaMarcus Aldridge,SAS,72,2335,139,345,72,67,32,11,29,19,48,2017
60,Eric Gordon,HOU,75,2323,188,451,113,75,98,9,6,30,45,2017
61,Aaron Gordon,ORL,80,2298,150,352,98,52,58,19,21,10,42,2017
62,Marvin Williams,CHA,76,2295,106,252,66,40,39,11,16,2,38,2017
63,Mike Conley,MEM,69,2292,433,1010,289,144,142,61,86,35,109,2017
64,Brandon Ingram,LAL,79,2279,166,386,112,54,70,25,17,13,41,2017
65,Robin Lopez,CHI,81,2271,80,182,58,22,33,10,15,7,15,2017
66,Allen Crabbe,POR,79,2254,94,228,54,40,26,16,12,12,28,2017
67,Kyle Lowry,TOR,60,2244,417,940,311,106,196,65,50,42,64,2017
68,Thaddeus Young,IND,74,2237,122,286,80,42,52,8,20,11,31,2017
69,PJ Tucker,TOR,81,2236,99,230,67,32,33,19,15,11,21,2017
70,Evan Fournier,ORL,68,2234,202,460,146,56,66,42,38,15,41,2017
71,Maurice Harkless,POR,77,2223,88,217,47,41,23,11,13,9,32,2017
72,Victor Oladipo,OKC,67,2223,176,401,127,49,80,25,22,19,30,2017
73,Brook Lopez,BKN,75,2222,176,420,108,68,93,10,5,16,52,2017
74,Dwight Howard,ATL,74,2199,104,235,77,27,44,5,28,11,16,2017
75,JJ Redick,LAC,78,2198,110,251,79,31,62,4,13,11,20,2017
76,Wilson Chandler,DEN,71,2197,141,355,68,73,42,14,12,19,54,2017
77,Al Horford,BOS,68,2193,337,797,214,123,138,39,37,42,81,2017
78,Jrue Holiday,NOP,67,2190,488,1147,317,171,183,63,71,46,125,2017
79,Nik Stauskas,PHI,80,2188,188,441,123,65,80,30,13,14,51,2017
80,Tyler Johnson,MIA,73,2178,233,559,140,93,85,33,22,39,54,2017
81,Eric Bledsoe,PHX,66,2176,418,977,277,141,180,34,63,57,84,2017
82,Kristaps Porzingis,NYK,66,2164,97,233,58,39,24,13,21,12,27,2017
83,Nikola Vucevic,ORL,75,2163,208,510,114,94,68,26,20,17,77,2017
84,Jamal Crawford,LAC,82,2157,214,493,149,65,112,21,16,21,44,2017
85,Tim Hardaway Jr.,ATL,79,2153,182,418,128,54,78,16,34,19,35,2017
86,Mason Plumlee,DEN,81,2148,284,664,188,96,120,22,46,18,78,2017
87,Ersan Ilyasova,ATL,82,2142,141,330,93,48,66,18,9,12,36,2017
88,Danilo Gallinari,DEN,63,2134,135,309,96,39,61,21,14,7,32,2017
89,T.J. McConnell,PHI,81,2133,534,1272,330,204,240,45,45,36,168,2017
90,Julius Randle,LAL,74,2132,264,667,125,139,63,14,48,31,108,2017
91,Dario Saric,PHI,81,2129,182,434,112,70,70,29,13,19,51,2017
92,Robert Covington,PHI,67,2119,102,248,58,44,37,9,12,18,26,2017
93,Ryan Anderson,HOU,72,2117,68,182,22,46,14,7,1,11,35,2017
94,JaMychal Green,MEM,77,2101,84,199,53,31,36,6,11,4,27,2017
95,James Johnson,MIA,76,2085,276,664,164,112,109,18,37,47,65,2017
96,Bojan Bogdanovic,WAS,81,2083,111,267,66,45,45,15,6,16,29,2017
97,Derrick Rose,NYK,64,2082,283,680,169,114,81,29,59,38,76,2017
98,Blake Griffin,LAC,61,2076,300,725,175,125,108,17,50,42,83,2017
99,Kevin Durant,GSW,62,2070,300,730,170,130,108,24,38,35,95,2017
100,Jonas Valanciunas,TOR,80,2066,57,139,32,25,16,8,8,7,18,2017
101,Darren Collison,SAC,68,2063,312,754,182,130,115,36,31,20,110,2017
102,Patrick Beverley,HOU,67,2058,281,682,161,120,130,19,12,28,92,2017
103,Austin Rivers,LAC,74,2054,204,503,109,95,61,8,40,23,72,2017
104,TJ Warren,PHX,66,2048,75,171,54,21,43,5,6,11,10,2017
105,Jameer Nelson,DEN,75,2045,385,917,238,147,148,54,36,42,105,2017
106,Nikola Jokic,DEN,73,2038,359,815,262,97,214,25,23,17,80,2017
107,Seth Curry,DAL,70,2029,189,445,122,67,52,19,51,11,56,2017
108,Cory Joseph,TOR,80,2003,265,641,154,111,76,27,51,40,71,2017
109,Monta Ellis,IND,74,1998,236,550,158,78,85,38,35,26,52,2017
110,Andre Iguodala,GSW,76,1998,261,607,176,85,106,28,42,22,63,2017
111,Lou Williams,HOU,81,1993,239,517,200,39,149,33,18,13,26,2017
112,Taj Gibson,OKC,78,1989,73,164,55,18,32,6,17,10,8,2017
113,Matthew Dellavedova,MIL,76,1986,357,809,262,95,184,41,37,26,69,2017
114,Malcolm Brogdon,MIL,75,1982,317,737,214,103,143,36,35,37,66,2017
115,Joe Ingles,UTA,82,1972,225,518,157,68,125,17,15,31,37,2017
116,Rodney McGruder,MIA,78,1966,124,296,76,48,47,15,14,19,29,2017
117,Kent Bazemore,ATL,73,1963,177,395,136,41,99,17,20,15,26,2017
118,Ish Smith,DET,81,1955,418,987,267,151,137,72,58,44,107,2017
119,Terrence Ross,ORL,78,1955,88,207,57,31,38,8,11,8,23,2017
120,Frank Kaminsky,CHA,75,1954,162,387,99,63,53,13,33,9,54,2017
121,Jon Leuer,DET,75,1944,111,250,83,28,40,30,13,6,22,2017
122,Iman Shumpert,CLE,76,1937,109,265,62,47,38,12,12,18,29,2017
123,Chris Paul,LAC,61,1921,563,1291,398,165,244,26,128,49,116,2017
124,Tony Allen,MEM,71,1914,98,220,74,24,41,10,23,6,18,2017
125,Buddy Hield,SAC,82,1888,121,288,75,46,38,13,24,11,35,2017
126,Kevin Love,CLE,60,1885,116,272,76,40,64,3,9,18,22,2017
127,DeMarre Carroll,TOR,72,1881,74,175,47,27,27,11,9,4,23,2017
128,Joe Johnson,UTA,78,1843,144,349,83,61,59,11,13,29,32,2017
129,Rajon Rondo,CHI,69,1843,461,1039,344,117,174,84,86,40,77,2017
130,Avery Bradley,BOS,55,1835,121,288,75,46,43,16,16,11,35,2017
131,Greg Monroe,MIL,81,1823,187,431,130,57,99,13,18,21,36,2017
132,E'Twaun Moore,NOP,73,1820,164,378,114,50,60,23,31,15,35,2017
133,D'Angelo Russell,LAL,63,1811,303,714,195,108,125,32,38,40,68,2017
134,Danny Green,SAS,68,1807,124,270,102,22,51,18,33,10,12,2017
135,Brandon Jennings,WAS,81,1801,395,918,267,128,159,52,56,32,96,2017
136,Vince Carter,MEM,73,1800,133,305,94,39,53,19,22,11,28,2017
137,Bismack Biyombo,ORL,81,1793,74,174,48,26,19,9,20,2,24,2017
138,Dwyane Wade,CHI,60,1792,228,518,166,62,101,29,36,31,31,2017
139,Luc Mbah a Moute,LAC,80,1787,39,89,28,11,24,0,4,0,11,2017
140,Zach Randolph,MEM,73,1786,122,292,74,48,50,10,14,8,40,2017
141,Gary Harris,DEN,57,1782,164,407,85,79,61,15,9,19,60,2017
142,Marco Belinelli,CHA,74,1777,147,347,94,53,56,26,12,12,41,2017
143,CJ Miles,IND,76,1776,48,109,35,13,22,4,9,6,7,2017
144,Matt Barnes,GSW,74,1776,195,448,137,58,85,20,32,22,36,2017
145,Al-Farouq Aminu,POR,61,1773,99,239,58,41,41,11,6,7,34,2017
146,Jamal Murray,DEN,82,1764,170,401,109,61,75,16,18,12,49,2017
147,Rondae Hollis-Jefferson,BKN,78,1761,154,375,87,67,57,18,12,13,54,2017
148,Patty Mills,SAS,80,1754,280,637,203,77,103,38,62,26,51,2017
149,Trevor Booker,BKN,71,1754,138,356,58,80,36,17,5,17,63,2017
150,Sean Kilpatrick,BKN,70,1754,157,386,85,72,55,24,6,20,52,2017
151,Kyle Korver,CLE,67,1753,110,252,78,32,51,14,13,11,21,2017
152,Zach LaVine,MIN,47,1749,139,307,110,29,50,30,30,3,26,2017
153,Marquese Chriss,PHX,82,1743,60,126,54,6,29,15,10,0,6,2017
154,Ty Lawson,SAC,69,1732,334,780,222,112,144,51,27,36,76,2017
155,Garrett Temple,SAC,65,1728,168,383,121,47,78,30,13,17,30,2017
156,Jabari Parker,MIL,51,1728,142,336,90,52,62,16,12,22,30,2017
157,Cody Zeller,CHA,62,1726,99,238,59,40,33,5,21,9,31,2017
158,Will Barton,DEN,60,1705,206,507,111,95,75,23,13,18,77,2017
159,Raymond Felton,LAC,80,1700,191,454,119,72,76,15,28,14,58,2017
160,Nikola Mirotic,CHI,70,1679,75,173,52,23,34,11,7,8,15,2017
161,Gerald Henderson,PHI,72,1667,112,282,54,58,37,4,13,14,44,2017
162,Evan Turner,POR,65,1659,205,477,138,67,86,18,34,13,54,2017
163,Deron Williams,CLE,64,1657,360,869,211,149,105,27,79,36,113,2017
164,Dante Cunningham,NOP,66,1649,37,90,21,16,11,6,4,3,13,2017
165,Isaiah Whitehead,BKN,73,1644,192,460,116,76,90,17,9,20,56,2017
166,Dorian Finney-Smith,DAL,81,1642,67,174,27,40,13,4,10,20,20,2017
167,Justin Holiday,NYK,82,1639,102,229,77,25,49,9,19,10,15,2017
168,Domantas Sabonis,OKC,81,1631,82,203,43,39,25,10,8,18,21,2017
169,Pau Gasol,SAS,64,1627,150,337,113,37,75,15,23,12,25,2017
170,Josh Richardson,MIA,53,1614,140,338,82,58,44,18,20,16,42,2017
171,Richard Jefferson,CLE,79,1614,78,188,46,32,30,5,11,8,24,2017
172,Amir Johnson,BOS,80,1608,140,341,79,61,45,10,24,21,40,2017
173,Kelly Oubre Jr.,WAS,79,1605,47,111,30,17,11,7,12,2,15,2017
174,Patrick Patterson,TOR,65,1598,76,189,39,37,26,5,8,10,27,2017
175,Thabo Sefolosha,ATL,62,1596,107,253,68,39,39,7,22,10,29,2017
176,Rodney Hood,UTA,59,1593,96,225,63,33,46,7,10,10,23,2017
177,Tony Parker,SAS,63,1587,285,639,216,69,69,38,109,24,45,2017
178,Arron Afflalo,SAC,61,1580,78,185,49,29,20,12,17,7,22,2017
179,Alex Len,PHX,77,1560,44,99,33,11,21,2,10,2,9,2017
180,Nick Young,LAL,60,1556,58,136,38,20,19,13,6,8,12,2017
181,Clint Capela,HOU,65,1551,63,170,19,44,14,5,0,10,34,2017
182,George Hill,UTA,49,1544,204,491,121,83,77,18,26,36,47,2017
183,Kelly Olynyk,BOS,75,1538,148,352,92,56,64,13,15,14,42,2017
184,D.J. Augustin,ORL,78,1538,209,483,144,65,74,27,43,10,55,2017
185,Jeff Green,ORL,69,1534,81,192,51,30,28,12,11,5,25,2017
186,Enes Kanter,OKC,72,1533,67,169,32,35,24,2,6,8,27,2017
187,Jerami Grant,OKC,80,1531,46,111,27,19,17,4,6,7,12,2017
188,Tim Frazier,NOP,65,1525,335,768,237,98,108,65,64,22,76,2017
189,Sergio Rodriguez,PHI,68,1517,344,792,240,104,180,35,25,19,85,2017
190,Shabazz Muhammad,MIN,78,1515,35,80,25,10,12,7,6,2,8,2017
191,Doug McDermott,OKC,66,1508,58,136,38,20,19,7,12,3,17,2017
192,James Ennis III,MEM,64,1501,64,151,41,23,26,5,10,11,12,2017
193,Wayne Ellington,MIA,62,1500,70,174,36,34,19,10,7,11,23,2017
194,Langston Galloway,SAC,74,1494,93,225,54,39,25,11,18,8,31,2017
195,Luol Deng,LAL,56,1486,74,179,43,31,29,5,9,10,21,2017
196,David Lee,SAS,79,1477,124,296,76,48,44,8,24,15,33,2017
197,Anthony Tolliver,SAC,65,1477,77,174,57,20,33,14,10,5,15,2017
198,Andrew Harrison,MEM,72,1474,198,481,113,85,53,23,37,21,64,2017
199,Larry Nance Jr.,LAL,63,1442,96,219,69,27,42,16,11,10,17,2017
200,Glenn Robinson III,IND,69,1427,47,113,28,19,12,4,12,4,15,2017
201,Dirk Nowitzki,DAL,54,1424,82,202,44,38,27,8,9,11,27,2017
202,Reggie Jackson,DET,52,1424,270,631,179,91,88,43,48,22,69,2017
203,Willie Cauley-Stein,SAC,75,1421,80,182,58,22,33,12,13,8,14,2017
204,Kosta Koufos,SAC,71,1419,47,111,30,17,12,7,11,5,12,2017
205,Sam Dekker,HOU,77,1419,76,193,35,41,23,6,6,5,36,2017
206,Emmanuel Mudiay,DEN,55,1406,217,488,163,54,97,31,35,12,42,2017
207,Channing Frye,CLE,74,1398,45,112,23,22,18,2,3,10,12,2017
208,Jonathon Simmons,SAS,78,1392,126,315,63,63,33,11,19,19,44,2017
209,Jusuf Nurkic,POR,65,1391,123,278,91,32,69,9,13,8,24,2017
210,Dion Waiters,MIA,46,1384,200,499,101,99,63,17,21,34,65,2017
211,Stanley Johnson,DET,77,1371,105,236,79,26,42,23,14,5,21,2017
212,Norman Powell,TOR,76,1368,82,200,46,36,27,8,11,11,25,2017
213,Jason Terry,MIL,74,1365,98,231,63,35,53,3,7,11,24,2017
214,Jared Dudley,PHX,64,1362,121,269,94,27,52,29,13,6,21,2017
215,Shaun Livingston,GSW,76,1345,139,319,98,41,47,20,31,15,26,2017
216,Jaylen Brown,BOS,78,1341,64,156,36,28,22,8,6,10,18,2017
217,Spencer Dinwiddie,BKN,59,1334,185,457,98,87,69,17,12,29,58,2017
218,Dwight Powell,DAL,77,1333,49,125,22,27,12,4,6,7,20,2017
219,Kris Dunn,MIN,78,1333,188,440,124,64,72,29,23,19,45,2017
220,Dewayne Dedmon,SAS,76,1330,44,99,33,11,17,3,13,3,8,2017
221,Willy Hernangomez,NYK,72,1324,96,229,59,37,27,12,20,12,25,2017
222,Tyson Chandler,PHX,47,1298,30,71,19,11,10,3,6,3,8,2017
223,Kenneth Faried,DEN,61,1296,55,128,37,18,26,4,7,5,13,2017
224,Manu Ginobili,SAS,69,1291,183,429,120,63,68,21,31,24,39,2017
225,Marreese Speights,LAC,82,1286,65,157,38,27,27,2,9,8,19,2017
226,Randy Foye,BKN,69,1284,135,332,73,62,41,25,7,21,41,2017
227,Boris Diaw,UTA,73,1283,170,402,108,62,86,13,9,15,47,2017
228,Corey Brewer,LAL,82,1281,97,229,62,35,42,10,10,9,26,2017
229,Terrence Jones,MIL,54,1271,59,141,36,23,26,4,6,5,18,2017
230,Zaza Pachulia,GSW,70,1268,132,306,90,42,59,9,22,6,36,2017
231,Noah Vonleh,POR,74,1265,31,80,13,18,8,1,4,3,15,2017
232,Terry Rozier,BOS,74,1263,131,312,81,50,44,17,20,12,38,2017
233,Malcolm Delaney,ATL,73,1248,193,460,119,74,79,15,25,14,60,2017
234,Caris LeVert,BKN,57,1237,110,272,58,52,47,8,3,14,38,2017
235,Mike Muscala,ATL,70,1237,95,230,55,40,33,9,13,10,30,2017
236,Jonas Jerebko,BOS,78,1232,71,176,37,34,21,7,9,5,29,2017
237,Kyle O'Quinn,NYK,79,1229,117,259,92,25,62,13,17,4,21,2017
238,Dante Exum,UTA,66,1228,111,256,77,34,55,12,10,11,23,2017
239,Justin Anderson,PHI,75,1227,66,156,42,24,30,7,5,7,17,2017
240,Meyers Leonard,POR,74,1222,71,178,35,36,18,3,14,7,29,2017
241,Shelvin Mack,UTA,55,1205,154,375,87,67,52,18,17,22,45,2017
242,Nene,HOU,67,1198,65,166,29,36,27,2,0,14,22,2017
243,Yogi Ferrell,DAL,46,1197,172,419,97,75,41,21,35,19,56,2017
244,Richaun Holmes,PHI,57,1193,58,146,28,30,24,2,2,6,24,2017
245,Timothe Luwawu-Cabarrot,PHI,69,1190,75,168,57,18,37,12,8,5,13,2017
246,Nemanja Bjelica,MIN,65,1189,79,182,55,24,36,12,7,10,14,2017
247,JR Smith,CLE,41,1187,62,148,38,24,26,9,3,5,19,2017
248,Derrick Favors,UTA,50,1186,56,132,36,20,26,5,5,5,15,2017
249,Troy Daniels,MEM,67,1183,46,106,32,14,17,6,9,3,11,2017
250,Justin Hamilton,BKN,64,1176,55,134,31,24,22,6,3,4,20,2017
251,Ben McLemore,SAC,61,1176,51,118,35,16,21,9,5,4,12,2017
252,Aron Baynes,DET,75,1162,32,74,22,10,8,6,8,3,7,2017
253,Trey Lyles,UTA,71,1158,69,175,32,37,24,3,5,9,28,2017
254,Jeremy Lamb,CHA,62,1143,75,175,50,25,27,9,14,6,19,2017
255,Brandon Knight,PHX,54,1140,130,314,76,54,44,12,20,14,40,2017
256,Joe Harris,BKN,52,1138,54,127,35,19,20,11,4,10,9,2017
257,Ian Clark,GSW,77,1136,90,207,63,27,36,7,20,9,18,2017
258,Jahlil Okafor,PHI,50,1134,58,141,33,25,23,3,7,5,20,2017
259,Mirza Teletovic,MIL,70,1133,48,114,30,18,18,8,4,6,12,2017
260,Tyler Ulis,PHX,61,1123,226,505,173,53,112,34,27,19,34,2017
261,John Henson,MIL,58,1123,57,133,38,19,22,4,12,6,13,2017
262,Timofey Mozgov,LAL,54,1104,43,105,24,19,11,3,10,5,14,2017
263,Tarik Black,LAL,67,1091,39,97,20,19,10,5,5,6,13,2017
264,Lucas Nogueira,TOR,57,1088,42,109,17,25,12,2,3,10,15,2017
265,Devin Harris,DAL,65,1087,136,313,95,41,56,11,28,10,31,2017
266,Patrick McCaw,GSW,71,1074,77,184,47,30,34,9,4,9,21,2017
267,Jason Smith,WAS,74,1068,37,86,25,12,13,6,6,1,11,2017
268,Luke Babbitt,MIA,68,1065,36,88,20,16,10,2,8,2,14,2017
269,Montrezl Harrell,HOU,58,1064,64,168,24,40,20,2,2,13,27,2017
270,Alex Abrines,OKC,68,1055,40,94,26,14,16,5,5,4,10,2017
271,Nerlens Noel,DAL,51,1047,50,116,34,16,25,0,9,4,12,2017
272,Cristiano Felicio,CHI,66,1040,40,102,18,22,11,1,6,6,16,2017
273,Willie Reed,MIA,71,1031,26,61,17,9,6,3,8,1,8,2017
274,Brandon Rush,MIN,47,1030,45,100,35,10,16,11,8,4,6,2017
275,Jerian Grant,CHI,63,1028,121,272,91,30,48,22,21,8,22,2017
276,Kyle Anderson,SAS,72,1020,91,215,58,33,35,12,11,7,26,2017
277,Mindaugas Kuzminskas,NYK,68,1016,69,163,44,25,26,4,14,8,17,2017
278,Joakim Noah,NYK,46,1015,103,232,77,26,42,5,30,6,20,2017
279,Rudy Gay,SAC,30,1013,83,190,59,24,39,8,12,6,18,2017
280,C.J. Watson,ORL,62,1012,114,277,65,49,26,15,24,9,40,2017
281,Bobby Portis,CHI,64,1000,35,86,19,16,12,2,5,5,11,2017
282,Taurean Prince,ATL,59,981,55,132,33,22,24,2,7,7,15,2017
283,Joffrey Lauvergne,CHI,70,980,70,159,51,19,32,8,11,7,12,2017
284,Denzel Valentine,CHI,57,976,63,150,39,24,16,11,12,10,14,2017
285,Semaj Christon,OKC,64,973,130,305,85,45,49,16,20,14,31,2017
286,Lance Thomas,NYK,46,968,35,80,25,10,10,6,9,5,5,2017
287,Leandro Barbosa,PHX,67,963,81,184,59,22,40,8,11,8,14,2017
288,Mario Hezonja,ORL,65,960,62,143,43,19,29,5,9,5,14,2017
289,Michael Beasley,MIL,56,935,53,122,37,16,25,7,5,4,12,2017
290,Al Jefferson,IND,66,931,57,137,34,23,11,6,17,6,17,2017
291,Salah Mejri,DAL,73,905,14,34,8,6,2,2,4,1,5,2017
292,Aaron Brooks,IND,65,894,125,282,93,32,32,28,33,9,23,2017
293,Khris Middleton,MIL,29,889,99,224,73,26,64,8,1,11,15,2017
294,Jeremy Lin,BKN,36,883,184,422,130,54,90,29,11,19,35,2017
295,Lavoy Allen,IND,61,871,57,135,36,21,18,7,11,7,14,2017
296,Pascal Siakam,TOR,55,859,17,40,11,6,9,1,1,2,4,2017
297,Ron Baker,NYK,52,857,107,248,73,34,45,13,15,9,25,2017
298,David West,GSW,68,854,151,330,123,28,90,15,18,4,24,2017
299,Michael Carter-Williams,CHI,45,846,113,268,71,42,30,11,30,16,26,2017
300,Paul Zipser,CHI,44,843,36,85,23,13,13,5,5,6,7,2017
301,Juan Hernangomez,DEN,62,842,29,72,15,14,6,5,4,3,11,2017
302,Mike Dunleavy,ATL,53,841,50,121,29,21,18,5,6,10,11,2017
303,Ramon Sessions,CHA,50,811,129,291,96,33,47,21,28,7,26,2017
304,Wesley Johnson,LAC,68,810,23,55,14,9,7,3,4,2,7,2017
305,Davis Bertans,SAS,67,807,46,110,28,18,20,2,6,8,10,2017
306,Derrick Williams,CLE,50,804,28,70,14,14,10,2,2,4,10,2017
307,Spencer Hawes,MIL,54,797,81,180,63,18,40,11,12,3,15,2017
308,Ed Davis,POR,46,789,26,62,16,10,10,1,5,2,8,2017
309,Tyreke Evans,SAC,40,788,124,301,71,53,37,17,17,15,38,2017
310,Joel Embiid,PHI,31,786,66,164,34,32,24,3,7,4,28,2017
311,DeAndre Liggins,DAL,62,776,54,134,28,26,21,6,1,7,19,2017
312,Tyus Jones,MIN,60,774,156,358,110,46,75,17,18,11,35,2017
313,J.J. Barea,DAL,35,771,193,430,149,44,90,22,37,14,30,2017
314,Hollis Thompson,NOP,40,752,35,83,22,13,13,5,4,3,10,2017
315,JaVale McGee,GSW,77,739,17,41,10,7,6,3,1,1,6,2017
316,Jodie Meeks,ORL,36,737,45,111,24,21,19,3,2,6,15,2017
317,Tomas Satoransky,WAS,57,719,92,213,63,29,28,14,21,5,24,2017
318,Anthony Morrow,CHI,49,714,25,58,17,8,12,4,1,4,4,2017
319,Alan Williams,PHX,47,708,23,54,15,8,8,4,3,0,8,2017
320,Trey Burke,WAS,57,703,100,231,69,31,25,15,29,7,24,2017
321,Rodney Stuckey,IND,39,696,84,197,55,29,22,20,13,11,18,2017
322,Kris Humphries,ATL,56,689,29,68,19,10,9,1,9,1,9,2017
323,Roy Hibbert,DEN,48,682,21,52,11,10,6,3,2,2,8,2017
324,Chandler Parsons,MEM,34,675,55,133,32,23,14,4,14,11,12,2017
325,Alec Burks,UTA,42,653,30,65,25,5,19,4,2,2,3,2017
326,Omri Casspi,MIN,36,642,37,87,24,13,17,5,2,4,9,2017
327,Darrell Arthur,DEN,41,638,42,99,27,15,18,3,6,4,11,2017
328,Jakob Poeltl,TOR,54,626,12,30,6,6,2,3,1,3,3,2017
329,Justise Winslow,MIA,18,625,66,153,45,21,25,7,13,11,10,2017
330,Skal Labissiere,SAC,33,612,27,61,20,7,9,5,6,0,7,2017
331,Ivica Zubac,LAL,38,609,30,71,19,11,9,6,4,4,7,2017
332,Isaiah Canaan,CHI,39,592,37,87,24,13,11,5,8,5,8,2017
333,Tyler Ennis,LAL,53,588,86,200,58,28,40,12,6,8,20,2017
334,Alexis Ajinca,NOP,39,584,12,27,9,3,5,2,2,1,2,2017
335,Andrew Bogut,CLE,27,583,49,116,31,18,23,5,3,5,13,2017
336,Brandon Bass,LAC,52,577,21,53,10,11,5,3,2,1,10,2017
337,Marcus Thornton,WAS,33,575,41,89,34,7,13,8,13,1,6,2017
338,Dragan Bender,PHX,43,574,23,49,20,3,15,2,3,2,1,2017
339,Thon Maker,MIL,57,562,23,53,16,7,13,1,2,3,4,2017
340,Thomas Robinson,LAL,48,560,31,76,17,14,10,3,4,5,9,2017
341,Beno Udrih,DET,39,560,131,294,99,32,54,23,22,7,25,2017
342,Kevin Seraphin,IND,49,559,23,56,13,10,9,1,3,3,7,2017
343,Jarell Martin,MEM,42,558,8,19,5,3,3,0,2,2,1,2017
344,Quincy Acy,BKN,38,558,18,42,12,6,9,1,2,3,3,2017
345,Troy Williams,HOU,30,557,25,57,18,7,11,3,4,4,3,2017
346,Ian Mahinmi,WAS,31,555,19,46,11,8,6,3,2,1,7,2017
347,Derrick Jones Jr.,PHX,32,545,12,30,6,6,0,2,4,0,6,2017
348,Jose Calderon,ATL,41,539,88,200,64,24,32,8,24,4,20,2017
349,Gerald Green,BOS,47,538,33,76,23,10,19,2,2,1,9,2017
350,Cole Aldrich,MIN,62,531,25,59,16,9,6,4,6,3,6,2017
351,Tyler Zeller,BOS,51,525,42,99,27,15,15,6,6,1,14,2017
352,Nicolas Brussino,DAL,54,521,47,106,35,12,22,4,9,2,10,2017
353,Shabazz Napier,POR,53,512,67,165,36,31,24,4,8,8,23,2017
354,KJ McDaniels,BKN,49,506,13,28,11,2,10,0,1,2,0,2017
355,Miles Plumlee,CHA,45,485,21,49,14,7,7,2,5,2,5,2017
356,Omer Asik,NOP,31,482,15,38,7,8,2,3,2,4,4,2017
357,Donatas Motiejunas,NOP,34,479,32,74,22,10,8,9,5,3,7,2017
358,Okaro White,MIA,35,471,21,56,7,14,5,2,0,5,9,2017
359,Reggie Bullock,DET,31,467,29,66,21,8,12,6,3,3,5,2017
360,Cameron Payne,CHI,31,462,55,124,41,14,28,3,10,7,7,2017
361,Luis Scola,BKN,36,461,37,85,26,11,23,2,1,1,10,2017
362,Rashad Vaughn,MIL,41,459,23,50,19,4,12,5,2,2,2,2017
363,James Michael McAdoo,GSW,52,457,18,42,12,6,5,5,2,2,4,2017
364,Kevon Looney,GSW,53,447,29,71,16,13,7,3,6,4,9,2017
365,Brandan Wright,MEM,28,447,15,36,9,6,6,2,1,1,5,2017
366,Delon Wright,TOR,27,446,57,146,25,32,17,4,4,12,20,2017
367,Jordan Crawford,NOP,19,442,57,128,43,14,33,6,4,4,10,2017
368,Jeff Withey,UTA,51,432,7,18,3,4,1,0,2,1,3,2017
369,Brian Roberts,CHA,41,416,52,120,36,16,17,8,11,4,12,2017
370,Sasha Vujacic,NYK,42,408,52,118,38,14,21,6,11,4,10,2017
371,Wade Baldwin IV,MEM,33,405,61,150,33,28,18,6,9,11,17,2017
372,David Nwaba,LAL,20,397,14,33,9,5,6,1,2,0,5,2017
373,Toney Douglas,MEM,24,394,56,134,34,22,15,9,10,2,20,2017
374,Kay Felder,CLE,42,386,58,150,24,34,15,2,7,12,22,2017
375,Kyle Singler,OKC,32,385,9,20,7,2,4,2,1,0,2,2017
376,Jordan McRae,CLE,37,383,19,48,9,10,3,1,5,2,8,2017
377,Josh McRoberts,MIA,22,381,50,112,38,12,19,10,9,2,10,2017
378,Darrun Hilliard,DET,39,381,33,78,21,12,9,6,6,6,6,2017
379,James Jones,CLE,48,380,14,35,7,7,4,0,3,2,5,2017
380,DeAndre' Bembry,ATL,38,371,28,70,14,14,7,3,4,3,11,2017
381,Lance Stephenson,IND,18,362,59,142,35,24,21,6,8,7,17,2017
382,Georgios Papagiannis,SAC,22,355,20,45,15,5,6,4,5,0,5,2017
383,Raul Neto,UTA,40,346,34,81,21,13,17,2,2,3,10,2017
384,Andrew Nicholson,BKN,38,342,10,24,6,4,3,1,2,1,3,2017
385,Maurice Ndour,NYK,32,331,8,17,7,1,5,1,1,0,1,2017
386,Dejounte Murray,SAS,38,321,48,107,37,11,23,5,9,4,7,2017
387,Pat Connaughton,POR,39,316,28,70,14,14,7,2,5,4,10,2017
388,Damjan Rudez,ORL,45,314,20,44,16,4,12,3,1,0,4,2017
389,Alan Anderson,LAC,30,308,11,23,10,1,9,0,1,0,1,2017
390,Chasson Randle,NYK,26,299,34,78,24,10,12,3,9,2,8,2017
391,Fred VanVleet,TOR,36,294,35,82,23,12,13,7,3,4,8,2017
392,Boban Marjanovic,DET,35,293,9,19,8,1,5,0,3,1,0,2017
393,Sheldon Mac,WAS,30,287,15,33,12,3,5,3,4,0,3,2017
394,Bryn Forbes,SAS,36,285,23,53,16,7,7,3,6,0,7,2017
395,Paul Pierce,LAC,25,277,10,26,4,6,2,0,2,3,3,2017
396,Anthony Bennett,BKN,23,264,12,32,4,8,2,2,0,2,6,2017
397,Jake Layman,POR,35,249,11,28,5,6,2,0,3,0,6,2017
398,Deyonta Davis,MEM,36,238,2,4,2,0,1,0,1,0,0,2017
399,Marcelo Huertas,LAL,23,237,52,115,41,11,28,6,7,4,7,2017
400,Wayne Selden,MEM,14,236,13,29,10,3,5,3,2,0,3,2017
401,Shawn Long,PHI,17,234,13,30,9,4,6,3,0,2,2,2017
402,Jonathan Gibson,DAL,17,231,26,67,11,15,8,0,3,3,12,2017
403,James Young,BOS,29,220,4,10,2,2,1,0,1,1,1,2017
404,Rakeem Christmas,IND,29,219,4,8,4,0,3,1,0,0,0,2017
405,Archie Goodwin,BKN,15,214,24,56,16,8,11,4,1,2,6,2017
406,Briante Weber,CHA,20,205,21,54,9,12,3,3,3,2,10,2017
407,Cheick Diallo,NOP,17,199,4,10,2,2,1,0,1,0,2,2017
408,Malachi Richardson,SAC,22,198,11,27,6,5,5,0,1,2,3,2017
409,Mike Scott,ATL,18,195,17,40,11,6,8,3,0,1,5,2017
410,Treveon Graham,CHA,27,189,6,15,3,3,1,0,2,0,3,2017
411,Quinn Cook,NOP,14,187,26,60,18,8,11,2,5,1,7,2017
412,Nicolas Laprovittola,SAS,18,174,28,63,21,7,13,1,7,4,3,2017
413,Marshall Plumlee,NYK,21,170,10,25,5,5,1,1,3,2,3,2017
414,Malik Beasley,DEN,22,165,11,25,8,3,5,1,2,0,3,2017
415,AJ Hammons,DAL,22,163,4,10,2,2,1,1,0,0,2,2017
416,Metta World Peace,LAL,25,160,11,22,11,0,5,4,2,0,0,2017
417,Anthony Brown,ORL,11,159,8,19,5,3,4,1,0,0,3,2017
418,Alex Poythress,PHI,6,157,5,12,3,2,1,1,1,0,2,2017
419,Mike Miller,DEN,20,151,22,54,12,10,8,3,1,4,6,2017
420,Henry Ellenson,DET,19,146,7,17,4,3,1,2,1,0,3,2017
421,Jordan Mickey,BOS,25,141,7,17,4,3,2,0,2,1,2,2017
422,Adreian Payne,MIN,18,135,7,15,6,1,5,1,0,0,1,2017
423,Joe Young,IND,33,135,15,34,11,4,6,1,4,3,1,2017
424,Ronnie Price,PHX,14,134,18,41,13,5,6,3,4,2,3,2017
425,Udonis Haslem,MIA,16,130,6,13,5,1,0,0,5,0,1,2017
426,Nick Collison,OKC,20,128,12,26,10,2,10,0,0,1,1,2017
427,Norris Cole,OKC,13,125,14,29,13,1,7,2,4,0,1,2017
428,Bobby Brown,HOU,25,123,14,34,8,6,8,0,0,0,6,2017
429,Joel Anthony,SAS,19,122,3,7,2,1,1,1,0,1,0,2017
430,Jared Sullinger,TOR,11,118,3,8,1,2,0,0,1,0,2,2017
431,Jarrod Uthoff,DAL,9,115,9,22,5,4,2,0,3,1,3,2017
432,Chris Andersen,CLE,12,114,5,14,1,4,0,0,1,2,2,2017
433,Ryan Kelly,ATL,16,110,8,18,6,2,5,0,1,0,2,2017
434,Stephen Zimmerman,ORL,19,108,4,9,3,1,2,0,1,0,1,2017
435,CJ Wilcox,ORL,22,108,12,31,5,7,1,2,2,2,5,2017
436,Christian Wood,CHA,13,107,2,5,1,1,1,0,0,1,0,2017
437,Gary Payton II,MIL,6,99,13,33,6,7,4,1,1,2,5,2017
438,Georges Niang,IND,23,93,5,11,4,1,1,1,2,0,1,2017
439,Anderson Varejao,GSW,14,92,10,24,6,4,3,2,1,1,3,2017
440,Alonzo Gee,DEN,13,89,6,16,2,4,1,0,1,1,3,2017
441,Damian Jones,GSW,10,85,0,0,0,0,0,0,0,0,0,2017
442,Pierre Jackson,DAL,8,84,19,45,12,7,9,1,2,2,5,2017
443,Johnny O'Bryant III,CHA,11,81,6,16,2,4,2,0,0,0,4,2017
444,Chris McCullough,WAS,16,80,2,4,2,0,2,0,0,0,0,2017
445,Tim Quarterman,POR,16,80,11,26,7,4,2,3,2,2,2,2017
446,Reggie Williams,NOP,6,79,4,9,3,1,2,1,0,0,1,2017
447,Tiago Splitter,PHI,8,76,4,8,4,0,2,2,0,0,0,2017
448,Daniel Ochefu,WAS,19,75,3,9,0,3,0,0,0,2,1,2017
449,Jerryd Bayless,PHI,3,72,13,32,7,6,5,2,0,1,5,2017
450,Jarell Eddie,PHX,5,62,0,0,0,0,0,0,0,0,0,2017
451,Joel Bolomboy,UTA,12,53,2,5,1,1,1,0,0,1,0,2017
452,Isaiah Taylor,HOU,4,52,3,7,2,1,2,0,0,0,1,2017
453,Chinanu Onuaku,HOU,5,52,3,6,3,0,2,1,0,0,0,2017
454,Marcus Georges-Hunt,ORL,5,48,3,8,1,2,0,0,1,0,2,2017
455,Axel Toupane,NOP,4,47,0,0,0,0,0,0,0,0,0,2017
456,Jordan Hill,MIN,7,47,0,0,0,0,0,0,0,0,0,2017
457,Kyle Wiltjer,HOU,14,44,2,5,1,1,1,0,0,0,1,2017
458,Patricio Garino,ORL,5,43,0,0,0,0,0,0,0,0,0,2017
459,Lamar Patterson,ATL,5,40,6,12,6,0,4,0,2,0,0,2017
460,Bruno Caboclo,TOR,9,40,4,10,2,2,2,0,0,1,1,2017
461,Greivis Vasquez,BKN,3,39,5,14,1,4,0,1,0,0,4,2017
462,Jordan Farmar,SAC,2,35,9,21,6,3,4,2,0,1,2,2017
463,Jarrett Jack,NOP,2,33,5,12,3,2,1,1,1,1,1,2017
464,Michael Gbinije,DET,9,32,2,5,1,1,0,1,0,1,0,2017
465,Justin Harper,PHI,3,31,2,5,1,1,0,0,1,0,1,2017
466,Josh Huestis,OKC,2,31,3,9,0,3,0,0,0,1,2,2017
467,Arinze Onuaku,ORL,8,28,2,5,1,1,0,0,1,0,1,2017
468,Edy Tavares,CLE,2,28,1,3,0,1,0,0,0,0,1,2017
469,Mike Tobey,CHA,2,25,1,2,1,0,0,0,1,0,0,2017
470,Manny Harris,DAL,4,25,2,5,1,1,0,1,0,0,1,2017
471,Diamond Stone,LAC,7,24,0,0,0,0,0,0,0,0,0,2017
472,Elijah Millsap,PHX,2,23,1,3,0,1,0,0,0,1,0,2017
473,Steve Novak,MIL,8,22,0,0,0,0,0,0,0,0,0,2017
474,Gary Neal,ATL,2,18,1,3,0,1,0,0,0,0,1,2017
475,Demetrius Jackson,BOS,5,17,3,6,3,0,3,0,0,0,0,2017
476,Aaron Harrison,CHA,5,17,3,8,1,2,1,0,0,2,0,2017
477,John Jenkins,PHX,4,13,1,2,1,0,1,0,0,0,0,2017
478,Larry Sanders,CLE,5,13,0,0,0,0,0,0,0,0,0,2017
479,Dahntay Jones,CLE,1,12,1,3,0,1,0,0,0,0,1,2017
480,John Lucas III,MIN,5,11,1,2,1,0,0,1,0,0,0,2017
481,Ben Bentil,DAL,3,10,0,0,0,0,0,0,0,0,0,2017
482,Brice Johnson,LAC,3,9,1,3,0,1,0,0,0,0,1,2017
483,RJ Hunter,CHI,3,9,0,0,0,0,0,0,0,0,0,2017
484,Jarnell Stokes,DEN,2,7,2,6,0,2,0,0,0,0,2,2017
485,Danuel House,WAS,1,1,0,0,0,0,0,0,0,0,0,2017
0,James Harden,HOU,82,3125,612,1458,378,234,294,65,19,106,128,2016
1,Gordon Hayward,UTA,80,2893,296,704,184,112,124,35,25,55,57,2016
2,Kemba Walker,CHA,81,2885,421,1037,226,195,135,43,48,35,160,2016
3,Trevor Ariza,HOU,81,2859,188,456,108,80,78,18,12,28,52,2016
4,Marcus Morris,DET,80,2856,201,473,130,71,76,30,24,29,42,2016
5,Khris Middleton,MIL,79,2852,331,704,289,42,208,46,35,19,23,2016
6,Kyle Lowry,TOR,77,2851,494,1140,342,152,219,63,60,70,82,2016
7,Andrew Wiggins,MIN,81,2845,164,371,121,43,53,21,47,13,30,2016
8,Giannis Antetokounmpo,MIL,80,2823,345,754,281,64,161,65,55,23,41,2016
9,Paul George,IND,81,2819,329,730,257,72,174,37,46,30,42,2016
10,Draymond Green,GSW,81,2808,598,1411,383,215,268,53,62,70,145,2016
11,DeMar DeRozan,TOR,78,2804,315,790,155,160,104,28,23,51,109,2016
12,Kentavious Caldwell-Pope,DET,76,2789,138,335,79,59,52,20,7,23,36,2016
13,John Wall,WAS,77,2784,789,1854,513,276,293,89,131,89,187,2016
14,CJ McCollum,POR,80,2780,341,799,224,117,137,37,50,43,74,2016
15,Russell Westbrook,OKC,80,2750,834,1828,674,160,403,115,156,53,107,2016
16,Monta Ellis,IND,81,2734,383,893,256,127,163,42,51,49,78,2016
17,LeBron James,CLE,76,2709,514,1268,274,240,164,53,57,95,145,2016
18,Joe Johnson,MIA,81,2704,318,711,243,75,116,67,60,36,39,2016
19,Stephen Curry,GSW,79,2700,527,1222,359,168,264,42,53,46,122,2016
20,Damian Lillard,POR,75,2676,512,1217,319,193,202,50,67,67,126,2016
21,Klay Thompson,GSW,80,2666,166,384,114,52,86,12,16,21,31,2016
22,Andre Drummond,DET,81,2666,67,164,37,30,22,7,8,13,17,2016
23,Paul Millsap,ATL,81,2647,265,642,153,112,107,12,34,41,71,2016
24,Isaiah Thomas,BOS,82,2644,509,1190,337,172,188,47,102,54,118,2016
25,Wesley Matthews,DAL,78,2644,151,361,92,59,46,19,27,12,47,2016
26,Al Horford,ATL,82,2631,263,627,162,101,105,18,39,35,66,2016
27,Karl-Anthony Towns,MIN,82,2627,161,363,120,41,66,17,37,8,33,2016
28,DeAndre Jordan,LAC,77,2598,90,207,63,27,33,6,24,11,16,2016
29,Kevin Durant,OKC,72,2578,361,827,256,105,140,54,62,66,39,2016
30,Evan Fournier,ORL,79,2566,214,470,172,42,75,28,69,14,28,2016
31,Jordan Clarkson,LAL,79,2552,192,450,126,66,65,24,37,17,49,2016
32,Rodney Hood,UTA,79,2541,213,505,134,79,81,20,33,30,49,2016
33,PJ Tucker,PHX,82,2540,177,412,119,58,74,12,33,15,43,2016
34,Rajon Rondo,SAC,72,2537,839,1873,644,195,386,109,149,60,135,2016
35,Avery Bradley,BOS,76,2536,158,352,122,36,73,26,23,7,29,2016
36,Carmelo Anthony,NYK,72,2530,299,704,193,106,98,56,39,33,73,2016
37,George Hill,IND,74,2524,259,594,183,76,81,31,71,27,49,2016
38,Tobias Harris,DET,76,2513,169,406,101,68,47,26,28,24,44,2016
39,Serge Ibaka,OKC,78,2500,66,170,28,38,20,5,3,16,22,2016
40,Jimmy Butler,CHI,67,2474,321,745,218,103,83,43,92,31,72,2016
41,Brook Lopez,BKN,73,2457,146,331,107,39,72,17,18,10,29,2016
42,Nicolas Batum,CHA,70,2448,403,955,254,149,162,59,33,32,117,2016
43,Gary Harris,DEN,76,2439,147,334,107,40,65,17,25,10,30,2016
44,Kevin Love,CLE,77,2425,185,438,117,68,87,14,16,20,48,2016
45,Reggie Jackson,DET,79,2424,492,1150,326,166,205,63,58,52,114,2016
46,Chris Paul,LAC,74,2420,738,1710,504,234,295,41,168,60,174,2016
47,Jabari Parker,MIL,76,2408,130,287,103,27,73,15,15,10,17,2016
48,Thaddeus Young,BKN,73,2408,136,313,95,41,55,29,11,21,20,2016
49,Kyle Korver,ATL,80,2401,164,371,121,43,75,22,24,16,27,2016
50,Luol Deng,MIA,74,2394,140,328,92,48,61,12,19,23,25,2016
51,Kawhi Leonard,SAS,72,2380,186,425,133,53,59,25,49,13,40,2016
52,Victor Oladipo,ORL,72,2379,282,642,204,78,92,35,77,24,54,2016
53,Rudy Gay,SAC,70,2379,120,281,79,41,54,12,13,13,28,2016
54,Arron Afflalo,NYK,71,2371,144,335,97,47,33,25,39,8,39,2016
55,Dirk Nowitzki,DAL,75,2364,132,324,72,60,52,9,11,28,32,2016
56,Goran Dragic,MIA,72,2363,419,946,311,108,175,39,97,43,65,2016
57,JR Smith,CLE,77,2362,130,311,79,51,50,9,20,19,32,2016
58,Will Barton,DEN,82,2353,203,455,154,49,100,19,35,13,36,2016
59,Al-Farouq Aminu,POR,82,2341,138,335,79,59,49,16,14,19,40,2016
60,Marvin Williams,CHA,81,2338,110,270,60,50,30,8,22,11,39,2016
61,Courtney Lee,CHA,79,2334,136,315,93,43,34,23,36,16,27,2016
62,Ricky Rubio,MIN,76,2323,658,1398,576,82,292,110,174,21,61,2016
63,Greg Monroe,MIL,79,2314,178,410,124,54,82,16,26,16,38,2016
64,Jae Crowder,BOS,73,2308,135,305,100,35,71,12,17,8,27,2016
65,Zach LaVine,MIN,82,2293,251,554,199,52,108,29,62,12,40,2016
66,Pau Gasol,CHI,72,2292,294,669,213,81,160,32,21,17,64,2016
67,Julius Randle,LAL,81,2286,144,359,73,71,37,12,24,16,55,2016
68,Dwight Howard,HOU,71,2280,98,233,61,37,45,8,8,9,28,2016
69,Otto Porter Jr.,WAS,75,2276,120,269,91,29,62,13,16,10,19,2016
70,Evan Turner,BOS,81,2271,359,817,260,99,183,30,47,24,75,2016
71,Tristan Thompson,CLE,82,2269,62,162,24,38,14,3,7,8,30,2016
72,LaMarcus Aldridge,SAS,74,2261,110,261,69,41,36,14,19,10,31,2016
73,D'Angelo Russell,LAL,80,2259,266,609,189,77,106,35,48,16,61,2016
74,Dwyane Wade,MIA,74,2258,344,789,243,101,173,30,40,55,46,2016
75,Marcin Gortat,WAS,75,2256,106,245,73,33,39,7,27,7,26,2016
76,Jeff Teague,ATL,79,2255,470,1093,317,153,175,44,98,36,117,2016
77,Jeff Green,LAC,80,2253,138,328,86,52,42,22,22,25,27,2016
78,DeMarcus Cousins,SAC,65,2246,214,500,142,72,107,13,22,24,48,2016
79,Ish Smith,PHI,77,2239,502,1177,329,173,210,42,77,38,135,2016
80,Justise Winslow,MIA,78,2232,118,266,88,30,52,13,23,15,15,2016
81,Gorgui Dieng,MIN,82,2220,143,325,104,39,59,9,36,15,24,2016
82,Robin Lopez,NYK,82,2219,114,258,84,30,24,8,52,6,24,2016
83,Darren Collison,SAC,74,2219,318,733,221,97,125,58,38,15,82,2016
84,Raymond Felton,DAL,80,2192,284,690,162,122,100,14,48,39,83,2016
85,Matt Barnes,MEM,76,2190,163,355,134,29,83,24,27,14,15,2016
86,Anthony Davis,NOP,61,2164,116,274,74,42,50,9,15,9,33,2016
87,Hollis Thompson,PHI,77,2154,99,232,65,34,45,11,9,13,21,2016
88,Dion Waiters,OKC,78,2152,154,374,88,66,52,16,20,26,40,2016
89,Elfrid Payton,ORL,73,2145,467,1047,354,113,181,55,118,29,84,2016
90,Jamal Crawford,LAC,79,2126,183,417,132,51,100,10,22,15,36,2016
91,Hassan Whiteside,MIA,73,2126,29,61,26,3,17,3,6,1,2,2016
92,Bojan Bogdanovic,BKN,79,2115,99,227,70,29,32,20,18,12,17,2016
93,Devin Booker,PHX,76,2108,200,470,130,70,88,17,25,25,45,2016
94,Deron Williams,DAL,65,2106,378,905,229,149,115,36,78,30,119,2016
95,Allen Crabbe,POR,81,2105,99,234,63,36,38,10,15,8,28,2016
96,Jared Dudley,WAS,81,2098,171,394,119,52,79,26,14,18,34,2016
97,Derrick Rose,CHI,66,2098,311,713,220,91,93,27,100,37,54,2016
98,JJ Redick,LAC,75,2097,106,249,69,37,49,5,15,15,22,2016
99,Mason Plumlee,POR,82,2084,226,543,135,91,77,16,42,24,67,2016
100,Kent Bazemore,ATL,75,2083,171,380,133,38,85,20,28,8,30,2016
101,Emmanuel Mudiay,DEN,68,2068,372,841,275,97,182,48,45,26,71,2016
102,Jerami Grant,PHI,77,2066,135,333,72,63,43,13,16,19,44,2016
103,Danny Green,SAS,79,2061,141,315,108,33,48,25,35,15,18,2016
104,Jeremy Lin,CHA,78,2048,235,562,143,92,92,24,27,23,69,2016
105,Kristaps Porzingis,NYK,72,2046,94,224,58,36,30,11,17,12,24,2016
106,Cory Joseph,TOR,80,2046,250,602,148,102,80,36,32,30,72,2016
107,Harrison Barnes,GSW,66,2041,117,295,56,61,33,4,19,16,45,2016
108,Patrick Beverley,HOU,71,2041,239,566,151,88,104,35,12,33,55,2016
109,Nikola Vucevic,ORL,65,2037,179,444,93,86,69,6,18,18,68,2016
110,Langston Galloway,NYK,82,2033,207,480,141,66,67,20,54,20,46,2016
111,Jose Calderon,NYK,72,2024,298,694,200,98,80,51,69,33,65,2016
112,Patrick Patterson,TOR,79,2020,94,224,58,36,30,7,21,11,25,2016
113,Zach Randolph,MEM,68,2017,142,341,85,57,52,12,21,5,52,2016
114,Steven Adams,OKC,80,2015,62,146,40,22,17,6,17,7,15,2016
115,Ryan Anderson,NOP,66,2008,73,174,45,28,26,9,10,11,17,2016
116,Zaza Pachulia,DAL,76,2004,128,301,83,45,44,4,35,7,38,2016
117,Derrick Favors,UTA,62,1983,94,231,51,43,32,7,12,16,27,2016
118,Tony Parker,SAS,72,1981,379,841,296,83,105,60,131,22,61,2016
119,Dante Cunningham,NOP,80,1971,77,178,53,24,21,10,22,4,20,2016
120,Isaiah Canaan,PHI,77,1966,137,324,87,50,55,16,16,9,41,2016
121,Nerlens Noel,PHI,67,1965,122,283,83,39,62,13,8,9,30,2016
122,Garrett Temple,WAS,80,1951,140,320,100,40,48,21,31,11,29,2016
123,Taj Gibson,CHI,73,1936,106,244,74,32,33,14,27,4,28,2016
124,Rudy Gobert,UTA,61,1932,91,216,57,34,30,9,18,5,29,2016
125,Jared Sullinger,BOS,81,1915,187,440,121,66,67,24,30,16,50,2016
126,Lou Williams,LAL,67,1907,167,377,124,43,79,18,27,16,27,2016
127,Robert Covington,PHI,67,1903,97,225,66,31,54,8,4,10,21,2016
128,Ersan Ilyasova,ORL,74,1880,67,158,43,24,20,15,8,9,15,2016
129,Omri Casspi,SAC,69,1880,95,210,75,20,50,16,9,4,16,2016
130,Roy Hibbert,LAL,81,1878,95,216,69,26,27,14,28,7,19,2016
131,Brandon Knight,PHX,52,1870,263,636,153,110,99,30,24,35,75,2016
132,Matthew Dellavedova,CLE,76,1867,337,788,223,114,168,30,25,36,78,2016
133,Kobe Bryant,LAL,66,1863,184,416,136,48,79,26,31,9,39,2016
134,Aaron Gordon,ORL,78,1863,128,283,101,27,59,11,31,7,20,2016
135,Doug McDermott,CHI,81,1860,59,140,37,22,19,4,14,3,19,2016
136,Danilo Gallinari,DEN,53,1839,135,303,102,33,69,19,14,9,24,2016
137,Jrue Holiday,NOP,65,1831,391,901,272,119,155,46,71,29,90,2016
138,Alex Len,PHX,78,1821,97,231,60,37,33,12,15,10,27,2016
139,Ian Mahinmi,IND,71,1816,104,252,60,44,27,9,24,15,29,2016
140,Nik Stauskas,PHI,73,1809,138,315,99,39,66,15,18,17,22,2016
141,Bismack Biyombo,TOR,82,1808,29,72,15,14,9,2,4,2,12,2016
142,Amir Johnson,BOS,79,1800,138,322,92,46,43,15,34,8,38,2016
143,Chandler Parsons,DAL,61,1799,169,411,96,73,56,14,26,32,41,2016
144,Marc Gasol,MEM,52,1791,196,449,139,57,74,24,41,11,46,2016
145,Chris Bosh,MIA,53,1778,128,292,92,36,50,12,30,13,23,2016
146,Cody Zeller,CHA,73,1774,71,173,40,31,19,5,16,11,20,2016
147,Mike Conley,MEM,56,1761,342,756,270,72,111,60,99,19,53,2016
148,Thabo Sefolosha,ATL,75,1758,107,252,69,38,49,9,11,8,30,2016
149,Shane Larkin,BKN,78,1751,342,771,255,87,116,72,67,36,51,2016
150,Terrence Ross,TOR,73,1747,56,133,35,21,28,3,4,10,11,2016
151,Nikola Jokic,DEN,80,1733,189,438,129,60,93,11,25,20,40,2016
152,Andre Iguodala,GSW,65,1732,219,528,129,90,96,14,19,24,66,2016
153,Enes Kanter,OKC,82,1721,33,82,17,16,7,4,6,0,16,2016
154,Bradley Beal,WAS,55,1708,162,376,110,52,62,26,22,15,37,2016
155,Frank Kaminsky,CHA,81,1708,98,247,47,51,25,8,14,10,41,2016
156,Kenneth Faried,DEN,67,1695,79,188,49,30,33,3,13,4,26,2016
157,Stanley Johnson,DET,73,1687,118,282,72,46,46,20,6,18,28,2016
158,Mirza Teletovic,PHX,79,1685,89,211,56,33,43,5,8,8,25,2016
159,Ed Davis,POR,81,1684,88,208,56,32,25,5,26,10,22,2016
160,Shabazz Muhammad,MIN,82,1682,52,117,39,13,27,1,11,5,8,2016
161,Marco Belinelli,SAC,68,1672,127,298,83,44,51,14,18,16,28,2016
162,Corey Brewer,HOU,82,1669,109,257,70,39,56,10,4,16,23,2016
163,Kyrie Irving,CLE,53,1667,250,600,150,100,79,34,37,35,65,2016
164,Ramon Sessions,WAS,82,1667,239,538,179,60,91,36,52,10,50,2016
165,J.J. Barea,DAL,74,1667,302,692,214,88,126,36,52,24,64,2016
166,Marcus Smart,BOS,61,1667,185,428,127,58,92,15,20,19,39,2016
167,Wesley Johnson,LAC,80,1666,49,117,30,19,24,3,3,3,16,2016
168,Patty Mills,SAS,81,1662,226,498,180,46,79,35,66,15,31,2016
169,Michael Carter-Williams,MIL,54,1649,281,626,217,64,133,34,50,19,45,2016
170,Nikola Mirotic,CHI,66,1646,100,226,74,26,52,7,15,9,17,2016
171,Randy Foye,OKC,81,1641,161,375,108,53,62,16,30,13,40,2016
172,Luis Scola,TOR,76,1636,66,161,37,29,25,3,9,9,20,2016
173,Trevor Booker,UTA,79,1632,83,208,41,42,23,11,7,17,25,2016
174,Alonzo Gee,NOP,73,1632,72,172,44,28,24,7,13,5,23,2016
175,Markieff Morris,WAS,64,1629,124,293,79,45,52,15,12,14,31,2016
176,Dennis Schroder,ATL,80,1621,349,834,213,136,133,28,52,21,115,2016
177,Tony Allen,MEM,64,1620,70,151,59,11,27,19,13,2,9,2016
178,Tyson Chandler,PHX,66,1618,64,149,43,21,26,7,10,6,15,2016
179,Wayne Ellington,BKN,76,1615,83,189,60,23,34,13,13,7,16,2016
180,T.J. McConnell,PHI,81,1606,367,888,213,154,150,30,33,52,102,2016
181,Lavoy Allen,IND,79,1599,76,183,45,31,25,8,12,9,22,2016
182,Jahlil Okafor,PHI,53,1591,65,152,43,22,27,8,8,4,18,2016
183,Jonas Valanciunas,TOR,60,1557,42,106,20,22,14,3,3,6,16,2016
184,Gerald Green,MIA,69,1557,56,124,44,12,24,7,13,7,5,2016
185,Andre Roberson,OKC,70,1553,47,111,30,17,15,4,11,4,13,2016
186,Tim Duncan,SAS,61,1537,163,354,135,28,83,21,31,9,19,2016
187,Shaun Livingston,GSW,78,1519,237,547,164,73,87,26,51,20,53,2016
188,Darrell Arthur,DEN,70,1516,96,217,71,25,45,16,10,3,22,2016
189,Jordan Hill,IND,73,1513,87,204,57,30,30,8,19,9,21,2016
190,Jerryd Bayless,MIL,52,1505,163,367,122,41,59,18,45,13,28,2016
191,Raul Neto,UTA,81,1499,174,398,124,50,91,19,14,31,19,2016
192,Kosta Koufos,SAC,78,1482,33,80,19,14,10,2,7,5,9,2016
193,Eric Gordon,NOP,45,1481,121,271,92,29,46,20,26,13,16,2016
194,Clint Capela,HOU,77,1471,47,108,33,14,24,5,4,3,11,2016
195,CJ Miles,IND,64,1464,63,150,39,24,27,4,8,9,15,2016
196,Austin Rivers,LAC,67,1463,99,245,52,47,24,10,18,21,26,2016
197,Tayshaun Prince,MIN,77,1461,74,165,57,17,23,17,17,2,15,2016
198,Maurice Harkless,POR,78,1457,67,161,40,27,25,6,9,8,19,2016
199,Andrew Bogut,GSW,70,1451,162,392,94,68,58,11,25,14,54,2016
200,JaMychal Green,MEM,78,1446,67,151,50,17,29,11,10,3,14,2016
201,Ben McLemore,SAC,68,1443,79,182,55,24,41,11,3,8,16,2016
202,Derrick Williams,NYK,80,1435,75,172,53,22,23,11,19,2,20,2016
203,Gerald Henderson,POR,72,1431,75,181,44,31,30,6,8,8,23,2016
204,Mario Hezonja,ORL,79,1413,109,237,90,19,46,18,26,8,11,2016
205,Willie Cauley-Stein,SAC,66,1411,37,85,26,11,19,3,4,0,11,2016
206,Ty Lawson,IND,66,1411,237,557,154,83,106,25,23,33,50,2016
207,David West,SAS,78,1404,143,326,103,40,72,15,16,18,22,2016
208,Kelly Olynyk,BOS,69,1395,105,243,72,33,46,6,20,12,21,2016
209,Boris Diaw,SAS,76,1386,176,410,118,58,63,26,29,14,44,2016
210,Trey Lyles,UTA,80,1382,59,154,23,36,14,3,6,12,24,2016
211,Mario Chalmers,MEM,61,1373,230,525,165,65,87,28,50,27,38,2016
212,Lance Stephenson,MEM,69,1372,133,299,100,33,67,11,22,11,22,2016
213,Myles Turner,IND,60,1367,41,98,25,16,13,6,6,3,13,2016
214,Trey Burke,UTA,64,1366,148,342,102,46,67,15,20,22,24,2016
215,Brandon Bass,LAL,66,1342,74,175,47,27,22,12,13,7,20,2016
216,Anthony Tolliver,DET,72,1341,52,124,32,20,16,13,3,6,14,2016
217,Meyers Leonard,POR,61,1332,92,226,50,42,25,8,17,11,31,2016
218,Timofey Mozgov,CLE,76,1326,33,79,20,13,8,3,9,4,9,2016
219,Richard Jefferson,CLE,74,1325,59,139,38,21,18,9,11,7,14,2016
220,Donald Sloan,BKN,61,1318,268,598,206,62,105,43,58,18,44,2016
221,Iman Shumpert,CLE,54,1316,92,231,45,47,32,8,5,9,38,2016
222,Lance Thomas,NYK,59,1313,53,119,40,13,12,13,15,1,12,2016
223,PJ Hairston,MEM,66,1313,38,90,24,14,12,3,9,2,12,2016
224,Tony Snell,CHI,64,1301,63,138,51,12,20,6,25,7,5,2016
225,Devin Harris,DAL,64,1280,118,268,86,32,54,11,21,11,21,2016
226,Rodney Stuckey,IND,58,1275,142,335,91,51,56,16,19,19,32,2016
227,Luc Mbah a Moute,LAC,74,1274,30,74,16,14,8,1,7,3,11,2016
228,Larry Nance Jr.,LAL,63,1266,44,105,27,17,11,5,11,5,12,2016
229,Jerian Grant,NYK,76,1265,177,418,113,64,58,29,26,24,40,2016
230,E'Twaun Moore,CHI,59,1263,99,225,72,27,38,12,22,7,20,2016
231,Toney Douglas,NOP,61,1262,157,363,108,49,63,18,27,16,33,2016
232,Jason Terry,HOU,72,1258,103,249,60,43,49,6,5,13,30,2016
233,Jon Leuer,PHX,67,1255,72,172,44,28,29,7,8,5,23,2016
234,Kyle Anderson,SAS,78,1245,123,277,92,31,58,11,23,10,21,2016
235,Joe Ingles,UTA,81,1241,96,219,69,27,54,9,6,9,18,2016
236,Aron Baynes,DET,81,1233,51,124,29,22,16,5,8,6,16,2016
237,Paul Pierce,LAC,68,1230,71,167,46,25,34,7,5,12,13,2016
238,Jeremy Lamb,CHA,66,1227,77,182,49,28,30,8,11,9,19,2016
239,Ronnie Price,PHX,62,1211,147,341,100,47,53,16,31,10,37,2016
240,Channing Frye,CLE,70,1199,71,164,49,22,27,15,7,4,18,2016
241,Norris Cole,NOP,45,1198,167,370,131,36,67,28,36,8,28,2016
242,Jason Smith,ORL,76,1181,62,144,42,20,21,4,17,5,15,2016
243,Omer Asik,NOP,68,1178,26,60,18,8,9,1,8,1,7,2016
244,D.J. Augustin,DEN,62,1178,198,445,149,49,94,22,33,22,27,2016
245,Jonas Jerebko,BOS,78,1177,62,142,44,18,24,6,14,2,16,2016
246,Noah Vonleh,POR,78,1174,30,77,13,17,7,0,6,6,11,2016
247,Blake Griffin,LAC,35,1170,170,411,99,71,45,12,42,22,49,2016
248,JaKarr Sampson,DEN,73,1160,46,115,23,23,14,5,4,6,17,2016
249,Mike Scott,ATL,75,1146,78,183,51,27,38,4,9,10,17,2016
250,Manu Ginobili,SAS,58,1134,177,396,135,42,76,27,32,14,28,2016
251,Archie Goodwin,PHX,57,1114,118,277,77,41,39,16,22,12,29,2016
252,Marcus Thornton,WAS,61,1108,84,192,60,24,53,6,1,9,15,2016
253,Aaron Brooks,CHI,69,1108,180,429,111,69,55,21,35,19,50,2016
254,Josh Richardson,MIA,52,1107,73,166,53,20,22,12,19,7,13,2016
255,Bobby Portis,CHI,62,1102,52,128,28,24,16,3,9,3,21,2016
256,Al Jefferson,CHA,47,1097,70,164,46,24,30,1,15,2,22,2016
257,Kevin Martin,SAS,55,1095,58,133,41,17,15,11,15,3,14,2016
258,Nene,WAS,57,1094,97,214,77,20,50,11,16,10,10,2016
259,O.J. Mayo,MIL,41,1090,118,254,100,18,61,23,16,2,16,2016
260,Leandro Barbosa,GSW,68,1079,82,191,55,27,35,7,13,10,17,2016
261,Nemanja Bjelica,MIN,60,1075,82,182,64,18,40,10,14,7,11,2016
262,TJ Warren,PHX,47,1070,44,105,27,17,11,6,10,3,14,2016
263,Eric Bledsoe,PHX,31,1059,190,447,123,67,80,14,29,19,48,2016
264,Shelvin Mack,UTA,52,1058,187,432,129,58,75,28,26,24,34,2016
265,Brandon Rush,GSW,72,1055,57,137,34,23,17,12,5,8,15,2016
266,Terrence Jones,HOU,50,1044,41,104,19,22,17,1,1,7,15,2016
267,Joffrey Lauvergne,DEN,59,1041,56,134,34,22,23,3,8,4,18,2016
268,Jameer Nelson,DEN,39,1036,190,437,133,57,68,29,36,16,41,2016
269,Spencer Hawes,CHA,57,1035,109,253,74,35,44,7,23,8,27,2016
270,Nick Young,LAL,54,1033,34,78,24,10,16,2,6,1,9,2016
271,Jarrett Jack,BKN,32,1027,236,509,199,37,88,71,40,13,24,2016
272,Vince Carter,MEM,60,1005,56,127,41,15,23,9,9,7,8,2016
273,Rashad Vaughn,MIL,70,1001,39,86,31,8,18,5,8,3,5,2016
274,Dwight Powell,DAL,69,992,44,108,24,20,13,4,7,1,19,2016
275,Steve Blake,DET,58,986,200,477,123,77,74,30,19,24,53,2016
276,Markel Brown,BKN,62,982,91,202,71,20,45,11,15,7,13,2016
277,Kyle Singler,OKC,68,977,24,55,17,7,13,1,3,3,4,2016
278,John Henson,MIL,57,959,54,121,41,13,26,7,8,3,10,2016
279,Chase Budinger,PHX,66,930,64,144,48,16,32,6,10,3,13,2016
280,Anthony Morrow,OKC,68,926,24,57,15,9,13,0,2,3,6,2016
281,James Johnson,TOR,57,926,67,156,45,22,32,7,6,12,10,2016
282,Thomas Robinson,BKN,71,916,46,102,36,10,25,5,6,4,6,2016
283,Sasha Vujacic,NYK,61,908,84,196,56,28,23,12,21,12,16,2016
284,David Lee,DAL,55,903,84,203,49,35,23,7,19,15,20,2016
285,Josh Smith,HOU,55,880,90,208,62,28,43,9,10,18,10,2016
286,Quincy Acy,SAC,59,876,27,62,19,8,9,4,6,3,5,2016
287,Miles Plumlee,MIL,61,870,16,34,14,2,4,4,6,1,1,2016
288,Marcelo Huertas,LAL,53,869,182,415,131,51,87,20,24,14,37,2016
289,Brandon Jennings,ORL,48,868,170,392,118,52,68,18,32,14,38,2016
290,Solomon Hill,IND,59,866,57,130,41,16,23,6,12,8,8,2016
291,Tim Hardaway Jr.,ATL,51,864,51,121,32,19,17,4,11,5,14,2016
292,Tyler Johnson,MIA,36,863,79,182,55,24,26,12,17,10,14,2016
293,Alexis Ajinca,NOP,59,861,31,75,18,13,12,2,4,1,12,2016
294,Johnny O'Bryant III,MIL,66,857,32,73,23,9,10,6,7,2,7,2016
295,Chris Johnson,UTA,70,857,45,103,32,13,23,4,5,6,7,2016
296,Luke Babbitt,NOP,47,845,53,124,35,18,20,5,10,3,15,2016
297,Kris Humphries,ATL,53,835,36,82,26,10,13,3,10,4,6,2016
298,Marreese Speights,GSW,72,832,61,144,39,22,21,6,12,5,17,2016
299,Andrew Nicholson,ORL,56,823,25,65,10,15,3,3,4,7,8,2016
300,Pablo Prigioni,LAC,59,823,130,308,82,48,47,13,22,21,27,2016
301,Jonathon Simmons,SAS,55,813,58,142,32,26,14,7,11,6,20,2016
302,Gary Neal,WAS,40,807,47,112,29,18,12,5,12,6,12,2016
303,Cole Aldrich,LAC,60,800,50,125,25,25,11,7,7,11,14,2016
304,Alec Burks,UTA,31,797,63,146,43,20,32,2,9,9,11,2016
305,DeMarre Carroll,TOR,26,786,27,69,12,15,8,1,3,6,9,2016
306,Justin Holiday,CHI,53,772,56,126,42,14,26,7,9,3,11,2016
307,Festus Ezeli,GSW,46,770,32,83,13,19,3,1,9,7,12,2016
308,Tyreke Evans,NOP,25,765,164,390,102,62,53,10,39,15,47,2016
309,Kyle O'Quinn,NYK,65,764,72,156,60,12,36,5,19,2,10,2016
310,Amar'e Stoudemire,MIA,52,762,27,60,21,6,7,6,8,5,1,2016
311,Mo Williams,CLE,41,748,98,223,71,27,52,7,12,8,19,2016
312,Tim Frazier,NOP,51,741,162,372,114,48,66,20,28,13,35,2016
313,Norman Powell,TOR,49,725,47,117,24,23,12,6,6,9,14,2016
314,James Anderson,SAC,51,721,41,98,25,16,15,5,5,11,5,2016
315,Tyler Zeller,BOS,60,710,29,64,23,6,11,1,11,2,4,2016
316,Beno Udrih,MIA,44,708,116,264,84,32,36,18,30,8,24,2016
317,Dewayne Dedmon,ORL,58,705,13,31,8,5,5,0,3,0,5,2016
318,Mike Dunleavy,CHI,31,703,39,89,28,11,14,4,10,5,6,2016
319,Richaun Holmes,PHI,51,702,33,78,21,12,15,3,3,4,8,2016
320,Nick Collison,OKC,59,699,52,112,44,8,26,11,7,1,7,2016
321,Cameron Payne,OKC,57,698,108,251,73,35,40,13,20,10,25,2016
322,Seth Curry,SAC,44,692,67,153,48,19,28,13,7,6,13,2016
323,Kelly Oubre Jr.,WAS,63,671,13,29,10,3,7,2,1,1,2,2016
324,Charlie Villanueva,DAL,62,665,24,52,20,4,15,1,4,2,2,2016
325,Jeff Withey,UTA,51,658,20,53,7,13,3,0,4,2,11,2016
326,C.J. Watson,ORL,33,656,88,202,62,26,24,6,32,9,17,2016
327,Tyler Ennis,MIL,46,654,95,212,73,22,43,13,17,8,14,2016
328,Justin Anderson,DAL,55,647,29,70,17,12,11,1,5,2,10,2016
329,Joakim Noah,CHI,29,635,110,257,73,37,38,12,23,4,33,2016
330,Andrea Bargnani,BKN,46,634,18,43,11,7,5,1,5,3,4,2016
331,Kirk Hinrich,ATL,46,631,73,171,48,25,21,11,16,6,19,2016
332,Sean Kilpatrick,BKN,31,616,29,70,17,12,11,1,5,3,9,2016
333,Rondae Hollis-Jefferson,BKN,29,615,43,93,36,7,18,8,10,4,3,2016
334,Shabazz Napier,ORL,55,600,97,231,60,37,26,8,26,10,27,2016
335,Anthony Brown,LAL,29,599,19,45,12,7,5,2,5,3,4,2016
336,Josh McRoberts,MIA,42,595,81,179,64,17,38,8,18,3,14,2016
337,Metta World Peace,LAL,35,590,27,60,21,6,9,4,8,2,4,2016
338,Tiago Splitter,ATL,36,580,30,67,23,7,14,3,6,2,5,2016
339,Ian Clark,GSW,66,578,64,155,37,27,15,7,15,2,25,2016
340,Tyus Jones,MIN,37,573,108,243,81,27,56,10,15,15,12,2016
341,Carl Landry,PHI,36,569,32,81,15,17,8,1,6,4,13,2016
342,Mike Muscala,ATL,60,565,34,79,23,11,15,5,3,5,6,2016
343,Kevin Garnett,MIN,38,556,62,135,51,11,19,9,23,1,10,2016
344,Jusuf Nurkic,DEN,32,547,40,92,28,12,20,3,5,4,8,2016
345,Donatas Motiejunas,HOU,37,547,41,96,27,14,23,1,3,4,10,2016
346,Kendrick Perkins,NOP,37,542,31,70,23,8,12,4,7,4,4,2016
347,Kevin Seraphin,NYK,48,526,47,100,41,6,18,9,14,2,4,2016
348,Glenn Robinson III,IND,45,508,26,57,21,5,12,2,7,3,2,2016
349,Boban Marjanovic,SAS,54,508,21,47,16,5,9,1,6,2,3,2016
350,Sonny Weems,PHI,43,498,49,114,33,16,24,5,4,2,14,2016
351,Tarik Black,LAL,39,496,16,39,9,7,4,1,4,0,7,2016
352,Anderson Varejao,GSW,53,496,35,86,19,16,11,3,5,3,13,2016
353,Adreian Payne,MIN,52,486,29,65,22,7,10,4,8,0,7,2016
354,John Jenkins,PHX,43,480,35,83,22,13,10,7,5,4,9,2016
355,Troy Daniels,CHA,43,476,21,48,15,6,6,4,5,3,3,2016
356,Ray McCallum,MEM,41,474,60,132,48,12,10,10,28,5,7,2016
357,Jason Thompson,TOR,47,471,29,66,21,8,11,5,5,3,5,2016
358,Brian Roberts,POR,51,470,54,129,33,21,13,9,11,8,13,2016
359,Ryan Kelly,LAL,36,470,20,47,13,7,9,2,2,1,6,2016
360,James Jones,CLE,48,463,14,34,8,6,5,1,2,3,3,2016
361,Andre Miller,SAS,39,461,87,198,63,24,38,3,22,3,21,2016
362,Greivis Vasquez,MIL,23,460,91,206,67,24,43,13,11,7,17,2016
363,Ryan Hollins,MEM,37,460,10,22,8,2,6,0,2,1,1,2016
364,JJ Hickson,WAS,35,436,23,54,15,8,7,2,6,3,5,2016
365,Rasual Butler,SAS,46,431,24,58,14,10,9,1,4,5,5,2016
366,Reggie Bullock,DET,37,429,27,64,17,10,9,4,4,4,6,2016
367,Willie Reed,BKN,39,426,10,23,7,3,5,2,0,1,2,2016
368,Jared Cunningham,MIL,44,410,20,46,14,6,7,3,4,1,5,2016
369,Chris Andersen,MEM,27,403,12,28,8,4,6,0,2,1,3,2016
370,Kendall Marshall,PHI,30,400,73,169,50,23,32,9,9,8,15,2016
371,Sergey Karasev,BKN,40,399,35,81,24,11,14,5,5,6,5,2016
372,Salah Mejri,DAL,34,397,10,24,6,4,3,0,3,1,3,2016
373,Lamar Patterson,ATL,35,395,39,91,26,13,18,6,2,3,10,2016
374,Joe Young,IND,41,383,65,141,54,11,21,10,23,5,6,2016
375,Darrun Hilliard,DET,38,383,27,66,15,12,5,7,3,3,9,2016
376,Jarell Martin,MEM,27,380,15,35,10,5,6,2,2,1,4,2016
377,Montrezl Harrell,HOU,39,379,17,43,8,9,8,0,0,2,7,2016
378,Mike Miller,DEN,46,373,40,93,27,13,21,4,2,1,12,2016
379,JaVale McGee,DAL,34,370,3,6,3,0,1,0,2,0,0,2016
380,Michael Beasley,HOU,20,363,16,36,12,4,7,4,1,2,2,2016
381,Chris McCullough,BKN,24,362,9,20,7,2,3,0,4,2,0,2016
382,Tyler Hansbrough,CHA,44,343,8,20,4,4,3,1,0,1,3,2016
383,James Ennis III,NOP,22,328,21,42,21,0,14,4,3,0,0,2016
384,Cristiano Felicio,CHI,31,321,26,64,14,12,11,1,2,2,10,2016
385,Robert Sacre,LAL,25,320,14,34,8,6,2,2,4,1,5,2016
386,RJ Hunter,BOS,36,314,13,27,12,1,7,0,5,0,1,2016
387,Terry Rozier,BOS,39,311,37,92,19,18,10,2,7,3,15,2016
388,Axel Toupane,DEN,21,305,15,35,10,5,3,5,2,4,1,2016
389,Drew Gooden,WAS,30,305,13,31,8,5,2,3,3,1,4,2016
390,Jordan Hamilton,NOP,11,304,25,59,16,9,10,1,5,2,7,2016
391,Kostas Papanikolaou,DEN,26,294,16,38,10,6,7,1,2,1,5,2016
392,Jordan Farmar,MEM,12,291,37,83,28,9,16,4,8,4,5,2016
393,Phil Pressey,PHX,23,283,75,184,41,34,29,6,6,6,28,2016
394,Bryce Dejean-Jones,NOP,14,279,15,34,11,4,8,2,1,0,4,2016
395,Damjan Rudez,MIN,33,277,11,24,9,2,4,4,1,2,0,2016
396,Henry Sims,BKN,14,263,9,19,8,1,5,2,1,1,0,2016
397,James Michael McAdoo,GSW,41,262,17,41,10,7,4,4,2,0,7,2016
398,Udonis Haslem,MIA,37,260,14,31,11,3,6,2,3,0,3,2016
399,Jeremy Evans,DAL,30,251,2,4,2,0,1,0,1,0,0,2016
400,Devyn Marble,ORL,28,249,12,30,6,6,4,1,1,3,3,2016
401,Xavier Munford,MEM,14,244,22,47,19,3,13,0,6,0,3,2016
402,KJ McDaniels,HOU,37,235,10,22,8,2,4,1,3,1,1,2016
403,Delon Wright,TOR,27,229,31,75,18,13,10,3,5,6,7,2016
404,Elton Brand,PHI,17,225,18,47,7,11,5,0,2,3,8,2016
405,Lucas Nogueira,TOR,29,225,7,16,5,2,4,1,0,0,2,2016
406,DeJuan Blair,WAS,29,218,11,27,6,5,4,1,1,0,5,2016
407,Brandan Wright,MEM,12,212,6,14,4,2,2,0,2,1,1,2016
408,Matt Bonner,SAS,30,206,9,22,5,4,4,1,0,1,3,2016
409,Michael Kidd-Gilchrist,CHA,7,205,9,24,3,6,2,0,1,2,4,2016
410,Lou Amundson,NYK,29,204,12,25,11,1,3,1,7,1,0,2016
411,James Young,BOS,29,199,9,23,4,5,3,0,1,1,4,2016
412,Jordan McRae,CLE,22,196,25,59,16,9,13,3,0,6,3,2016
413,Alan Anderson,WAS,13,192,14,31,11,3,8,2,1,2,1,2016
414,Greg Smith,MIN,18,192,6,13,5,1,1,0,4,0,1,2016
415,Caron Butler,SAC,17,176,10,24,6,4,4,1,1,3,1,2016
416,Elijah Millsap,UTA,20,173,19,47,10,9,4,3,3,4,5,2016
417,Briante Weber,MIA,7,169,21,48,15,6,12,1,2,1,5,2016
418,CJ Wilcox,LAC,23,167,10,22,8,2,2,1,5,0,2,2016
419,Spencer Dinwiddie,DET,12,159,22,50,16,6,8,5,3,1,5,2016
420,Damien Inglis,MIL,20,156,10,22,8,2,5,1,2,1,1,2016
421,Nikola Pekovic,MIN,12,156,11,27,6,5,1,2,3,2,3,2016
422,Chris Copeland,MIL,24,156,11,26,7,4,5,1,1,1,3,2016
423,Cleanthony Early,NYK,17,154,6,14,4,2,3,0,1,0,2,2016
424,Jarell Eddie,WAS,26,147,5,11,4,1,4,0,0,0,1,2016
425,Christian Wood,PHI,17,145,3,7,2,1,2,0,0,0,1,2016
426,Tony Wroten,PHI,8,144,20,46,14,6,11,2,1,4,2,2016
427,Pat Connaughton,POR,34,143,10,25,5,5,3,0,2,1,4,2016
428,Chris Kaman,POR,16,112,11,25,8,3,4,0,4,1,2,2016
429,Jeff Ayres,LAC,17,107,5,11,4,1,4,0,0,0,1,2016
430,Cameron Bairstow,CHI,18,103,6,13,5,1,5,0,0,1,0,2016
431,Orlando Johnson,NOP,7,102,2,4,2,0,1,1,0,0,0,2016
432,Joel Anthony,DET,19,96,1,2,1,0,1,0,0,0,0,2016
433,Sasha Kaun,CLE,25,95,3,7,2,1,1,0,1,0,1,2016
434,Aaron Harrison,CHA,21,93,2,4,2,0,1,1,0,0,0,2016
435,Anthony Bennett,TOR,19,84,0,0,0,0,0,0,0,0,0,2016
436,Tibor Pleiss,UTA,12,82,2,5,1,1,1,0,0,0,1,2016
437,Edy Tavares,ATL,11,73,3,7,2,1,2,0,0,0,1,2016
438,Mitch McGary,OKC,20,72,3,7,2,1,0,0,2,1,0,2016
439,Alex Stepheson,MEM,8,72,2,5,1,1,1,0,0,0,1,2016
440,Alan Williams,PHX,10,68,5,12,3,2,3,0,0,0,2,2016
441,Russ Smith,MEM,15,66,11,26,7,4,3,2,2,2,2,2016
442,Jorge Gutierrez,CHA,12,63,17,42,9,8,2,2,5,3,5,2016
443,Lorenzo Brown,PHX,8,61,11,25,8,3,6,1,1,1,2,2016
444,Jordan Mickey,BOS,16,57,1,3,0,1,0,0,0,0,1,2016
445,Josh Huestis,OKC,5,55,0,0,0,0,0,0,0,0,0,2016
446,Cory Jefferson,PHX,7,50,0,0,0,0,0,0,0,0,0,2016
447,Andrew Goudelock,HOU,8,50,4,9,3,1,3,0,0,0,1,2016
448,Eric Moreland,SAC,8,48,1,3,0,1,0,0,0,0,1,2016
449,Elliot Williams,MEM,5,45,4,9,3,1,1,1,1,0,1,2016
450,Steve Novak,MIL,10,44,0,0,0,0,0,0,0,0,0,2016
451,Jodie Meeks,DET,3,43,3,7,2,1,2,0,0,1,0,2016
452,Bruno Caboclo,TOR,6,43,1,3,0,1,0,0,0,0,1,2016
453,Dahntay Jones,CLE,1,42,2,5,1,1,1,0,0,0,1,2016
454,Erick Green,UTA,9,42,3,9,0,3,0,0,0,1,2,2016
455,Luis Montero,POR,12,42,1,2,1,0,1,0,0,0,0,2016
456,Shayne Whittington,IND,7,41,3,7,2,1,1,1,0,0,1,2016
457,Bryce Cotton,MEM,8,39,3,7,2,1,0,0,2,0,1,2016
458,Cliff Alexander,POR,8,36,0,0,0,0,0,0,0,0,0,2016
459,Justin Harper,DET,5,35,0,0,0,0,0,0,0,0,0,2016
460,Branden Dawson,LAC,6,29,0,0,0,0,0,0,0,0,0,2016
461,Keith Appling,ORL,5,27,1,3,0,1,0,0,0,0,1,2016
462,Duje Dukan,SAC,1,24,1,2,1,0,1,0,0,0,0,2016
463,Chuck Hayes,HOU,2,24,2,4,2,0,2,0,0,0,0,2016
464,Nate Robinson,NOP,2,23,4,9,3,1,0,2,1,0,1,2016
465,Kevon Looney,GSW,5,21,0,0,0,0,0,0,0,0,0,2016
466,Nazr Mohammed,OKC,5,19,0,0,0,0,0,0,0,0,0,2016
467,Jarnell Stokes,MIA,7,19,1,3,0,1,0,0,0,0,1,2016
468,Jimmer Fredette,NYK,6,18,1,3,0,1,0,0,0,0,1,2016
469,Joe Harris,CLE,5,15,2,5,1,1,0,1,0,0,1,2016
470,Jordan Adams,MEM,2,15,3,6,3,0,2,0,1,0,0,2016
471,JJ O'Brien,UTA,2,6,0,0,0,0,0,0,0,0,0,2016
472,Thanasis Antetokounmpo,NYK,2,6,0,0,0,0,0,0,0,0,0,2016
473,Sam Dekker,HOU,3,6,0,0,0,0,0,0,0,0,0,2016
474,Rakeem Christmas,IND,1,6,0,0,0,0,0,0,0,0,0,2016
475,Coty Clarke,BOS,3,6,0,0,0,0,0,0,0,0,0,2016
0,James Harden,HOU,81,2981,565,1380,315,250,246,52,17,131,119,2015
1,Andrew Wiggins,MIN,82,2969,170,380,130,40,72,31,27,11,29,2015
2,Trevor Ariza,HOU,82,2930,209,510,117,92,80,27,10,44,48,2015
3,Damian Lillard,POR,82,2925,507,1176,345,162,171,47,127,45,117,2015
4,Chris Paul,LAC,82,2858,838,1908,606,232,328,58,220,76,156,2015
5,John Wall,WAS,79,2837,792,1792,584,208,339,67,178,72,136,2015
6,DeAndre Jordan,LAC,82,2821,61,144,39,22,19,3,17,4,18,2015
7,Eric Bledsoe,PHX,81,2800,493,1143,336,157,194,60,82,50,107,2015
8,Joe Johnson,BKN,80,2791,292,673,203,89,100,42,61,40,49,2015
9,Kyrie Irving,CLE,75,2730,389,907,260,129,185,37,38,44,85,2015
10,Monta Ellis,DAL,80,2699,329,790,197,132,140,14,43,29,103,2015
11,Tyreke Evans,NOP,79,2690,521,1226,337,184,195,45,97,56,128,2015
12,Marc Gasol,MEM,81,2687,307,687,234,73,155,33,46,28,45,2015
13,Pau Gasol,CHI,78,2681,210,505,125,85,85,22,18,21,64,2015
14,Ben McLemore,SAC,82,2670,140,302,118,22,72,13,33,11,11,2015
15,Ty Lawson,DEN,75,2666,720,1665,495,225,287,95,113,65,160,2015
16,Goran Dragic,MIA,78,2640,350,812,238,112,146,36,56,43,69,2015
17,Gordon Hayward,UTA,76,2618,313,743,196,117,133,26,37,43,74,2015
18,Stephen Curry,GSW,80,2613,619,1422,435,184,281,84,70,69,115,2015
19,Kentavious Caldwell-Pope,DET,82,2587,109,253,74,35,46,14,14,10,25,2015
20,Markieff Morris,PHX,82,2581,192,447,129,63,90,21,18,30,33,2015
21,Victor Oladipo,ORL,72,2573,295,673,212,83,98,44,70,31,52,2015
22,Giannis Antetokounmpo,MIL,81,2541,207,487,134,73,81,23,30,30,43,2015
23,Kevin Love,CLE,75,2532,168,366,138,30,98,26,14,9,21,2015
24,Nikola Vucevic,ORL,74,2529,147,357,84,63,60,13,11,19,44,2015
25,Jimmy Butler,CHI,65,2514,212,492,144,68,67,23,54,25,43,2015
26,LaMarcus Aldridge,POR,71,2512,124,308,64,60,40,8,16,15,45,2015
27,Andre Drummond,DET,82,2502,55,127,38,17,29,6,3,4,13,2015
28,Arron Afflalo,POR,78,2502,129,303,84,45,53,17,14,15,30,2015
29,LeBron James,CLE,69,2494,511,1230,303,208,207,48,48,82,126,2015
30,Draymond Green,GSW,79,2490,291,698,175,116,109,25,41,40,76,2015
31,Elfrid Payton,ORL,82,2489,533,1202,397,136,202,73,122,47,89,2015
32,Wilson Chandler,DEN,78,2471,134,322,80,54,50,13,17,16,38,2015
33,Anthony Davis,NOP,68,2455,149,354,93,56,66,9,18,17,39,2015
34,Jeff Green,MEM,78,2455,134,303,99,35,44,27,28,15,20,2015
35,Klay Thompson,GSW,77,2455,222,505,161,61,108,29,24,20,41,2015
36,Marcin Gortat,WAS,82,2453,97,230,61,36,23,6,32,14,22,2015
37,Thaddeus Young,BKN,76,2434,173,385,134,39,78,23,33,15,24,2015
38,Avery Bradley,BOS,77,2428,135,293,112,23,55,23,34,7,16,2015
39,Luol Deng,MIA,72,2421,139,321,96,43,52,24,20,15,28,2015
40,Kyle Korver,ATL,75,2418,196,426,162,34,103,25,34,11,23,2015
41,Kyle Lowry,TOR,70,2415,473,1080,339,134,200,81,58,47,87,2015
42,JJ Redick,LAC,78,2409,137,317,94,43,66,11,17,14,29,2015
43,Rudy Gay,SAC,68,2408,250,562,188,62,116,26,46,32,30,2015
44,Paul Millsap,ATL,73,2390,223,529,140,83,72,22,46,36,47,2015
45,PJ Tucker,PHX,78,2383,122,280,86,36,52,16,18,10,26,2015
46,Solomon Hill,IND,82,2381,184,427,125,59,45,14,66,19,40,2015
47,Nicolas Batum,POR,71,2380,341,772,251,90,134,41,76,28,62,2015
48,Khris Middleton,MIL,79,2378,182,403,143,39,88,20,35,16,23,2015
49,Tobias Harris,ORL,68,2369,124,280,92,32,54,16,22,11,21,2015
50,Mario Chalmers,MIA,80,2368,307,711,210,97,131,32,47,41,56,2015
51,Blake Griffin,LAC,67,2356,354,852,210,144,116,31,63,55,89,2015
52,Courtney Lee,MEM,77,2354,151,336,117,34,45,30,42,9,25,2015
53,Harrison Barnes,GSW,82,2318,116,277,71,45,38,14,19,9,36,2015
54,Al Horford,ATL,76,2318,244,604,128,116,81,22,25,53,63,2015
55,Gerald Henderson,CHA,80,2315,206,451,167,39,65,40,62,10,29,2015
56,Danny Green,SAS,81,2311,158,352,122,36,69,23,30,14,22,2015
57,Nerlens Noel,PHI,75,2311,128,303,81,47,55,9,17,7,40,2015
58,Zach Randolph,MEM,71,2304,153,351,108,45,58,31,19,6,39,2015
59,Russell Westbrook,OKC,67,2302,574,1295,427,147,259,81,87,54,93,2015
60,Josh Smith,HOU,83,2301,277,673,158,119,136,4,18,65,54,2015
61,Trey Burke,UTA,76,2288,328,739,245,83,156,31,58,26,57,2015
62,Tyson Chandler,DAL,75,2286,84,181,71,13,24,9,38,3,10,2015
63,Dirk Nowitzki,DAL,77,2282,143,339,90,53,67,12,11,21,32,2015
64,Derrick Favors,UTA,74,2280,112,273,63,49,35,6,22,16,33,2015
65,Matt Barnes,LAC,76,2271,114,263,79,35,50,8,21,9,26,2015
66,Reggie Jackson,DET,77,2268,462,1055,331,131,190,63,78,46,85,2015
67,Evan Turner,BOS,82,2260,449,989,358,91,205,54,99,19,72,2015
68,Wesley Johnson,LAL,76,2245,124,273,99,25,50,18,31,6,19,2015
69,Jarrett Jack,BKN,80,2241,373,840,279,94,156,62,61,31,63,2015
70,Jeff Teague,ATL,73,2228,513,1184,355,158,200,40,115,46,112,2015
71,Tim Duncan,SAS,77,2227,230,513,177,53,110,36,31,19,34,2015
72,Mike Conley,MEM,70,2225,375,804,321,54,162,63,96,25,29,2015
73,Dion Waiters,OKC,80,2208,163,388,101,62,58,20,23,25,37,2015
74,Tristan Thompson,CLE,82,2194,39,105,12,27,5,2,5,4,23,2015
75,Gorgui Dieng,MIN,73,2193,146,323,115,31,61,12,42,5,26,2015
76,DeMarre Carroll,ATL,70,2189,118,285,69,49,37,10,22,12,37,2015
77,Chandler Parsons,DAL,66,2186,161,374,109,52,71,4,34,20,32,2015
78,Rudy Gobert,UTA,82,2158,109,262,65,44,38,6,21,11,33,2015
79,Patrick Patterson,TOR,81,2156,155,368,97,58,67,15,15,23,35,2015
80,Michael Carter-Williams,MIL,66,2150,442,1019,307,135,170,40,97,22,113,2015
81,Greg Monroe,DET,69,2137,142,336,90,52,64,10,16,14,38,2015
82,Enes Kanter,OKC,75,2136,55,132,33,22,16,3,14,9,13,2015
83,Kemba Walker,CHA,62,2119,318,706,248,70,117,47,84,19,51,2015
84,Serge Ibaka,OKC,64,2116,55,133,32,23,23,6,3,7,16,2015
85,Deron Williams,BKN,68,2114,448,1009,335,113,167,103,65,34,79,2015
86,Bradley Beal,WAS,63,2108,194,428,154,40,74,25,55,13,27,2015
87,Brook Lopez,BKN,72,2101,50,121,29,21,12,10,7,8,13,2015
88,DeMar DeRozan,TOR,60,2100,210,523,107,103,70,25,12,36,67,2015
89,Jonas Valanciunas,TOR,80,2096,39,95,22,17,16,2,4,6,11,2015
90,Terrence Ross,TOR,82,2092,86,200,58,28,32,15,11,10,18,2015
91,Corey Brewer,HOU,80,2087,173,396,123,50,81,29,13,14,36,2015
92,Kenneth Faried,DEN,75,2086,89,204,63,26,44,8,11,3,23,2015
93,JR Smith,CLE,70,2079,195,456,129,66,73,22,34,21,45,2015
94,Andre Iguodala,GSW,77,2068,228,527,157,71,95,28,34,25,46,2015
95,Joakim Noah,CHI,67,2049,312,709,227,85,134,27,66,10,75,2015
96,Timofey Mozgov,CLE,81,2046,55,131,34,21,16,9,9,3,18,2015
97,Marcus Morris,PHX,81,2045,133,305,94,39,51,17,26,25,14,2015
98,Donatas Motiejunas,HOU,71,2037,130,316,74,56,53,14,7,18,38,2015
99,Brandon Knight,PHX,63,2035,330,728,262,68,135,34,93,30,38,2015
100,Marvin Williams,CHA,78,2035,100,227,73,27,36,13,24,5,22,2015
101,Kawhi Leonard,SAS,64,2033,161,369,114,47,67,27,20,19,28,2015
102,Wesley Matthews,POR,60,2024,139,332,85,54,32,22,31,14,40,2015
103,Rajon Rondo,DAL,68,2019,538,1240,374,164,196,54,124,54,110,2015
104,Eric Gordon,NOP,61,2018,229,505,182,47,101,28,53,21,26,2015
105,Lou Williams,TOR,80,2015,164,390,102,62,56,27,19,27,35,2015
106,DeMarcus Cousins,SAC,59,2013,210,509,121,89,85,21,15,30,59,2015
107,Al Jefferson,CHA,65,1992,113,255,84,29,52,10,22,2,27,2015
108,Jason Thompson,SAC,81,1991,85,187,68,17,45,12,11,4,13,2015
109,Greivis Vasquez,TOR,82,1991,302,685,221,81,127,51,43,29,52,2015
110,Boris Diaw,SAS,81,1984,233,538,161,72,85,41,35,30,42,2015
111,Omer Asik,NOP,76,1982,72,168,48,24,23,8,17,7,17,2015
112,Mo Williams,CHA,68,1980,424,915,357,67,195,60,102,31,36,2015
113,Amir Johnson,TOR,75,1979,117,259,92,25,51,16,25,7,18,2015
114,Dwyane Wade,MIA,62,1971,299,689,208,91,143,24,41,38,53,2015
115,D.J. Augustin,OKC,82,1964,353,827,232,121,137,45,50,37,84,2015
116,Robert Covington,PHI,70,1956,105,244,71,34,43,10,18,10,24,2015
117,Tony Parker,SAS,68,1953,335,788,217,118,117,63,37,46,72,2015
118,Brandon Bass,BOS,82,1929,104,254,58,46,18,16,24,13,33,2015
119,Roy Hibbert,IND,76,1927,84,190,62,22,45,6,11,7,15,2015
120,Luc Mbah a Moute,PHI,67,1916,106,257,61,45,40,9,12,10,35,2015
121,Paul Pierce,WAS,73,1914,144,309,123,21,72,20,31,3,18,2015
122,Jeremy Lin,LAL,74,1907,339,733,284,55,165,42,77,20,35,2015
123,Zach LaVine,MIN,77,1902,276,592,236,40,99,47,90,9,31,2015
124,David West,IND,66,1896,223,510,159,64,83,47,29,28,36,2015
125,Aaron Brooks,CHI,82,1885,261,603,180,81,94,34,52,33,48,2015
126,Jordan Hill,LAL,70,1874,103,234,75,28,33,10,32,4,24,2015
127,Rodney Stuckey,IND,71,1873,219,506,151,68,56,20,75,31,37,2015
128,Channing Frye,ORL,75,1870,94,210,72,22,44,19,9,9,13,2015
129,Shane Larkin,NYK,76,1865,226,518,160,66,61,18,81,14,52,2015
130,Bojan Bogdanovic,BKN,78,1854,68,159,45,23,23,9,13,8,15,2015
131,CJ Miles,IND,70,1841,75,170,55,20,28,8,19,6,14,2015
132,Ed Davis,LAL,79,1840,94,218,64,30,31,5,28,6,24,2015
133,Mike Dunleavy,CHI,63,1838,114,254,88,26,49,9,30,5,21,2015
134,Norris Cole,NOP,75,1831,255,590,175,80,79,30,66,23,57,2015
135,Dante Exum,UTA,82,1817,198,459,135,63,104,13,18,21,42,2015
136,Marcus Smart,BOS,67,1808,208,471,153,55,85,16,52,12,43,2015
137,Anthony Morrow,OKC,74,1806,60,139,41,19,27,9,5,8,11,2015
138,Quincy Pondexter,NOP,75,1793,94,204,78,16,50,14,14,5,11,2015
139,Jason Smith,NYK,82,1785,140,326,94,46,39,21,34,8,38,2015
140,Hollis Thompson,PHI,71,1776,85,196,59,26,28,12,19,8,18,2015
141,Steven Adams,OKC,70,1771,66,159,39,27,14,7,18,7,20,2015
142,Alan Anderson,BKN,74,1744,83,191,58,25,35,10,13,12,13,2015
143,Kyle Singler,OKC,80,1744,85,198,57,28,29,17,11,11,17,2015
144,Mason Plumlee,BKN,82,1743,74,169,53,21,31,9,13,8,13,2015
145,Tyler Zeller,BOS,82,1731,113,254,85,28,27,5,53,3,25,2015
146,Zaza Pachulia,MIL,73,1730,178,391,143,35,86,15,42,10,25,2015
147,Patrick Beverley,HOU,56,1727,192,459,117,75,76,36,5,21,54,2015
148,Isaiah Thomas,BOS,67,1726,284,696,156,128,86,20,50,41,87,2015
149,Jerryd Bayless,MIL,77,1717,233,534,165,68,79,24,62,22,46,2015
150,Jared Dudley,MIL,72,1717,130,303,87,43,51,17,19,21,22,2015
151,Jamal Crawford,LAC,64,1703,158,368,106,52,73,14,19,17,35,2015
152,O.J. Mayo,MIL,71,1697,197,429,162,35,112,20,30,16,19,2015
153,Nene,WAS,67,1694,123,272,97,26,56,15,26,9,17,2015
154,Taj Gibson,CHI,62,1692,71,172,41,30,20,7,14,1,29,2015
155,Carlos Boozer,LAL,71,1692,95,210,75,20,33,15,27,4,16,2015
156,Devin Harris,DAL,76,1685,237,551,160,77,110,16,34,27,50,2015
157,Tim Hardaway Jr.,NYK,70,1681,127,277,104,23,46,12,46,6,17,2015
158,Ryan Anderson,NOP,61,1675,55,126,39,16,21,10,8,4,12,2015
159,Wayne Ellington,LAL,65,1675,105,233,82,23,44,16,22,7,16,2015
160,Joe Ingles,UTA,79,1672,182,415,131,51,102,11,18,28,23,2015
161,Evan Fournier,ORL,58,1661,120,280,80,40,40,19,21,15,25,2015
162,Luis Scola,IND,81,1659,105,248,67,38,37,12,18,9,29,2015
163,Nikola Mirotic,CHI,82,1654,97,225,66,31,43,11,12,9,22,2015
164,Dante Cunningham,NOP,66,1652,50,113,37,13,21,5,11,2,11,2015
165,Tony Allen,MEM,63,1648,86,186,72,14,47,14,11,7,7,2015
166,Jae Crowder,BOS,82,1647,94,223,59,35,38,5,16,8,27,2015
167,Jason Terry,HOU,77,1641,147,345,96,51,71,17,8,19,32,2015
168,Robin Lopez,POR,59,1638,55,134,31,24,10,4,17,4,20,2015
169,Caron Butler,DET,78,1623,79,184,53,26,30,16,7,12,14,2015
170,Kirk Hinrich,CHI,66,1610,148,335,109,39,50,24,35,12,27,2015
171,Michael Kidd-Gilchrist,CHA,55,1587,77,168,63,14,23,13,27,4,10,2015
172,Manu Ginobili,SAS,70,1587,293,675,204,89,140,42,22,31,58,2015
173,Andrew Bogut,GSW,67,1583,180,425,115,65,66,19,30,17,48,2015
174,Lance Stephenson,CHA,61,1573,240,539,181,59,77,44,60,19,40,2015
175,Jared Sullinger,BOS,58,1566,134,321,81,53,44,4,33,24,29,2015
176,Darren Collison,SAC,45,1565,252,545,211,41,102,40,69,10,31,2015
177,Trevor Booker,UTA,79,1564,83,204,45,38,31,4,10,10,28,2015
178,Austin Rivers,LAC,76,1563,155,366,99,56,56,10,33,15,41,2015
179,Chris Bosh,MIA,44,1556,95,213,72,23,35,12,25,8,15,2015
180,Iman Shumpert,CLE,62,1545,135,326,79,56,42,11,26,17,39,2015
181,Derrick Rose,CHI,51,1530,251,567,186,65,78,28,80,23,42,2015
182,Steve Blake,POR,81,1529,288,662,202,86,112,27,63,32,54,2015
183,Alex Len,PHX,69,1518,32,77,19,13,14,3,2,3,10,2015
184,Dennis Schroder,ATL,77,1516,317,761,190,127,80,46,64,34,93,2015
185,Rasual Butler,WAS,75,1504,63,132,57,6,25,12,20,2,4,2015
186,Beno Udrih,MEM,79,1494,220,497,163,57,82,31,50,18,39,2015
187,Lance Thomas,NYK,62,1491,69,163,44,25,13,4,27,4,21,2015
188,Cody Zeller,CHA,62,1487,100,216,84,16,38,16,30,2,14,2015
189,Jordan Clarkson,LAL,59,1476,206,454,164,42,94,27,43,12,30,2015
190,Shaun Livingston,GSW,78,1468,259,592,185,74,94,28,63,17,57,2015
191,Jodie Meeks,DET,60,1462,79,179,58,21,32,9,17,10,11,2015
192,Derrick Williams,SAC,74,1462,50,114,36,14,22,7,7,5,9,2015
193,Langston Galloway,NYK,45,1457,150,341,109,41,38,27,44,11,30,2015
194,Brandan Wright,PHX,75,1448,41,98,25,16,11,6,8,2,14,2015
195,Gerald Green,PHX,74,1446,91,217,56,35,37,7,12,16,19,2015
196,Cory Joseph,SAS,79,1444,188,448,116,72,51,39,26,14,58,2015
197,Ray McCallum,SAC,68,1436,188,410,154,34,90,19,45,15,19,2015
198,Anthony Tolliver,DET,76,1433,59,134,43,16,27,11,5,3,13,2015
199,Otto Porter Jr.,WAS,74,1432,65,142,53,12,27,11,15,4,8,2015
200,Carmelo Anthony,NYK,40,1428,122,284,82,40,39,12,31,9,31,2015
201,Danilo Gallinari,DEN,59,1426,83,191,58,25,42,5,11,5,20,2015
202,Kelly Olynyk,BOS,64,1423,109,248,79,30,42,13,24,8,22,2015
203,C.J. Watson,IND,57,1422,208,468,156,52,51,25,80,14,38,2015
204,Omri Casspi,SAC,67,1416,102,225,81,21,52,15,14,10,11,2015
205,Tony Snell,CHI,72,1412,62,143,43,19,30,3,10,7,12,2015
206,JJ Hickson,DEN,73,1411,57,140,31,26,18,5,8,10,16,2015
207,Jameer Nelson,DEN,63,1406,253,579,180,73,110,29,41,22,51,2015
208,Henry Sims,PHI,73,1399,79,178,59,20,43,6,10,4,16,2015
209,Chris Kaman,POR,74,1398,65,164,31,34,15,3,13,12,22,2015
210,Tayshaun Prince,DET,58,1397,93,208,71,22,38,14,19,5,17,2015
211,Marco Belinelli,SAS,62,1388,94,226,56,38,34,12,10,15,23,2015
212,Matthew Dellavedova,CLE,67,1380,204,486,126,78,79,25,22,20,58,2015
213,Jerami Grant,PHI,65,1377,79,187,50,29,34,6,10,7,22,2015
214,James Johnson,TOR,70,1370,95,225,60,35,41,16,3,20,15,2015
215,Al-Farouq Aminu,DAL,74,1366,59,143,34,25,22,2,10,8,17,2015
216,J.J. Barea,DAL,77,1362,263,598,191,72,117,25,49,17,55,2015
217,KJ McDaniels,HOU,62,1352,72,165,51,21,32,8,11,6,15,2015
218,Kosta Koufos,MEM,81,1348,37,82,29,8,8,2,19,4,4,2015
219,Kris Humphries,WAS,64,1345,57,130,41,16,16,7,18,5,11,2015
220,Brian Roberts,CHA,72,1330,162,376,110,52,46,15,49,16,36,2015
221,Kent Bazemore,ATL,75,1323,78,186,48,30,33,9,6,5,25,2015
222,Ersan Ilyasova,MIL,58,1319,56,132,36,20,22,4,10,6,14,2015
223,Jrue Holiday,NOP,40,1303,274,603,219,55,136,22,61,17,38,2015
224,Kevin Martin,MIN,39,1303,89,190,77,12,33,15,29,2,10,2015
225,Quincy Acy,NYK,68,1287,68,158,46,22,18,5,23,3,19,2015
226,Andre Roberson,OKC,67,1286,70,165,45,25,20,10,15,7,18,2015
227,Chase Budinger,MIN,67,1286,64,140,52,12,28,9,15,0,12,2015
228,Spencer Hawes,LAC,73,1274,88,215,49,39,24,8,17,10,29,2015
229,Jose Calderon,NYK,42,1270,198,446,148,50,55,48,45,14,36,2015
230,George Hill,IND,43,1267,220,499,161,59,40,37,84,18,41,2015
231,Andre Miller,SAC,81,1253,284,627,225,59,126,37,62,15,44,2015
232,Amar'e Stoudemire,DAL,59,1244,45,104,31,14,9,4,18,3,11,2015
233,Richard Jefferson,DAL,74,1244,61,146,37,24,17,9,11,5,19,2015
234,Bismack Biyombo,CHA,64,1243,16,41,7,9,3,0,4,2,7,2015
235,Kevin Seraphin,WAS,79,1235,59,130,47,12,24,6,17,2,10,2015
236,Ryan Kelly,LAL,52,1233,92,213,63,29,28,13,22,9,20,2015
237,Jonas Jerebko,BOS,75,1230,71,176,37,34,20,10,7,7,27,2015
238,John Henson,MIL,67,1228,59,133,44,15,27,6,11,8,7,2015
239,Dwight Howard,HOU,41,1223,50,126,24,26,17,3,4,6,20,2015
240,Kobe Bryant,LAL,35,1207,197,441,150,47,87,23,40,18,29,2015
241,Marreese Speights,GSW,76,1207,72,160,56,16,33,12,11,4,12,2015
242,Pablo Prigioni,HOU,67,1197,171,397,116,55,60,24,32,12,43,2015
243,Tarik Black,LAL,63,1195,42,99,27,15,10,3,14,2,13,2015
244,Miles Plumlee,MIL,73,1194,34,82,20,14,7,6,7,3,11,2015
245,Gary Neal,MIN,54,1192,100,235,65,35,26,15,24,8,27,2015
246,Carl Landry,SAC,70,1192,26,58,20,6,9,2,9,0,6,2015
247,Ramon Sessions,WAS,64,1188,182,408,138,44,80,20,38,11,33,2015
248,Brandon Jennings,DET,41,1173,272,617,199,73,120,34,45,26,47,2015
249,Kendrick Perkins,CLE,68,1148,51,120,33,18,19,3,11,3,15,2015
250,Ian Mahinmi,IND,61,1146,33,78,21,12,10,2,9,3,9,2015
251,Hassan Whiteside,MIA,48,1142,6,14,4,2,3,1,0,0,2,2015
252,Robert Sacre,LAL,67,1133,55,131,34,21,10,8,16,1,20,2015
253,Chris Andersen,MIA,60,1132,43,92,37,6,23,5,9,2,4,2015
254,JaKarr Sampson,PHI,74,1131,77,179,52,25,30,10,12,6,19,2015
255,Nik Stauskas,SAC,73,1126,67,144,57,10,28,14,15,4,6,2015
256,Mike Scott,ATL,68,1123,75,183,42,33,25,9,8,11,22,2015
257,Aron Baynes,SAS,70,1122,35,84,21,14,12,1,8,2,12,2015
258,Donald Sloan,IND,53,1107,190,438,132,58,32,19,81,19,39,2015
259,Jusuf Nurkic,DEN,62,1103,50,115,35,15,27,2,6,2,13,2015
260,Shawn Marion,CLE,57,1101,51,119,34,17,15,10,9,6,11,2015
261,Nick Collison,OKC,66,1101,90,206,64,26,41,11,12,9,17,2015
262,Vince Carter,MEM,66,1091,79,169,68,11,40,10,18,4,7,2015
263,Shawne Williams,DET,63,1087,44,103,29,15,12,4,13,6,9,2015
264,Randy Foye,DEN,50,1086,119,270,87,32,58,14,15,12,20,2015
265,Lavoy Allen,IND,63,1070,73,169,50,23,29,10,11,5,18,2015
266,Rodney Hood,UTA,50,1064,83,194,55,28,37,8,10,8,20,2015
267,Tyler Hansbrough,TOR,74,1058,21,53,10,11,2,6,2,4,7,2015
268,James Ennis III,MIA,62,1051,48,114,30,18,20,2,8,7,11,2015
269,Damjan Rudez,IND,68,1047,53,130,29,24,16,5,8,10,14,2015
270,Pero Antic,ATL,63,1037,49,120,27,22,16,6,5,8,14,2015
271,Tiago Splitter,SAS,52,1030,78,178,56,22,38,12,6,11,11,2015
272,Shabazz Napier,MIA,51,1012,130,308,82,48,40,14,28,21,27,2015
273,Nick Young,LAL,42,1000,41,89,34,7,19,5,10,1,6,2015
274,Udonis Haslem,MIA,62,995,46,105,33,13,20,5,8,4,9,2015
275,Darrell Arthur,DEN,58,988,57,133,38,19,25,10,3,7,12,2015
276,Will Barton,DEN,58,984,81,187,56,25,31,7,18,11,14,2015
277,Leandro Barbosa,GSW,66,982,99,231,66,33,37,7,22,10,23,2015
278,Ronnie Price,LAL,43,982,165,366,129,36,57,18,54,13,23,2015
279,Cole Aldrich,NYK,60,976,75,164,61,14,31,9,21,5,9,2015
280,Thabo Sefolosha,ATL,52,976,75,181,44,31,24,10,10,10,21,2015
281,CJ McCollum,POR,62,973,64,152,40,24,20,4,16,14,10,2015
282,Alexis Ajinca,NOP,68,956,47,100,41,6,20,7,14,1,5,2015
283,Kevin Garnett,MIN,47,952,77,176,55,22,35,15,5,4,18,2015
284,Willie Green,ORL,52,951,68,161,43,25,19,8,16,2,23,2015
285,Isaiah Canaan,PHI,47,938,98,240,54,44,35,10,9,16,28,2015
286,Lou Amundson,NYK,53,937,70,151,59,11,18,10,31,2,9,2015
287,Matt Bonner,SAS,72,935,47,110,31,16,12,6,13,2,14,2015
288,Elijah Millsap,UTA,47,924,58,137,37,21,27,4,6,7,14,2015
289,Kevin Durant,OKC,27,913,110,250,80,30,47,14,19,13,17,2015
290,David Lee,GSW,49,904,85,206,49,36,26,9,14,8,28,2015
291,Glen Davis,LAC,74,904,39,95,22,17,8,4,10,5,12,2015
292,Alec Burks,UTA,27,899,82,188,58,24,38,9,11,6,18,2015
293,Tony Wroten,PHI,30,895,157,368,103,54,72,15,16,13,41,2015
294,Anthony Bennett,MIN,57,894,48,109,35,13,22,4,9,3,10,2015
295,Mirza Teletovic,BKN,40,892,46,106,32,14,19,7,6,5,9,2015
296,Terrence Jones,HOU,33,889,36,90,18,18,13,4,1,7,11,2015
297,Jason Maxiell,CHA,61,878,19,42,15,4,6,2,7,1,3,2015
298,Shabazz Muhammad,MIN,38,866,44,96,36,8,18,8,10,2,6,2015
299,Drew Gooden,WAS,51,864,49,105,42,7,24,11,7,2,5,2015
300,Joey Dorsey,HOU,69,854,25,59,16,9,13,2,1,3,6,2015
301,Meyers Leonard,POR,55,847,32,80,16,16,7,2,7,5,11,2015
302,Dewayne Dedmon,ORL,59,845,9,19,8,1,6,1,1,0,1,2015
303,Nick Calathes,MEM,58,838,146,318,120,26,64,23,33,5,21,2015
304,Shelvin Mack,ATL,55,833,155,352,113,42,57,13,43,11,31,2015
305,Ish Smith,PHI,55,831,180,425,115,65,84,12,19,18,47,2015
306,Luke Babbitt,NOP,63,830,24,56,16,8,9,6,1,0,8,2015
307,Chris Copeland,IND,49,827,51,117,36,15,14,10,12,4,11,2015
308,Jon Leuer,MEM,63,824,46,101,37,9,19,11,7,3,6,2015
309,Kyle O'Quinn,ORL,51,824,59,129,48,11,33,6,9,3,8,2015
310,Nikola Pekovic,MIN,31,815,27,58,23,4,13,2,8,1,3,2015
311,Patty Mills,SAS,51,801,87,207,54,33,30,12,12,11,22,2015
312,Thomas Robinson,PHI,54,798,33,78,21,12,14,0,7,2,10,2015
313,Aaron Gordon,ORL,47,797,33,80,19,14,14,4,1,5,9,2015
314,Kostas Papanikolaou,HOU,43,795,85,205,50,35,42,5,3,12,23,2015
315,Ben Gordon,ORL,56,790,50,108,42,8,23,9,10,1,7,2015
316,Andrea Bargnani,NYK,29,785,46,99,39,7,19,8,12,1,6,2015
317,Markel Brown,BKN,47,781,39,90,27,12,16,5,6,5,7,2015
318,Alexey Shved,NYK,42,767,106,234,84,22,40,21,23,6,16,2015
319,Reggie Evans,SAC,47,764,32,71,25,7,15,6,4,2,5,2015
320,Robbie Hummel,MIN,45,742,27,63,18,9,12,2,4,2,7,2015
321,Adreian Payne,MIN,32,740,30,66,24,6,9,7,8,2,4,2015
322,Jabari Parker,MIL,25,739,42,94,32,10,24,4,4,5,5,2015
323,Garrett Temple,WAS,52,735,56,121,47,9,20,17,10,1,8,2015
324,Marcus Thornton,PHX,48,721,36,77,31,5,17,5,9,1,4,2015
325,Gary Harris,DEN,55,719,29,65,22,7,12,0,10,1,6,2015
326,Justin Hamilton,MIN,41,713,36,82,26,10,10,6,10,4,6,2015
327,Hedo Turkoglu,LAC,62,704,37,95,16,21,5,3,8,10,11,2015
328,Mike Miller,CLE,52,701,46,105,33,13,16,10,7,2,11,2015
329,Ricky Rubio,MIN,22,692,193,417,162,31,78,29,55,9,22,2015
330,PJ Hairston,CHA,45,687,21,48,15,6,8,2,5,2,4,2015
331,Allen Crabbe,POR,51,683,39,93,24,15,8,4,12,3,12,2015
332,Luke Ridnour,ORL,47,683,96,220,68,28,32,17,19,6,22,2015
333,Charlie Villanueva,DAL,64,678,19,44,13,6,7,2,4,2,4,2015
334,Maurice Harkless,ORL,45,674,25,55,20,5,15,2,3,2,3,2015
335,Travis Wear,NYK,51,672,40,94,26,14,14,2,10,0,14,2015
336,James Jones,CLE,57,669,24,57,15,9,7,4,4,5,4,2015
337,Alonzo Gee,POR,54,661,25,60,15,10,6,2,7,1,9,2015
338,Justin Holiday,GSW,59,657,48,108,36,12,22,4,10,2,10,2015
339,Cleanthony Early,NYK,39,647,36,84,24,12,6,5,13,3,9,2015
340,Anderson Varejao,CLE,26,636,35,77,28,7,25,2,1,2,5,2015
341,Jeremy Lamb,OKC,47,633,44,100,32,12,15,8,9,3,9,2015
342,Perry Jones III,OKC,43,631,18,45,9,9,5,1,3,4,5,2015
343,Henry Walker,MIA,24,628,29,64,23,6,14,2,7,3,3,2015
344,Joel Freeland,POR,48,617,16,43,5,11,2,2,1,4,7,2015
345,TJ Warren,PHX,40,614,25,60,15,10,8,3,4,2,8,2015
346,Danny Granger,MIA,30,613,17,42,9,8,3,3,3,4,4,2015
347,Tyler Johnson,MIA,32,603,42,98,28,14,16,3,9,5,9,2015
348,Phil Pressey,BOS,50,600,117,277,74,43,43,7,24,9,34,2015
349,Dorell Wright,POR,48,592,41,98,25,16,11,10,4,8,8,2015
350,Nate Robinson,LAC,42,591,97,225,66,31,37,10,19,13,18,2015
351,Larry Sanders,MIL,27,586,23,49,20,3,12,3,5,2,1,2015
352,Jabari Brown,LAL,19,568,40,94,26,14,12,3,11,3,11,2015
353,Sergey Karasev,BKN,32,555,46,104,34,12,17,9,8,5,7,2015
354,Lorenzo Brown,MIN,29,549,90,209,61,29,25,19,17,12,17,2015
355,Samuel Dalembert,NYK,32,544,29,63,24,5,12,1,11,1,4,2015
356,Furkan Aldemir,PHI,41,541,28,69,15,13,9,1,5,0,13,2015
357,Archie Goodwin,PHX,41,535,44,97,35,9,23,5,7,3,6,2015
358,Cory Jefferson,BKN,50,531,16,38,10,6,7,2,1,3,3,2015
359,Jordan Farmar,LAC,36,529,67,149,52,15,33,7,12,9,6,2015
360,Chris Johnson,UTA,29,527,15,32,13,2,8,3,2,1,1,2015
361,Jimmer Fredette,NOP,50,509,58,132,42,16,28,5,9,1,15,2015
362,Michael Beasley,MIA,24,505,32,74,22,10,16,3,3,3,7,2015
363,E'Twaun Moore,CHI,56,504,33,77,22,11,14,3,5,3,8,2015
364,Festus Ezeli,GSW,46,504,9,24,3,6,1,1,1,0,6,2015
365,Mike Muscala,ATL,40,502,25,59,16,9,8,2,6,4,5,2015
366,Joe Harris,CLE,51,493,26,65,13,13,8,2,3,4,9,2015
367,Andrew Nicholson,ORL,40,492,22,52,14,8,5,3,6,2,6,2015
368,Elton Brand,ATL,36,486,22,54,12,10,6,2,4,3,7,2015
369,Mitch McGary,OKC,32,485,14,34,8,6,7,1,0,2,4,2015
370,Spencer Dinwiddie,DET,34,455,104,244,68,36,39,9,20,9,27,2015
371,Ryan Hollins,SAC,46,441,14,29,13,1,6,3,4,0,1,2015
372,Jeffery Taylor,CHA,29,430,22,50,16,6,8,3,5,3,3,2015
373,Brandon Davies,BKN,27,423,30,72,18,12,12,0,6,2,10,2015
374,Kendall Marshall,MIL,28,417,86,191,67,19,44,8,15,6,13,2015
375,Jason Richardson,PHI,19,416,38,90,24,14,16,1,7,4,10,2015
376,Tyler Ennis,MIL,33,411,73,168,51,22,26,4,21,6,16,2015
377,Erick Green,DEN,43,410,39,88,29,10,15,8,6,2,8,2015
378,Joel Anthony,DET,48,406,5,13,2,3,1,0,1,1,2,2015
379,Troy Daniels,CHA,47,397,22,52,14,8,7,4,3,2,6,2015
380,Jerome Jordan,BKN,44,383,13,28,11,2,6,4,1,0,2,2015
381,Jeff Ayres,SAS,51,383,14,31,11,3,8,1,2,1,2,2015
382,Johnny O'Bryant III,MIL,34,368,17,40,11,6,4,4,3,5,1,2015
383,Greg Smith,DAL,42,363,9,21,6,3,1,0,5,2,1,2015
384,Kyle Anderson,SAS,33,358,28,63,21,7,11,5,5,5,2,2015
385,Martell Webster,WAS,32,352,17,34,17,0,7,3,7,0,0,2015
386,Austin Daye,ATL,34,344,17,37,14,3,8,5,1,2,1,2015
387,Reggie Bullock,PHX,36,338,8,22,2,6,2,0,0,1,5,2015
388,James Young,BOS,31,332,13,30,9,4,2,4,3,3,1,2015
389,Sebastian Telfair,OKC,16,327,45,102,33,12,18,6,9,2,10,2015
390,AJ Price,PHX,26,323,46,104,34,12,13,6,15,4,8,2015
391,Doug McDermott,CHI,36,321,6,14,4,2,2,0,2,0,2,2015
392,Darius Morris,BKN,38,299,48,116,28,20,17,7,4,6,14,2015
393,John Jenkins,ATL,24,297,13,31,8,5,4,1,3,2,3,2015
394,Josh McRoberts,MIA,17,296,33,70,29,4,19,5,5,0,4,2015
395,Gerald Wallace,BOS,32,286,11,26,7,4,4,0,3,0,4,2015
396,Raymond Felton,DAL,29,281,41,102,21,20,14,2,5,7,13,2015
397,John Lucas III,DET,21,272,60,137,43,17,10,17,16,7,10,2015
398,Brandon Rush,GSW,33,271,12,28,8,4,5,2,1,1,3,2015
399,John Salmons,NOP,21,270,13,29,10,3,5,0,5,1,2,2015
400,Joffrey Lauvergne,DEN,24,268,13,31,8,5,3,2,3,0,5,2015
401,Jeremy Evans,UTA,38,266,13,34,5,8,3,1,1,0,8,2015
402,Nick Johnson,HOU,28,262,11,25,8,3,8,0,0,1,2,2015
403,Glenn Robinson III,PHI,35,261,11,28,5,6,4,0,1,2,4,2015
404,Jeff Withey,NOP,37,259,11,27,6,5,2,1,3,1,4,2015
405,Noah Vonleh,CHA,25,259,4,9,3,1,1,1,1,0,1,2015
406,JaVale McGee,PHI,23,256,3,6,3,0,3,0,0,0,0,2015
407,Chuck Hayes,TOR,29,255,20,47,13,7,7,2,4,1,6,2015
408,Jordan Adams,MEM,30,248,16,33,15,1,9,3,3,0,1,2015
409,Nate Wolters,NOP,21,247,21,47,16,5,7,4,5,3,2,2015
410,Ricky Ledo,NYK,17,244,19,45,12,7,7,1,4,3,4,2015
411,Tim Frazier,POR,11,239,60,147,33,27,17,5,11,9,18,2015
412,Dwight Powell,DAL,29,236,9,23,4,5,2,1,1,2,3,2015
413,Larry Drew II,PHI,12,219,45,111,24,21,12,4,8,4,17,2015
414,Landry Fields,TOR,26,216,15,35,10,5,5,4,1,2,3,2015
415,Jeff Adrien,MIN,17,215,15,31,14,1,5,4,5,0,1,2015
416,Gigi Datome,BOS,21,209,9,19,8,1,7,0,1,1,0,2015
417,Devyn Marble,ORL,16,208,17,39,12,5,8,2,2,2,3,2015
418,Francisco Garcia,HOU,14,200,15,36,9,6,6,2,1,5,1,2015
419,Cartier Martin,DET,23,198,11,28,5,6,4,1,0,3,3,2015
420,Steve Novak,OKC,35,197,11,27,6,5,4,1,1,0,5,2015
421,Malcolm Thomas,PHI,17,194,7,18,3,4,3,0,0,1,3,2015
422,Ian Clark,DEN,30,192,12,30,6,6,5,0,1,4,2,2015
423,DeJuan Blair,WAS,29,180,3,7,2,1,1,0,1,0,1,2015
424,Toney Douglas,NOP,12,177,24,55,17,7,11,1,5,3,4,2015
425,Jorge Gutierrez,MIL,20,174,22,46,20,2,10,4,6,1,1,2015
426,JaMychal Green,MEM,24,164,4,9,3,1,3,0,0,1,0,2015
427,Bryce Cotton,UTA,15,159,15,32,13,2,10,1,2,1,1,2015
428,Bernard James,DAL,16,158,4,9,3,1,0,0,3,0,1,2015
429,Earl Barron,PHX,16,143,5,12,3,2,1,1,1,1,1,2015
430,James Michael McAdoo,GSW,15,137,2,4,2,0,1,1,0,0,0,2015
431,Ekpe Udoh,LAC,33,128,8,21,3,5,2,0,1,0,5,2015
432,Nazr Mohammed,CHI,23,128,3,7,2,1,1,0,1,0,1,2015
433,Shavlik Randolph,BOS,21,126,4,12,0,4,0,0,0,1,3,2015
434,Jarnell Stokes,MEM,19,126,4,8,4,0,4,0,0,0,0,2015
435,Dahntay Jones,LAC,33,123,2,5,1,1,1,0,0,0,1,2015
436,Dwight Buycks,LAL,6,123,14,28,14,0,8,2,4,0,0,2015
437,Jordan Hamilton,LAC,14,122,7,16,5,2,1,1,3,1,1,2015
438,Quincy Miller,DET,10,120,8,19,5,3,4,0,1,0,3,2015
439,Brendan Haywood,CLE,22,119,2,6,0,2,0,0,0,0,2,2015
440,Elliot Williams,NOP,13,119,12,27,9,3,3,2,4,1,2,2015
441,Shayne Whittington,IND,20,108,6,14,4,2,4,0,0,1,1,2015
442,Reggie Williams,SAS,20,105,10,22,8,2,6,1,1,0,2,2015
443,Kenyon Martin,MIL,11,104,5,12,3,2,1,0,2,1,1,2015
444,Chris Douglas-Roberts,LAC,12,102,4,11,1,3,0,0,1,0,3,2015
445,CJ Wilcox,LAC,21,101,8,19,5,3,2,2,1,0,3,2015
446,Earl Clark,BKN,10,93,3,7,2,1,1,1,0,0,1,2015
447,Paul George,IND,6,91,6,13,5,1,0,2,3,1,0,2015
448,Clint Capela,HOU,11,90,2,5,1,1,1,0,0,0,1,2015
449,Jared Cunningham,LAC,19,89,10,25,5,5,4,0,1,2,3,2015
450,Shannon Brown,MIA,5,89,3,7,2,1,0,0,2,1,0,2015
451,Jack Cooley,UTA,16,87,1,2,1,0,0,0,1,0,0,2015
452,Xavier Henry,LAL,9,86,3,6,3,0,0,1,2,0,0,2015
453,Victor Claver,POR,10,76,1,2,1,0,1,0,0,0,0,2015
454,Zoran Dragic,MIA,16,75,5,11,4,1,4,0,0,1,0,2015
455,Vander Blue,LAL,2,74,8,18,6,2,3,0,3,1,1,2015
456,Jannero Pargo,CHA,9,73,8,19,5,3,2,1,2,0,3,2015
457,Ognjen Kuzmic,GSW,16,72,6,15,3,3,2,0,1,0,3,2015
458,Sean Kilpatrick,MIN,4,72,4,10,2,2,2,0,0,1,1,2015
459,Drew Gordon,PHI,9,71,2,5,1,1,1,0,0,0,1,2015
460,Will Cherry,CLE,8,69,8,17,7,1,3,3,1,0,1,2015
461,Arinze Onuaku,MIN,6,68,4,10,2,2,1,1,0,1,1,2015
462,Will Bynum,WAS,7,67,18,40,14,4,5,5,4,0,4,2015
463,Greg Stiemsma,TOR,17,66,3,8,1,2,1,0,0,0,2,2015
464,Russ Smith,MEM,12,65,8,19,5,3,4,1,0,0,3,2015
465,Cameron Bairstow,CHI,18,63,1,2,1,0,0,0,1,0,0,2015
466,Lester Hudson,LAC,5,56,5,13,2,3,1,1,0,0,3,2015
467,Grant Jerrett,UTA,8,51,3,7,2,1,1,1,0,0,1,2015
468,Gal Mekel,NOP,4,43,13,30,9,4,3,1,5,0,4,2015
469,Darius Miller,NOP,5,43,2,5,1,1,0,1,0,0,1,2015
470,Glen Rice,WAS,5,43,2,4,2,0,1,0,1,0,0,2015
471,Andrei Kirilenko,BKN,7,36,1,2,1,0,1,0,0,0,0,2015
472,Jerel McNeal,PHX,6,36,2,4,2,0,0,1,1,0,0,2015
473,David Stockton,SAC,3,33,9,22,5,4,3,0,2,0,4,2015
474,Patrick Christopher,UTA,4,29,0,0,0,0,0,0,0,0,0,2015
475,Bruno Caboclo,TOR,8,23,0,0,0,0,0,0,0,0,0,2015
476,Lucas Nogueira,TOR,6,23,1,2,1,0,1,0,0,0,0,2015
477,Miroslav Raduljica,MIN,5,23,0,0,0,0,0,0,0,0,0,2015
478,Andre Dawkins,MIA,4,22,1,2,1,0,1,0,0,0,0,2015
479,Ronny Turiaf,MIN,2,19,2,4,2,0,1,0,1,0,0,2015
480,Toure' Murry,WAS,5,18,1,2,1,0,0,1,0,0,0,2015
481,Alex Kirk,CLE,5,14,1,2,1,0,1,0,0,0,0,2015
482,Julius Randle,LAL,1,14,0,0,0,0,0,0,0,0,0,2015
483,Jamaal Franklin,DEN,3,13,3,7,2,1,2,0,0,1,0,2015
484,Seth Curry,PHX,2,8,1,3,0,1,0,0,0,0,1,2015
485,David Wear,SAC,2,7,1,2,1,0,0,1,0,0,0,2015
486,Tyrus Thomas,MEM,2,7,1,2,1,0,1,0,0,0,0,2015
487,Kalin Lucas,MEM,1,6,0,0,0,0,0,0,0,0,0,2015
488,Jerrelle Benimon,UTA,2,3,0,0,0,0,0,0,0,0,0,2015
489,Sim Bhullar,SAC,3,3,1,2,1,0,0,1,0,0,0,2015
490,Eric Moreland,SAC,3,2,0,0,0,0,0,0,0,0,0,2015
491,Malcolm Lee,PHI,1,2,0,0,0,0,0,0,0,0,0,2015
0,Kevin Durant,OKC,81,3122,445,1004,331,114,188,59,84,46,68,2014
1,Monta Ellis,DAL,82,3023,471,1105,308,163,184,51,73,33,130,2014
2,DeMar DeRozan,TOR,79,3017,313,786,153,160,82,31,40,49,111,2014
3,Carmelo Anthony,NYK,77,2982,242,592,134,108,84,14,36,34,74,2014
4,John Wall,WAS,82,2980,721,1689,474,247,298,62,114,112,135,2014
5,Nicolas Batum,POR,82,2956,420,946,314,106,170,43,101,31,75,2014
6,Damian Lillard,POR,82,2937,457,1071,300,157,145,46,109,47,110,2014
7,LeBron James,MIA,77,2902,488,1156,308,180,187,40,81,90,90,2014
8,Paul George,IND,80,2898,283,630,219,64,92,56,71,21,43,2014
9,DeAndre Jordan,LAC,82,2871,74,166,56,18,35,4,17,4,14,2014
10,Klay Thompson,GSW,81,2868,181,408,135,46,85,24,26,15,31,2014
11,Blake Griffin,LAC,80,2864,309,713,214,95,139,21,54,45,50,2014
12,Kyle Lowry,TOR,79,2862,586,1319,439,147,216,105,118,61,86,2014
13,Stephen Curry,GSW,78,2846,666,1486,512,154,329,91,92,52,102,2014
14,Joakim Noah,CHI,80,2820,431,954,339,92,192,36,111,21,71,2014
15,Jeff Green,BOS,82,2805,138,318,96,42,44,10,42,16,26,2014
16,Gordon Hayward,UTA,77,2800,400,932,268,132,159,50,59,42,90,2014
17,Kevin Love,MIN,77,2797,341,739,284,57,191,44,49,18,39,2014
18,Chandler Parsons,HOU,74,2783,298,695,199,99,155,32,12,31,68,2014
19,Wesley Matthews,POR,82,2780,197,445,146,51,58,20,68,15,36,2014
20,James Harden,HOU,73,2778,446,1043,295,151,240,39,16,50,101,2014
21,Lance Stephenson,IND,78,2752,359,809,268,91,123,41,104,37,54,2014
22,Josh Smith,DET,77,2730,252,574,182,70,146,18,18,38,32,2014
23,Brandon Jennings,DET,80,2728,609,1322,505,104,344,77,84,40,64,2014
24,Trevor Ariza,WAS,77,2723,191,432,141,50,85,17,39,17,33,2014
25,Thaddeus Young,PHI,79,2718,182,407,139,43,105,18,16,11,32,2014
26,Zach Randolph,MEM,79,2705,200,448,152,48,88,28,36,5,43,2014
27,Greg Monroe,DET,82,2690,171,388,125,46,91,12,22,15,31,2014
28,Goran Dragic,PHX,76,2668,447,1090,251,196,148,40,63,65,131,2014
29,Serge Ibaka,OKC,81,2666,85,207,48,37,29,4,15,11,26,2014
30,Marcin Gortat,WAS,81,2655,138,317,97,41,33,14,50,10,31,2014
31,Ricky Rubio,MIN,82,2638,704,1590,522,182,338,89,95,50,132,2014
32,Dirk Nowitzki,DAL,80,2628,216,490,158,58,105,27,26,24,34,2014
33,Andre Drummond,DET,81,2619,35,79,26,9,19,1,6,2,7,2014
34,Kemba Walker,CHA,73,2614,447,998,343,104,153,61,129,23,81,2014
35,Corey Brewer,MIN,81,2609,135,310,95,40,74,10,11,6,34,2014
36,Robin Lopez,POR,82,2604,73,176,43,30,23,3,17,7,23,2014
37,Tristan Thompson,CLE,82,2594,72,170,46,26,24,7,15,10,16,2014
38,Jimmy Butler,CHI,67,2591,175,394,131,44,65,16,50,16,28,2014
39,Mike Dunleavy,CHI,82,2584,186,403,155,31,78,28,49,13,18,2014
40,Joe Johnson,BKN,79,2575,216,515,133,83,77,23,33,21,62,2014
41,Jodie Meeks,LAL,77,2556,138,325,89,49,50,16,23,14,35,2014
42,Al Jefferson,CHA,73,2553,155,360,105,50,66,14,25,10,40,2014
43,Arron Afflalo,ORL,73,2552,248,571,173,75,84,29,60,19,56,2014
44,Jeff Teague,ATL,79,2542,528,1225,359,169,180,71,108,45,124,2014
45,Chris Bosh,MIA,79,2531,87,206,55,32,36,7,12,16,16,2014
46,Rudy Gay,SAC,73,2531,209,469,158,51,93,35,30,13,38,2014
47,Bradley Beal,WAS,73,2530,243,544,185,58,78,42,65,19,39,2014
48,LaMarcus Aldridge,POR,69,2499,178,446,88,90,60,11,17,33,57,2014
49,Isaiah Thomas,SAC,72,2497,454,1012,350,104,174,60,116,30,74,2014
50,Kyrie Irving,CLE,71,2496,433,965,334,99,141,83,110,27,72,2014
51,PJ Tucker,PHX,81,2490,141,336,87,54,53,10,24,16,38,2014
52,Victor Oladipo,ORL,80,2486,327,728,253,74,114,40,99,24,50,2014
53,Randy Foye,DEN,81,2485,287,648,213,74,153,30,30,31,43,2014
54,Paul Millsap,ATL,74,2482,232,549,147,85,90,23,34,41,44,2014
55,David West,IND,80,2472,223,518,151,72,90,33,28,22,50,2014
56,Spencer Hawes,CLE,80,2470,240,522,198,42,130,30,38,12,30,2014
57,Jose Calderon,DAL,81,2469,377,851,280,97,132,68,80,32,65,2014
58,Gerald Henderson,CHA,77,2461,199,446,151,48,80,32,39,11,37,2014
59,Khris Middleton,MIL,82,2460,169,372,135,34,86,18,31,11,23,2014
60,Evan Turner,IND,81,2457,262,596,190,72,128,24,38,14,58,2014
61,Mike Conley,MEM,73,2446,441,960,363,78,172,85,106,29,49,2014
62,George Hill,IND,76,2434,265,587,208,57,63,39,106,20,37,2014
63,JR Smith,NYK,74,2421,219,527,130,89,76,15,39,33,56,2014
64,Michael Carter-Williams,PHI,70,2414,441,1017,306,135,184,63,59,28,107,2014
65,Roy Hibbert,IND,81,2409,91,206,67,24,52,4,11,2,22,2014
66,Shawn Marion,DAL,76,2409,124,300,72,52,36,12,24,15,37,2014
67,Kyle Korver,ATL,71,2408,208,467,157,51,82,46,29,17,34,2014
68,Brandon Knight,MIL,72,2400,352,802,254,98,115,42,97,25,73,2014
69,Dwight Howard,HOU,71,2397,131,310,83,48,71,6,6,10,38,2014
70,Josh McRoberts,CHA,78,2360,333,729,270,63,140,43,87,22,41,2014
71,Anthony Davis,NOP,67,2358,105,238,77,28,36,11,30,7,21,2014
72,Taj Gibson,CHI,82,2351,91,221,52,39,33,7,12,10,29,2014
73,DeMarre Carroll,ATL,73,2341,134,320,82,52,49,12,21,22,30,2014
74,Kyle Singler,DET,82,2337,75,172,53,22,35,5,13,4,18,2014
75,Gerald Green,PHX,82,2330,122,289,77,45,46,16,15,19,26,2014
76,Channing Frye,PHX,82,2312,98,240,54,44,37,6,11,17,27,2014
77,James Anderson,PHI,80,2309,149,353,94,55,60,16,18,14,41,2014
78,DeMarcus Cousins,SAC,71,2298,207,476,145,62,98,18,29,15,47,2014
79,David Lee,GSW,69,2289,147,351,90,57,57,18,15,25,32,2014
80,Jonas Valanciunas,TOR,81,2282,57,131,40,17,21,7,12,5,12,2014
81,Reggie Jackson,OKC,80,2278,331,755,238,93,109,42,87,35,58,2014
82,Brandon Bass,BOS,82,2267,87,201,60,27,26,11,23,13,14,2014
83,Trey Burke,UTA,70,2263,396,892,296,100,155,46,95,36,64,2014
84,Jarrett Jack,CLE,80,2252,324,750,222,102,102,44,76,32,70,2014
85,Wesley Johnson,LAL,79,2240,124,283,89,35,57,11,21,18,17,2014
86,Ty Lawson,DEN,62,2222,543,1256,373,170,244,64,65,49,121,2014
87,Ramon Sessions,MIL,83,2214,340,766,254,86,124,60,70,18,68,2014
88,Amir Johnson,TOR,77,2214,115,259,86,29,43,18,25,6,23,2014
89,Luol Deng,CLE,63,2213,183,410,139,44,72,29,38,21,23,2014
90,Richard Jefferson,UTA,82,2212,130,294,96,34,63,12,21,7,27,2014
91,Harrison Barnes,GSW,78,2204,116,275,73,43,48,11,14,13,30,2014
92,Derrick Favors,UTA,73,2201,91,217,56,35,31,8,17,9,26,2014
93,Alec Burks,UTA,78,2193,212,481,155,57,78,35,42,13,44,2014
94,Ben McLemore,SAC,82,2187,82,180,66,16,38,15,13,6,10,2014
95,Jameer Nelson,ORL,68,2179,476,1065,363,113,161,61,141,51,62,2014
96,Mario Chalmers,MIA,73,2178,357,791,280,77,182,27,71,38,39,2014
97,Kenneth Faried,DEN,80,2178,96,234,54,42,46,3,5,18,24,2014
98,Kevin Martin,MIN,68,2177,121,283,80,41,49,15,16,9,32,2014
99,Chris Paul,LAC,62,2171,663,1495,494,169,300,52,142,62,107,2014
100,Terrence Ross,TOR,81,2159,79,174,63,16,40,14,9,4,12,2014
101,Tim Duncan,SAS,74,2158,220,485,175,45,112,27,36,10,35,2014
102,Martell Webster,WAS,78,2157,97,218,73,24,46,12,15,8,16,2014
103,Markieff Morris,PHX,81,2153,144,346,86,58,66,10,10,25,33,2014
104,Carlos Boozer,CHI,76,2141,118,272,82,36,49,6,27,6,30,2014
105,Enes Kanter,UTA,80,2138,75,181,44,31,19,5,20,4,27,2014
106,Kirk Hinrich,CHI,73,2116,286,642,216,70,84,36,96,22,48,2014
107,Paul Pierce,BKN,75,2098,178,421,113,65,60,20,33,26,39,2014
108,Jamal Crawford,LAC,69,2094,223,496,173,50,106,22,45,24,26,2014
109,Terrence Jones,HOU,76,2078,87,208,53,34,47,2,4,7,27,2014
110,Dion Waiters,CLE,70,2072,209,486,141,68,67,30,44,28,40,2014
111,Darren Collison,LAC,80,2069,297,697,194,103,115,17,62,41,62,2014
112,Deron Williams,BKN,64,2059,392,930,246,146,130,47,69,35,111,2014
113,Eric Gordon,NOP,64,2057,208,444,180,28,78,30,72,10,18,2014
114,Jeremy Lin,HOU,71,2054,294,690,192,102,150,37,5,29,73,2014
115,Al-Farouq Aminu,NOP,80,2045,114,246,96,18,56,15,25,1,17,2014
116,Jared Sullinger,BOS,74,2041,118,275,79,39,40,4,35,14,25,2014
117,Andre Iguodala,GSW,63,2040,263,626,163,100,96,25,42,36,64,2014
118,Tyreke Evans,NOP,72,2028,363,835,254,109,130,48,76,38,71,2014
119,Raymond Felton,NYK,65,2017,365,873,222,143,133,29,60,29,114,2014
120,Marco Belinelli,SAS,80,2016,179,419,118,61,69,28,21,27,34,2014
121,Norris Cole,MIA,82,2014,248,553,191,57,122,24,45,34,23,2014
122,Jason Thompson,SAC,82,2007,53,121,38,15,21,9,8,3,12,2014
123,Tony Parker,SAS,68,1997,388,897,267,121,139,50,78,38,83,2014
124,Shaun Livingston,BKN,76,1974,245,579,156,89,101,13,42,25,64,2014
125,Boris Diaw,SAS,79,1974,222,509,157,65,93,33,31,35,30,2014
126,Vince Carter,DAL,81,1973,212,476,160,52,104,31,25,15,37,2014
127,Courtney Lee,MEM,79,1973,115,252,93,22,34,31,28,7,15,2014
128,Marc Gasol,MEM,59,1970,215,478,167,48,104,20,43,21,27,2014
129,Miles Plumlee,PHX,80,1964,43,104,25,18,10,5,10,0,18,2014
130,Iman Shumpert,NYK,74,1962,129,308,79,50,44,8,27,12,38,2014
131,Rodney Stuckey,DET,73,1950,152,338,118,34,78,20,20,12,22,2014
132,Maurice Harkless,ORL,80,1950,80,179,61,19,32,4,25,7,12,2014
133,Tayshaun Prince,MEM,76,1948,119,257,100,19,39,37,24,6,13,2014
134,D.J. Augustin,CHI,71,1939,313,699,240,73,112,24,104,25,48,2014
135,Ray Allen,MIA,73,1936,143,343,86,57,61,11,14,32,25,2014
136,Wilson Chandler,DEN,62,1927,114,266,76,38,47,16,13,4,34,2014
137,Kawhi Leonard,SAS,66,1923,133,317,82,51,49,10,23,17,34,2014
138,Giannis Antetokounmpo,MIL,77,1897,150,337,113,37,67,22,24,9,28,2014
139,Pau Gasol,LAL,60,1884,201,485,118,83,65,14,39,15,68,2014
140,Tim Hardaway Jr.,NYK,81,1875,66,155,43,23,26,3,14,8,15,2014
141,Jordan Crawford,GSW,81,1860,281,648,195,86,100,27,68,35,51,2014
142,JJ Hickson,DEN,69,1860,96,232,56,40,42,3,11,14,26,2014
143,John Henson,MIL,70,1856,113,263,76,37,47,8,21,4,33,2014
144,Avery Bradley,BOS,60,1855,85,188,67,18,39,10,18,1,17,2014
145,Tobias Harris,ORL,61,1850,82,191,55,27,28,5,22,14,13,2014
146,Mo Williams,POR,74,1833,321,737,226,95,110,25,91,33,62,2014
147,Derrick Williams,SAC,78,1820,56,128,40,16,29,5,6,7,9,2014
148,Nikola Vucevic,ORL,57,1812,104,245,67,37,36,10,21,7,30,2014
149,Nick Young,LAL,64,1809,95,217,68,27,33,9,26,7,20,2014
150,Anderson Varejao,CLE,65,1800,140,324,96,44,56,18,22,13,31,2014
151,Marcus Morris,PHX,82,1800,88,199,65,23,38,12,15,11,12,2014
152,Draymond Green,GSW,82,1796,152,358,98,54,67,15,16,16,38,2014
153,Greivis Vasquez,TOR,79,1779,323,736,233,90,124,47,62,29,61,2014
154,Dwyane Wade,MIA,54,1775,252,574,182,70,134,15,33,31,39,2014
155,Alan Anderson,BKN,78,1772,81,191,52,29,28,6,18,15,14,2014
156,Timofey Mozgov,DEN,82,1770,62,150,36,26,21,5,10,8,18,2014
157,Andrew Bogut,GSW,67,1770,112,263,73,39,40,10,23,9,30,2014
158,Tony Wroten,PHI,72,1765,217,480,171,46,125,23,23,11,35,2014
159,Patrick Beverley,HOU,56,1751,151,361,92,59,72,14,6,16,43,2014
160,Hollis Thompson,PHI,77,1742,73,175,44,29,25,7,12,13,16,2014
161,Marcus Thornton,BKN,72,1741,77,173,58,19,39,7,12,8,11,2014
162,Matt Barnes,LAC,63,1735,125,281,94,31,70,9,15,12,19,2014
163,Jared Dudley,LAC,74,1729,104,245,67,37,42,6,19,14,23,2014
164,John Salmons,TOR,78,1726,147,349,92,55,40,25,27,17,38,2014
165,Mike Miller,MEM,82,1706,130,286,104,26,41,34,29,12,14,2014
166,Jerryd Bayless,BOS,72,1686,194,444,138,56,57,18,63,13,43,2014
167,Marvin Williams,UTA,66,1674,78,185,49,29,29,8,12,13,16,2014
168,Brian Roberts,NOP,72,1667,234,523,179,55,90,37,52,15,40,2014
169,Nikola Pekovic,MIN,54,1664,50,121,29,21,15,7,7,2,19,2014
170,Tyson Chandler,NYK,55,1662,59,140,37,22,9,7,21,1,21,2014
171,Glen Davis,LAC,68,1662,77,173,58,19,35,7,16,6,13,2014
172,Danny Green,SAS,68,1651,104,225,87,17,48,13,26,4,13,2014
173,Dante Cunningham,MIN,81,1635,83,198,51,32,32,5,14,6,26,2014
174,Andray Blatche,BKN,73,1618,112,279,57,55,40,9,8,18,37,2014
175,Samuel Dalembert,DAL,80,1614,38,91,23,15,10,3,10,1,14,2014
176,Thabo Sefolosha,OKC,61,1584,94,204,78,16,40,9,29,5,11,2014
177,Kentavious Caldwell-Pope,DET,80,1582,55,126,39,16,25,5,9,6,10,2014
178,Kendall Marshall,LAL,54,1564,477,1053,378,99,214,85,79,28,71,2014
179,Nene,WAS,53,1560,153,341,118,35,67,18,33,11,24,2014
180,Aaron Brooks,DEN,72,1557,233,546,153,80,101,26,26,37,43,2014
181,Trevor Booker,WAS,72,1554,64,157,35,29,24,2,9,7,22,2014
182,Manu Ginobili,SAS,68,1551,293,667,212,81,139,33,40,36,45,2014
183,Jeremy Lamb,OKC,78,1538,115,265,80,35,41,13,26,4,31,2014
184,Patrick Patterson,TOR,65,1532,78,193,41,37,23,6,12,12,25,2014
185,Patty Mills,SAS,81,1527,149,354,93,56,55,12,26,17,39,2014
186,E'Twaun Moore,ORL,79,1506,112,245,91,21,40,14,37,8,13,2014
187,Evan Fournier,DEN,76,1503,112,254,82,30,44,14,24,11,19,2014
188,Michael Kidd-Gilchrist,CHA,62,1502,52,115,41,11,19,10,12,1,10,2014
189,Jordan Hill,LAL,72,1500,54,138,24,30,12,4,8,5,25,2014
190,Steve Blake,GSW,55,1498,307,704,217,90,111,38,68,38,52,2014
191,Shelvin Mack,ATL,73,1490,271,638,175,96,91,36,48,29,67,2014
192,Mike Scott,ATL,80,1482,75,180,45,30,24,9,12,11,19,2014
193,Ersan Ilyasova,MIL,55,1479,72,168,48,24,24,12,12,8,16,2014
194,J.J. Barea,MIN,79,1471,303,671,238,65,122,28,88,19,46,2014
195,Shane Battier,MIA,73,1468,63,156,33,30,23,5,5,14,16,2014
196,Amar'e Stoudemire,NYK,65,1466,34,85,17,17,7,0,10,1,16,2014
197,Lou Williams,ATL,60,1445,210,473,157,53,79,35,43,14,39,2014
198,Derek Fisher,OKC,81,1428,117,255,96,21,48,20,28,6,15,2014
199,Anthony Morrow,NOP,76,1426,59,131,46,13,30,8,8,2,11,2014
200,Caron Butler,OKC,56,1419,82,192,54,28,30,9,15,6,22,2014
201,Cody Zeller,CHA,82,1417,92,208,68,24,35,17,16,12,12,2014
202,Eric Bledsoe,PHX,43,1416,235,562,143,92,98,23,22,40,52,2014
203,Gerald Wallace,BOS,58,1416,143,330,99,44,54,20,25,25,19,2014
204,Elton Brand,ATL,73,1414,74,178,44,30,21,10,13,9,21,2014
205,Russell Westbrook,OKC,46,1412,319,719,238,81,137,36,65,29,52,2014
206,Kelly Olynyk,BOS,70,1400,109,249,78,31,50,3,25,12,19,2014
207,Luis Scola,IND,82,1399,81,193,50,31,28,10,12,8,23,2014
208,Chris Andersen,MIA,72,1396,19,44,13,6,8,3,2,4,2,2014
209,Mirza Teletovic,BKN,72,1396,57,134,37,20,25,2,10,12,8,2014
210,Kris Humphries,BOS,69,1376,67,158,43,24,20,6,17,8,16,2014
211,Nick Collison,OKC,81,1353,104,240,72,32,45,8,19,2,30,2014
212,Kosta Koufos,MEM,80,1349,39,85,32,7,10,7,15,1,6,2014
213,O.J. Mayo,MIL,52,1346,113,248,91,22,54,17,20,9,13,2014
214,Austin Rivers,NOP,69,1338,160,366,114,46,57,26,31,11,35,2014
215,Zaza Pachulia,MIL,53,1325,136,292,116,20,66,21,29,5,15,2014
216,Ryan Kelly,LAL,59,1312,95,237,48,47,28,8,12,17,30,2014
217,Nate Wolters,MIL,58,1309,187,439,122,65,60,25,37,15,50,2014
218,Anthony Tolliver,CHA,64,1298,42,100,26,16,13,4,9,5,11,2014
219,Omri Casspi,HOU,71,1283,88,210,54,34,40,7,7,9,25,2014
220,Pablo Prigioni,NYK,66,1282,228,539,145,83,66,17,62,19,64,2014
221,Tony Allen,MEM,55,1278,94,202,80,14,45,22,13,6,8,2014
222,Mason Plumlee,BKN,70,1275,60,141,39,21,20,6,13,3,18,2014
223,Tiago Splitter,SAS,59,1271,90,203,67,23,49,8,10,8,15,2014
224,Matthew Dellavedova,CLE,72,1271,187,422,139,48,78,24,37,13,35,2014
225,Andrea Bargnani,NYK,42,1257,45,105,30,15,11,3,16,3,12,2014
226,Jae Crowder,DAL,78,1253,60,140,40,20,23,7,10,4,16,2014
227,Ian Mahinmi,IND,77,1248,24,58,14,10,10,1,3,3,7,2014
228,Tony Snell,CHI,77,1231,68,146,58,10,24,12,22,1,9,2014
229,DeJuan Blair,DAL,78,1214,70,168,42,28,24,5,13,6,22,2014
230,Jeremy Evans,UTA,66,1209,44,100,32,12,15,5,12,4,8,2014
231,Kendrick Perkins,OKC,62,1207,67,148,53,14,34,4,15,5,9,2014
232,Steven Adams,OKC,81,1197,43,97,32,11,13,6,13,0,11,2014
233,C.J. Watson,IND,63,1193,107,246,75,32,18,10,47,13,19,2014
234,Kyle O'Quinn,ORL,69,1188,78,170,64,14,44,8,12,4,10,2014
235,Andrew Nicholson,ORL,76,1174,25,63,12,13,6,4,2,1,12,2014
236,Nick Calathes,MEM,71,1172,207,466,155,52,67,32,56,14,38,2014
237,Darrell Arthur,DEN,68,1161,61,139,44,17,27,10,7,8,9,2014
238,Elliot Williams,PHI,67,1157,72,169,47,25,30,5,12,8,17,2014
239,Jrue Holiday,NOP,34,1144,268,604,200,68,124,26,50,15,53,2014
240,Luke Ridnour,CHA,61,1140,176,398,130,46,73,28,29,8,38,2014
241,Phil Pressey,BOS,75,1132,241,537,186,55,114,21,51,10,45,2014
242,Gary Neal,CHA,52,1113,83,188,61,22,33,12,16,6,16,2014
243,Kevin Garnett,BKN,54,1109,82,191,55,27,34,9,12,6,21,2014
244,Robert Sacre,LAL,65,1089,51,135,18,33,7,3,8,5,28,2014
245,Francisco Garcia,HOU,55,1083,63,149,40,23,27,11,2,10,13,2014
246,Brandan Wright,DAL,58,1077,31,78,15,16,6,0,9,1,15,2014
247,Bismack Biyombo,CHA,77,1072,8,18,6,2,2,2,2,1,1,2014
248,Lavoy Allen,IND,65,1071,71,168,45,26,27,8,10,2,24,2014
249,Travis Outlaw,SAC,63,1065,48,108,36,12,23,5,8,7,5,2014
250,Will Bynum,DET,56,1054,216,479,169,47,115,20,34,24,23,2014
251,Tyler Zeller,CLE,70,1050,36,84,24,12,10,5,9,2,10,2014
252,Diante Garrett,UTA,71,1047,120,277,83,37,42,19,22,15,22,2014
253,Jordan Hamilton,HOU,60,1020,52,125,31,21,18,4,9,7,14,2014
254,Alonzo Gee,CLE,65,1020,47,107,34,13,10,13,11,4,9,2014
255,Chris Douglas-Roberts,CHA,49,1016,51,118,35,16,13,8,14,3,13,2014
256,Greg Stiemsma,NOP,55,1006,36,79,29,7,11,5,13,3,4,2014
257,Ish Smith,PHX,70,1006,179,429,108,71,70,7,31,19,52,2014
258,Luc Mbah a Moute,MIN,64,1003,36,82,26,10,19,3,4,2,8,2014
259,Rajon Rondo,BOS,30,998,294,668,214,80,99,33,82,21,59,2014
260,JJ Redick,LAC,35,987,78,180,54,24,39,6,9,11,13,2014
261,Dorell Wright,POR,68,984,64,154,38,26,19,9,10,12,14,2014
262,CJ Miles,CLE,51,984,52,121,35,17,16,10,9,6,11,2014
263,Marreese Speights,GSW,79,982,32,76,20,12,12,2,6,3,9,2014
264,Andre Miller,WAS,58,982,197,449,142,55,94,20,28,15,40,2014
265,Tyler Hansbrough,TOR,64,978,17,44,7,10,3,2,2,3,7,2014
266,Rashard Lewis,MIA,60,971,57,139,32,25,17,5,10,9,16,2014
267,Omer Asik,HOU,48,968,25,62,13,12,8,2,3,1,11,2014
268,Jeff Adrien,MIL,53,962,38,82,32,6,16,5,11,1,5,2014
269,Al Horford,ATL,29,958,76,181,47,29,29,7,11,10,19,2014
270,James Johnson,MEM,52,956,111,242,91,20,51,23,17,10,10,2014
271,Ed Davis,MEM,63,956,27,59,22,5,12,3,7,1,4,2014
272,Jeff Ayres,SAS,73,952,60,141,39,21,18,6,15,8,13,2014
273,Donatas Motiejunas,HOU,62,952,34,93,9,25,6,2,1,5,20,2014
274,Alexis Ajinca,NOP,56,950,40,88,32,8,18,6,8,2,6,2014
275,Cory Joseph,SAS,68,936,114,262,80,34,28,18,34,5,29,2014
276,Pero Antic,ATL,49,925,58,136,38,20,21,11,6,4,16,2014
277,Jordan Farmar,LAL,41,912,199,478,119,80,61,30,28,27,53,2014
278,Kent Bazemore,LAL,67,911,91,206,67,24,40,15,12,7,17,2014
279,Xavier Henry,LAL,43,908,51,115,38,13,23,5,10,3,10,2014
280,Reggie Evans,SAC,54,899,21,50,13,8,7,2,4,3,5,2014
281,Ray McCallum,SAC,45,897,120,266,94,26,40,13,41,6,20,2014
282,Jermaine O'Neal,GSW,44,884,25,59,16,9,7,3,6,4,5,2014
283,Henry Sims,PHI,46,875,52,119,37,15,27,4,6,3,12,2014
284,Thomas Robinson,POR,70,873,34,80,22,12,12,4,6,4,8,2014
285,Cartier Martin,ATL,59,870,33,79,20,13,9,4,7,6,7,2014
286,Willie Green,LAC,55,869,50,125,25,25,8,2,15,6,19,2014
287,Nate Robinson,DEN,44,866,112,246,90,22,40,21,29,5,17,2014
288,Andrei Kirilenko,BKN,45,857,72,156,60,12,44,11,5,2,10,2014
289,Quincy Acy,SAC,63,848,28,64,20,8,10,2,8,2,6,2014
290,Danny Granger,LAC,41,848,41,97,26,15,14,4,8,7,8,2014
291,Michael Beasley,MIA,55,831,42,100,26,16,17,5,4,8,8,2014
292,Jason Smith,NOP,31,830,29,65,22,7,7,3,12,3,4,2014
293,Gorgui Dieng,MIN,60,818,39,89,28,11,17,2,9,3,8,2014
294,Devin Harris,DAL,40,818,178,418,116,62,66,29,21,15,47,2014
295,Ekpe Udoh,MIL,42,804,31,73,20,11,8,2,10,2,9,2014
296,Ryan Anderson,NOP,22,795,17,38,13,4,7,1,5,2,2,2014
297,Chris Johnson,BOS,40,789,31,72,21,10,6,3,12,1,9,2014
298,Quincy Miller,DEN,52,789,26,62,16,10,9,5,2,2,8,2014
299,Jan Vesely,DEN,54,776,21,47,16,5,12,2,2,2,3,2014
300,Earl Clark,NYK,54,768,18,38,16,2,7,3,6,2,0,2014
301,Perry Jones III,OKC,62,764,26,59,19,7,8,5,6,1,6,2014
302,Chuck Hayes,TOR,61,753,35,83,22,13,13,4,5,3,10,2014
303,Shawne Williams,LAL,36,751,30,78,12,18,4,3,5,4,14,2014
304,Chase Budinger,MIN,41,751,31,70,23,8,15,2,6,1,7,2014
305,Jonas Jerebko,DET,64,741,39,89,28,11,19,3,6,4,7,2014
306,Chris Kaman,LAL,39,736,58,139,35,23,22,3,10,10,13,2014
307,Joel Freeland,POR,52,727,36,94,14,22,7,1,6,5,17,2014
308,Darius Miller,NOP,45,723,43,95,34,9,19,7,8,1,8,2014
309,Doron Lamb,ORL,53,695,43,103,26,17,6,5,15,9,8,2014
310,Matt Bonner,SAS,61,690,31,77,16,15,7,2,7,4,11,2014
311,Jeff Withey,NOP,58,684,26,58,20,6,13,3,4,2,4,2014
312,Toney Douglas,MIA,51,675,68,159,45,23,25,2,18,4,19,2014
313,Alexey Shved,MIN,63,664,68,153,51,17,21,8,22,5,12,2014
314,Anthony Bennett,CLE,52,663,17,37,14,3,7,3,4,0,3,2014
315,Robbie Hummel,MIN,53,655,23,52,17,6,7,2,8,2,4,2014
316,Udonis Haslem,MIA,46,653,13,32,7,6,5,1,1,2,4,2014
317,Beno Udrih,MEM,41,643,116,263,85,31,39,11,35,12,19,2014
318,Jon Leuer,MEM,49,642,20,44,16,4,8,6,2,0,4,2014
319,Dennis Schroder,ATL,49,641,93,210,69,24,36,17,16,9,15,2014
320,Garrett Temple,WAS,75,638,72,173,43,29,21,8,14,9,20,2014
321,Kenyon Martin,NYK,32,633,50,110,40,10,19,5,16,1,9,2014
322,Jeffery Taylor,CHA,26,629,22,49,17,5,9,2,6,2,3,2014
323,Ronny Turiaf,MIN,31,606,24,59,13,11,5,1,7,1,10,2014
324,John Lucas III,UTA,42,591,42,95,31,11,20,8,3,2,9,2014
325,Larry Sanders,MIL,23,584,19,38,19,0,9,1,9,0,0,2014
326,Kevin Seraphin,WAS,53,578,17,42,9,8,5,1,3,1,7,2014
327,Brandon Davies,PHI,51,575,28,64,20,8,13,5,2,2,6,2014
328,Jason Terry,BKN,35,570,56,128,40,16,20,7,13,4,12,2014
329,Nazr Mohammed,CHI,80,562,20,46,14,6,7,0,7,1,5,2014
330,Steve Novak,TOR,54,540,13,32,7,6,6,0,1,2,4,2014
331,Brook Lopez,BKN,17,533,16,41,7,9,4,1,2,4,5,2014
332,Archie Goodwin,PHX,52,533,20,47,13,7,8,1,4,0,7,2014
333,Anthony Randolph,DEN,43,527,32,81,15,17,10,1,4,3,14,2014
334,Jimmer Fredette,CHI,49,519,64,140,52,12,29,8,15,5,7,2014
335,Andrew Bynum,IND,26,516,29,64,23,6,13,5,5,2,4,2014
336,Al Harrington,WAS,34,511,28,64,20,8,13,3,4,2,6,2014
337,Nando De Colo,TOR,47,494,65,152,43,22,24,11,8,9,13,2014
338,Aron Baynes,SAS,53,491,34,77,25,9,10,6,9,3,6,2014
339,Shane Larkin,DAL,48,489,71,165,48,23,16,9,23,5,18,2014
340,Jason Maxiell,ORL,34,488,9,20,7,2,6,0,1,1,1,2014
341,Vitor Faverani,BOS,37,488,16,36,12,4,9,2,1,3,1,2014
342,Ryan Hollins,LAC,61,482,8,18,6,2,5,1,0,1,1,2014
343,CJ McCollum,POR,38,476,27,64,17,10,6,3,8,3,7,2014
344,Luke Babbitt,NOP,27,473,29,68,19,10,14,3,2,3,7,2014
345,Miroslav Raduljica,MIL,48,465,23,49,20,3,12,3,5,0,3,2014
346,Marquis Teague,BKN,40,442,58,140,34,24,18,5,11,7,17,2014
347,Rudy Gobert,UTA,45,434,7,15,6,1,4,0,2,0,1,2014
348,Gustavo Ayon,ATL,26,429,28,65,19,9,12,5,2,2,7,2014
349,Brandon Rush,UTA,38,418,24,56,16,8,7,5,4,5,3,2014
350,Byron Mullens,PHI,45,414,14,36,6,8,3,1,2,2,6,2014
351,Andre Roberson,OKC,40,399,15,31,14,1,6,4,4,0,1,2014
352,Jeremy Tyler,NYK,41,397,8,21,3,5,1,0,2,1,4,2014
353,Reggie Bullock,LAC,43,395,12,27,9,3,5,2,2,1,2,2014
354,Drew Gooden,WAS,22,395,15,33,12,3,10,2,0,1,2,2014
355,Wayne Ellington,DAL,45,393,19,45,12,7,7,3,2,3,4,2014
356,Orlando Johnson,SAC,45,392,20,51,9,11,3,2,4,3,8,2014
357,Donald Sloan,IND,48,392,50,117,33,17,8,7,18,5,12,2014
358,Hedo Turkoglu,LAC,38,392,33,74,25,8,14,4,7,4,4,2014
359,Dewayne Dedmon,ORL,31,390,5,12,3,2,1,0,2,1,1,2014
360,Metta World Peace,NYK,29,388,17,43,8,9,4,2,2,1,8,2014
361,Will Barton,POR,41,387,33,77,22,11,15,3,4,3,8,2014
362,Rasual Butler,IND,50,378,17,39,12,5,8,1,3,2,3,2014
363,Ronnie Price,ORL,31,377,66,143,55,11,19,10,26,4,7,2014
364,Toure' Murry,NYK,51,372,49,110,37,12,26,4,7,0,12,2014
365,Leandro Barbosa,PHX,20,368,32,80,16,16,6,1,9,5,11,2014
366,Alex Len,PHX,41,362,4,10,2,2,1,1,0,1,1,2014
367,Meyers Leonard,POR,40,355,18,43,11,7,4,1,6,1,6,2014
368,Aaron Gray,SAC,36,354,22,48,18,4,14,1,3,0,4,2014
369,Jarvis Varnado,PHI,24,339,13,34,5,8,2,2,1,0,8,2014
370,Cole Aldrich,NYK,46,330,14,33,9,5,6,0,3,2,3,2014
371,Eric Maynor,PHI,31,327,52,124,32,20,16,4,12,6,14,2014
372,Landry Fields,TOR,30,322,20,47,13,7,9,2,2,3,4,2014
373,Otto Porter Jr.,WAS,37,319,10,23,7,3,2,2,3,0,3,2014
374,Josh Harrellson,DET,32,317,15,33,12,3,9,2,1,1,2,2014
375,MarShon Brooks,LAL,35,317,25,58,17,8,11,2,4,3,5,2014
376,Darius Morris,MEM,27,313,44,100,32,12,12,10,10,2,10,2014
377,Steve Nash,LAL,15,313,86,200,58,28,27,18,13,8,20,2014
378,Derrick Rose,CHI,10,311,43,95,34,9,20,6,8,3,6,2014
379,Chauncey Billups,DET,19,309,42,94,32,10,19,6,7,2,8,2014
380,Gal Mekel,DAL,31,292,63,151,38,25,21,11,6,3,22,2014
381,Shabazz Muhammad,MIN,37,290,6,15,3,3,3,0,0,1,2,2014
382,Ben Gordon,CHA,19,279,21,47,16,5,10,2,4,0,5,2014
383,Quincy Pondexter,MEM,15,270,20,43,17,3,8,4,5,1,2,2014
384,Tyshawn Taylor,BKN,23,270,36,86,22,14,19,0,3,2,12,2014
385,Chris Copeland,IND,41,265,18,43,11,7,5,3,3,4,3,2014
386,Roger Mason Jr.,MIA,25,260,19,44,13,6,9,1,3,4,2,2014
387,Isaiah Canaan,HOU,22,252,22,53,13,9,9,4,0,3,6,2014
388,Shannon Brown,NYK,29,251,9,20,7,2,2,2,3,0,2,2014
389,Daniel Orton,PHI,22,251,15,35,10,5,7,1,2,1,4,2014
390,Chris Singleton,WAS,25,250,6,12,6,0,6,0,0,0,0,2014
391,Antawn Jamison,LAC,22,247,7,18,3,4,1,1,1,0,4,2014
392,Jorge Gutierrez,BKN,15,244,30,70,20,10,11,2,7,4,6,2014
393,Jannero Pargo,CHA,29,242,52,127,29,23,18,4,7,6,17,2014
394,Gigi Datome,DET,34,237,11,26,7,4,6,1,0,2,2,2014
395,James Jones,MIA,20,236,9,21,6,3,2,3,1,1,2,2014
396,Carl Landry,SAC,18,233,5,11,4,1,2,0,2,0,1,2014
397,Solomon Hill,IND,28,226,12,30,6,6,1,1,4,1,5,2014
398,Mike Harris,UTA,20,225,5,13,2,3,2,0,0,0,3,2014
399,Peyton Siva,DET,24,224,34,83,19,15,13,1,5,3,12,2014
400,Lorenzo Brown,PHI,26,224,41,96,27,14,21,3,3,2,12,2014
401,Mike Muscala,ATL,20,215,7,16,5,2,2,1,2,2,0,2014
402,Greg Oden,MIA,23,212,1,3,0,1,0,0,0,1,0,2014
403,Dionte Christmas,PHX,31,198,8,19,5,3,4,0,1,0,3,2014
404,Hasheem Thabeet,OKC,23,192,1,2,1,0,1,0,0,0,0,2014
405,Arnett Moultrie,PHI,12,187,2,4,2,0,1,0,1,0,0,2014
406,Joel Anthony,BOS,31,186,2,6,0,2,0,0,0,0,2,2014
407,Lou Amundson,CHI,19,185,6,16,2,4,1,0,1,1,3,2014
408,Victor Claver,POR,21,184,12,27,9,3,9,0,0,1,2,2014
409,Manny Harris,LAL,9,180,11,28,5,6,3,1,1,1,5,2014
410,Charlie Villanueva,DET,20,180,6,15,3,3,3,0,0,2,1,2014
411,Kobe Bryant,LAL,6,177,38,83,31,7,18,7,6,5,2,2014
412,Jason Collins,BKN,22,172,4,9,3,1,2,0,1,0,1,2014
413,Ian Clark,UTA,23,172,15,32,13,2,10,2,1,1,1,2014
414,James Nunnally,PHI,13,165,8,18,6,2,3,1,2,0,2,2014
415,Jamaal Franklin,MEM,21,161,6,15,3,3,1,2,0,1,2,2014
416,Earl Watson,POR,24,161,28,62,22,6,9,8,5,3,3,2014
417,Ronnie Brewer,CHI,24,160,10,26,4,6,2,1,1,3,3,2014
418,John Jenkins,ATL,13,158,11,27,6,5,2,3,1,1,4,2014
419,Sergey Karasev,CLE,22,156,6,12,6,0,3,1,2,0,0,2014
420,Tornike Shengelia,CHI,26,155,14,31,11,3,9,0,2,0,3,2014
421,Austin Daye,SAS,22,148,8,17,7,1,5,2,0,0,1,2014
422,Dwight Buycks,TOR,14,146,10,25,5,5,3,1,1,1,4,2014
423,Bernard James,DAL,30,146,3,8,1,2,0,0,1,0,2,2014
424,Nemanja Nedovic,GSW,24,142,13,32,7,6,1,1,5,2,4,2014
425,Chris Babb,BOS,14,132,3,6,3,0,1,1,1,0,0,2014
426,Chris Wright,MIL,8,125,5,10,5,0,3,1,1,0,0,2014
427,Julyan Stone,TOR,21,120,12,30,6,6,4,1,1,3,3,2014
428,Casper Ware,PHI,9,116,10,21,9,1,4,2,3,1,0,2014
429,Jamaal Tinsley,UTA,8,110,23,47,22,1,13,3,6,0,1,2014
430,Glen Rice,WAS,11,109,7,14,7,0,5,0,2,0,0,2014
431,Stephen Jackson,LAC,9,107,5,12,3,2,3,0,0,0,2,2014
432,Greg Smith,HOU,11,100,0,0,0,0,0,0,0,0,0,2014
433,Allen Crabbe,POR,15,100,6,15,3,3,1,1,1,2,1,2014
434,AJ Price,MIN,28,99,13,30,9,4,2,2,5,1,3,2014
435,Hilton Armstrong,GSW,14,97,5,10,5,0,3,0,2,0,0,2014
436,Shavlik Randolph,PHX,14,95,1,2,1,0,0,1,0,0,0,2014
437,Ognjen Kuzmic,GSW,19,92,2,6,0,2,0,0,0,1,1,2014
438,Solomon Jones,ORL,11,85,2,4,2,0,0,0,2,0,0,2014
439,Jared Cunningham,SAC,13,80,8,19,5,3,1,0,4,1,2,2014
440,JaVale McGee,DEN,5,80,2,4,2,0,2,0,0,0,0,2014
441,Tony Mitchell,DET,21,79,2,5,1,1,1,0,0,0,1,2014
442,Mike James,CHI,11,77,17,36,15,2,7,3,5,0,2,2014
443,Troy Daniels,HOU,5,75,5,13,2,3,0,1,1,2,1,2014
444,Hamady Ndiaye,SAC,14,74,3,7,2,1,0,1,1,1,0,2014
445,Justin Hamilton,MIA,8,72,0,0,0,0,0,0,0,0,0,2014
446,Malcolm Thomas,UTA,8,63,2,5,1,1,0,0,1,0,1,2014
447,Erik Murphy,CHI,24,62,2,4,2,0,1,0,1,0,0,2014
448,Viacheslav Kravtsov,PHX,20,59,1,3,0,1,0,0,0,0,1,2014
449,Keith Bogans,BOS,6,55,3,7,2,1,0,0,2,0,1,2014
450,Damion James,SAS,5,50,3,6,3,0,1,1,1,0,0,2014
451,Othyus Jeffers,MIN,6,47,1,2,1,0,1,0,0,0,0,2014
452,Andris Biedrins,UTA,6,45,0,0,0,0,0,0,0,0,0,2014
453,Lance Thomas,NOP,5,42,3,7,2,1,0,1,1,0,1,2014
454,Carrick Felix,CLE,7,38,4,8,4,0,2,2,0,0,0,2014
455,Adonis Thomas,PHI,6,38,3,6,3,0,1,1,1,0,0,2014
456,Ryan Gomes,OKC,5,34,1,3,0,1,0,0,0,0,1,2014
457,Robert Covington,HOU,7,34,0,0,0,0,0,0,0,0,0,2014
458,Ricky Ledo,DAL,11,33,2,5,1,1,0,1,0,0,1,2014
459,Arinze Onuaku,CLE,5,30,3,6,3,0,1,1,1,0,0,2014
460,James Southerland,NOP,4,30,0,0,0,0,0,0,0,0,0,2014
461,Melvin Ely,NOP,2,27,0,0,0,0,0,0,0,0,0,2014
462,Josh Childress,NOP,4,24,2,4,2,0,1,0,1,0,0,2014
463,Josh Powell,HOU,1,19,0,0,0,0,0,0,0,0,0,2014
464,Reggie Williams,OKC,3,17,1,2,1,0,0,1,0,0,0,2014
465,Darius Johnson-Odom,PHI,3,15,1,2,1,0,1,0,0,0,0,2014
466,Vander Blue,BOS,3,15,1,2,1,0,1,0,0,0,0,2014
467,DJ Stephens,MIL,3,15,0,0,0,0,0,0,0,0,0,2014
468,Seth Curry,CLE,2,13,0,0,0,0,0,0,0,0,0,2014
469,Shane Edwards,CLE,2,12,0,0,0,0,0,0,0,0,0,2014
470,Mustafa Shakur,OKC,3,11,4,10,2,2,1,1,0,2,0,2014
471,Elias Harris,LAL,2,11,1,2,1,0,1,0,0,0,0,2014
472,Sasha Vujacic,LAC,2,10,0,0,0,0,0,0,0,0,0,2014
473,DJ White,CHA,2,10,0,0,0,0,0,0,0,0,0,2014
474,Tony Mitchell,MIL,3,10,1,2,1,0,1,0,0,0,0,2014
475,Maalik Wayns,LAC,2,9,2,6,0,2,0,0,0,2,0,2014
476,Royce White,SAC,3,9,0,0,0,0,0,0,0,0,0,2014
477,Scotty Hopson,CLE,2,7,1,2,1,0,1,0,0,0,0,2014
478,Royal Ivey,OKC,2,5,0,0,0,0,0,0,0,0,0,2014
479,Dexter Pittman,ATL,2,3,0,0,0,0,0,0,0,0,0,2014
480,Chris Smith,NYK,2,2,0,0,0,0,0,0,0,0,0,2014
481,DeAndre Liggins,MIA,1,1,0,0,0,0,0,0,0,0,0,2014
0,Damian Lillard,POR,82,3167,531,1230,363,168,192,29,142,55,113,2013
1,Kevin Durant,OKC,81,3119,374,900,222,152,141,29,52,70,82,2013
2,Monta Ellis,MIL,82,3076,496,1127,361,135,232,58,71,35,100,2013
3,DeMar DeRozan,TOR,82,3013,204,502,110,94,53,24,33,27,67,2013
4,Kobe Bryant,LAL,78,3013,469,1092,315,154,210,46,59,46,108,2013
5,James Harden,HOU,78,2985,455,1098,267,188,205,29,33,75,113,2013
6,Stephen Curry,GSW,78,2983,539,1181,436,103,253,66,117,36,67,2013
7,Paul George,IND,79,2972,327,736,245,82,139,54,52,26,56,2013
8,Klay Thompson,GSW,82,2936,183,401,148,35,96,22,30,10,25,2013
9,Jrue Holiday,PHI,78,2926,625,1414,461,164,214,94,153,68,96,2013
10,O.J. Mayo,DAL,82,2913,361,795,288,73,132,78,78,18,55,2013
11,David Lee,GSW,79,2908,279,685,152,127,81,17,54,43,84,2013
12,Luol Deng,CHI,75,2903,222,489,177,45,114,20,43,11,34,2013
13,Brandon Jennings,MIL,80,2897,521,1165,398,123,219,44,135,40,83,2013
14,Evan Turner,PHI,82,2892,354,779,283,71,150,59,74,20,51,2013
15,LeBron James,MIA,76,2877,551,1298,355,196,219,29,107,104,92,2013
16,Russell Westbrook,OKC,82,2861,607,1350,471,136,251,70,150,41,95,2013
17,Kemba Walker,CHA,82,2859,471,1040,373,98,204,42,127,25,73,2013
18,Deron Williams,BKN,78,2842,604,1356,456,148,271,89,96,58,90,2013
19,Nicolas Batum,POR,73,2807,360,800,280,80,165,52,63,30,50,2013
20,Marc Gasol,MEM,80,2796,318,704,250,68,146,35,69,28,40,2013
21,LaMarcus Aldridge,POR,74,2790,192,474,102,90,66,10,26,24,66,2013
22,Andre Iguodala,DEN,80,2779,433,957,342,91,269,56,17,46,45,2013
23,Chandler Parsons,HOU,76,2758,269,634,173,96,122,20,31,40,56,2013
24,Mike Conley,MEM,80,2757,487,1035,426,61,179,89,158,20,41,2013
25,Al Horford,ATL,74,2757,240,593,127,113,79,15,33,42,71,2013
26,Dwight Howard,LAL,76,2722,108,273,51,57,30,5,16,16,41,2013
27,Greg Monroe,DET,81,2688,281,637,206,75,133,31,42,24,51,2013
28,Rudy Gay,TOR,75,2687,202,443,163,39,80,32,51,12,27,2013
29,Greivis Vasquez,NOH,78,2685,704,1573,539,165,307,95,137,28,137,2013
30,Josh Smith,ATL,76,2683,321,761,202,119,152,15,35,48,71,2013
31,JR Smith,NYK,80,2678,218,539,115,103,75,11,29,39,64,2013
32,Joe Johnson,BKN,72,2642,253,624,135,118,64,31,40,51,67,2013
33,Jeremy Lin,HOU,82,2640,497,1152,339,158,266,38,35,55,103,2013
34,Tayshaun Prince,MEM,82,2632,196,448,140,56,58,34,48,16,40,2013
35,Thaddeus Young,PHI,76,2629,125,283,92,33,50,14,28,14,19,2013
36,Jeff Teague,ATL,80,2628,579,1316,421,158,200,58,163,44,114,2013
37,George Hill,IND,76,2620,355,791,274,81,115,64,95,29,52,2013
38,Zach Randolph,MEM,76,2607,108,242,82,26,46,17,19,3,23,2013
39,Blake Griffin,LAC,80,2599,299,702,195,104,110,33,52,47,57,2013
40,Goran Dragic,PHX,77,2582,569,1250,457,112,214,54,189,41,71,2013
41,Al Jefferson,UTA,78,2578,164,397,95,69,51,15,29,5,64,2013
42,Paul Pierce,BOS,77,2575,370,810,300,70,107,54,139,39,31,2013
43,Tristan Thompson,CLE,82,2564,108,255,69,39,28,14,27,9,30,2013
44,Nikola Vucevic,ORL,77,2559,143,323,106,37,60,16,30,9,28,2013
45,Carlos Boozer,CHI,79,2547,179,396,141,38,89,19,33,9,29,2013
46,Alonzo Gee,CLE,82,2541,133,303,96,37,41,20,35,3,34,2013
47,Metta World Peace,LAL,75,2530,112,264,72,40,47,14,11,14,26,2013
48,Ty Lawson,DEN,73,2513,501,1145,358,143,254,59,45,43,100,2013
49,Ryan Anderson,NOH,81,2503,97,217,74,23,40,16,18,7,16,2013
50,Serge Ibaka,OKC,80,2486,43,106,23,20,15,3,5,7,13,2013
51,Carmelo Anthony,NYK,67,2482,171,442,71,100,54,4,13,31,69,2013
52,Luke Ridnour,MIN,82,2474,311,676,257,54,155,37,65,17,37,2013
53,Omer Asik,HOU,82,2464,75,172,53,22,38,4,11,10,12,2013
54,Chris Bosh,MIA,74,2454,123,288,81,42,54,7,20,12,30,2013
55,David West,IND,73,2436,213,502,137,76,98,22,17,24,52,2013
56,Joakim Noah,CHI,66,2426,262,573,213,49,130,26,57,12,37,2013
57,Wesley Matthews,POR,69,2403,174,391,131,43,61,19,51,15,28,2013
58,Dwyane Wade,MIA,69,2391,352,804,252,100,165,23,64,44,56,2013
59,JJ Redick,MIL,78,2380,296,663,225,71,125,44,56,27,44,2013
60,Paul Millsap,UTA,78,2375,201,485,118,83,63,15,40,29,54,2013
61,Darren Collison,DAL,81,2372,415,948,297,118,125,66,106,30,88,2013
62,Brandon Knight,DET,75,2365,303,663,246,57,148,32,66,15,42,2013
63,Jarrett Jack,GSW,79,2349,439,1005,312,127,134,52,126,45,82,2013
64,Chris Paul,LAC,70,2335,678,1542,492,186,312,58,122,71,115,2013
65,Amir Johnson,TOR,81,2325,122,265,101,21,64,10,27,7,14,2013
66,JJ Hickson,POR,80,2323,88,212,52,36,32,6,14,8,28,2013
67,Raymond Felton,NYK,68,2313,372,924,192,180,137,12,43,49,131,2013
68,Danilo Gallinari,DEN,71,2309,176,391,137,39,91,27,19,12,27,2013
69,Arron Afflalo,ORL,64,2307,206,474,144,62,63,21,60,16,46,2013
70,Kyle Singler,DET,82,2293,77,177,54,23,31,11,12,5,18,2013
71,DeMarcus Cousins,SAC,75,2290,199,465,132,67,89,16,27,29,38,2013
72,Jason Thompson,SAC,82,2285,84,193,59,25,43,7,9,7,18,2013
73,John Salmons,SAC,76,2278,226,508,170,56,96,38,36,22,34,2013
74,Lance Stephenson,IND,78,2278,223,515,154,69,80,35,39,21,48,2013
75,Roy Hibbert,IND,79,2269,113,259,80,33,57,13,10,10,23,2013
76,Kyle Korver,ATL,74,2259,146,325,113,33,64,21,28,14,19,2013
77,Brook Lopez,BKN,74,2254,70,173,37,33,28,1,8,12,21,2013
78,Jeff Green,BOS,81,2251,128,309,75,53,37,13,25,27,26,2013
79,Randy Foye,UTA,82,2249,167,365,136,31,59,22,55,14,17,2013
80,Kenneth Faried,DEN,80,2248,77,176,55,22,43,7,5,11,11,2013
81,Brandon Bass,BOS,81,2240,84,196,56,28,16,6,34,8,20,2013
82,Spencer Hawes,PHI,82,2233,183,399,150,33,71,27,52,15,18,2013
83,Jamal Crawford,LAC,76,2230,193,421,158,35,119,20,19,16,19,2013
84,Thabo Sefolosha,OKC,81,2229,125,276,99,26,48,11,40,7,19,2013
85,Danny Green,SAS,80,2200,141,305,118,23,54,26,38,11,12,2013
86,Martell Webster,WAS,76,2200,143,322,107,36,50,15,42,21,15,2013
87,Bismack Biyombo,CHA,80,2186,35,75,30,5,17,3,10,1,4,2013
88,Luis Scola,PHX,82,2184,182,410,136,46,65,18,53,14,32,2013
89,Tony Parker,SAS,66,2174,499,1168,329,170,186,44,99,75,95,2013
90,Rodney Stuckey,DET,76,2171,270,623,187,83,120,27,40,26,57,2013
91,Jared Dudley,PHX,79,2170,203,435,174,29,91,26,57,10,19,2013
92,Tyson Chandler,NYK,66,2164,62,146,40,22,22,3,15,4,18,2013
93,Jose Calderon,DET,73,2159,518,1127,427,91,214,79,134,28,63,2013
94,Andre Miller,DEN,82,2151,484,1044,408,76,325,40,43,30,46,2013
95,Kevin Martin,OKC,77,2136,106,238,80,26,40,14,26,9,17,2013
96,Robin Lopez,NOH,82,2136,64,144,48,16,27,6,15,1,15,2013
97,Jimmy Butler,CHI,82,2133,115,256,89,26,59,14,16,5,21,2013
98,Gerald Henderson,CHA,68,2133,177,409,122,55,65,23,34,17,38,2013
99,Jason Terry,BOS,79,2124,198,442,152,46,71,24,57,20,26,2013
100,Isaiah Thomas,SAC,79,2121,316,719,229,87,117,41,71,19,68,2013
101,Tony Allen,MEM,79,2109,98,217,77,21,55,8,14,14,7,2013
102,Gordon Hayward,UTA,72,2104,213,474,165,48,76,35,54,13,35,2013
103,Vince Carter,DAL,81,2093,194,431,151,43,75,40,36,13,30,2013
104,Nate Robinson,CHI,82,2086,358,777,297,61,126,36,135,17,44,2013
105,Tim Duncan,SAS,69,2078,184,403,149,35,104,22,23,12,23,2013
106,Gerald Wallace,BKN,69,2076,181,414,129,52,77,22,30,22,30,2013
107,Mario Chalmers,MIA,77,2068,273,606,213,60,121,21,71,26,34,2013
108,Al-Farouq Aminu,NOH,76,2066,103,239,70,33,32,14,24,7,26,2013
109,Matt Barnes,LAC,80,2058,123,281,88,35,66,9,13,11,24,2013
110,Harrison Barnes,GSW,81,2058,98,227,67,31,23,11,33,12,19,2013
111,Emeka Okafor,WAS,79,2052,93,222,57,36,25,7,25,13,23,2013
112,Kyrie Irving,CLE,59,2048,350,768,282,68,157,58,67,26,42,2013
113,Jason Kidd,NYK,76,2043,249,600,147,102,91,13,43,23,79,2013
114,Ray Allen,MIA,79,2035,135,319,86,49,53,10,23,29,20,2013
115,Andrei Kirilenko,MIN,64,2034,177,368,163,14,105,21,37,5,9,2013
116,Tyler Zeller,CLE,77,2033,96,224,64,32,32,18,14,5,27,2013
117,Michael Kidd-Gilchrist,CHA,78,2025,117,272,79,38,44,11,24,11,27,2013
118,Kevin Garnett,BOS,68,2022,159,363,114,45,72,5,37,17,28,2013
119,Kyle Lowry,TOR,68,2020,435,965,340,95,183,67,90,23,72,2013
120,Tyreke Evans,SAC,65,2016,229,525,162,67,72,38,52,25,42,2013
121,Ersan Ilyasova,MIL,73,2012,117,273,78,39,42,16,20,17,22,2013
122,Shawn Marion,DAL,67,2010,163,383,106,57,36,20,50,9,48,2013
123,DeAndre Jordan,LAC,82,2010,28,61,23,5,18,1,4,3,2,2013
124,Dante Cunningham,MIN,80,2010,67,158,43,24,19,9,15,10,14,2013
125,Corey Brewer,DEN,82,2002,124,263,109,15,94,6,9,7,8,2013
126,Tiago Splitter,SAS,81,1997,130,291,99,31,71,11,17,9,22,2013
127,Jameer Nelson,ORL,56,1977,413,912,327,86,161,64,102,29,57,2013
128,Maurice Harkless,ORL,76,1974,50,111,39,11,17,7,15,4,7,2013
129,Reggie Evans,BKN,80,1967,43,99,30,13,17,7,6,6,7,2013
130,Nikola Pekovic,MIN,62,1960,53,123,36,17,16,1,19,3,14,2013
131,Kendrick Perkins,OKC,78,1954,111,246,87,24,60,5,22,5,19,2013
132,Mike Dunleavy,MIL,75,1942,145,320,115,30,66,22,27,7,23,2013
133,Courtney Lee,BOS,78,1941,143,322,107,36,49,11,47,13,23,2013
134,Larry Sanders,MIL,71,1938,83,187,62,21,30,5,27,7,14,2013
135,Derrick Williams,MIN,78,1916,46,112,26,20,11,2,13,8,12,2013
136,PJ Tucker,PHX,79,1910,109,244,83,26,36,10,37,12,14,2013
137,Marco Belinelli,CHI,73,1882,148,333,111,37,47,27,37,10,27,2013
138,Caron Butler,LAC,78,1879,78,182,52,26,28,10,14,16,10,2013
139,Carl Landry,GSW,81,1876,65,152,43,22,17,8,18,4,18,2013
140,Marcin Gortat,PHX,61,1876,75,166,59,16,35,3,21,9,7,2013
141,Anthony Davis,NOH,64,1846,63,144,45,18,29,6,10,10,8,2013
142,Alexey Shved,MIN,77,1839,286,636,222,64,125,26,71,25,39,2013
143,Markieff Morris,PHX,82,1837,108,238,86,22,52,12,22,9,13,2013
144,Kosta Koufos,DEN,81,1817,32,77,19,13,10,4,5,4,9,2013
145,Kawhi Leonard,SAS,58,1810,93,213,66,27,33,17,16,11,16,2013
146,Jason Maxiell,DET,72,1789,54,128,34,20,25,3,6,4,16,2013
147,Derrick Favors,UTA,77,1787,75,168,57,18,28,11,18,3,15,2013
148,Shane Battier,MIA,72,1786,72,169,47,25,28,10,9,13,12,2013
149,Dorell Wright,PHI,79,1783,150,333,117,33,47,27,43,10,23,2013
150,Patrick Patterson,SAC,71,1775,81,199,44,37,34,8,2,7,30,2013
151,Jerryd Bayless,MEM,80,1765,264,596,196,68,67,39,90,29,39,2013
152,Kirk Hinrich,CHI,60,1764,314,679,263,51,96,45,122,14,37,2013
153,Dion Waiters,CLE,61,1756,183,411,138,45,59,37,42,17,28,2013
154,Bradley Beal,WAS,56,1745,137,311,100,37,39,28,33,17,20,2013
155,Marvin Williams,UTA,73,1727,77,167,64,13,29,14,21,4,9,2013
156,Marcus Thornton,SAC,72,1726,91,203,70,21,52,8,10,4,17,2013
157,Kevin Seraphin,WAS,79,1721,57,146,25,32,12,3,10,13,19,2013
158,J.J. Barea,MIN,74,1713,294,655,227,67,105,29,93,16,51,2013
159,Boris Diaw,SAS,75,1709,180,416,124,56,68,26,30,18,38,2013
160,Jordan Crawford,BOS,70,1708,225,489,186,39,90,38,58,19,20,2013
161,Ricky Rubio,MIN,57,1691,418,897,357,61,213,29,115,22,39,2013
162,Carlos Delfino,HOU,67,1689,135,327,78,57,57,11,10,22,35,2013
163,E'Twaun Moore,ORL,75,1682,206,448,170,36,71,36,63,13,23,2013
164,Lavoy Allen,PHI,79,1669,73,159,60,13,27,8,25,4,9,2013
165,Jodie Meeks,LAL,78,1663,69,158,49,20,28,9,12,7,13,2013
166,Dirk Nowitzki,DAL,53,1662,132,293,103,29,57,23,23,12,17,2013
167,Wayne Ellington,CLE,78,1661,104,234,78,26,35,15,28,6,20,2013
168,Nene,WAS,61,1659,177,402,129,48,74,25,30,27,21,2013
169,Pau Gasol,LAL,49,1655,200,464,136,64,104,8,24,22,42,2013
170,Ramon Sessions,CHA,61,1652,230,532,158,72,80,23,55,30,42,2013
171,Steve Novak,NYK,81,1641,35,91,14,21,4,2,8,6,15,2013
172,Antawn Jamison,LAL,76,1636,50,115,35,15,18,7,10,7,8,2013
173,Ed Davis,MEM,81,1631,63,147,42,21,25,2,15,4,17,2013
174,Steve Nash,LAL,50,1627,333,747,252,81,148,42,62,23,58,2013
175,Lamar Odom,LAC,82,1616,142,327,99,43,65,18,16,18,25,2013
176,John Wall,WAS,49,1602,373,864,255,118,123,46,86,60,58,2013
177,Norris Cole,MIA,80,1590,164,385,107,57,68,17,22,29,28,2013
178,Nick Collison,OKC,81,1583,121,289,74,47,49,7,18,8,39,2013
179,Ben Gordon,CHA,75,1560,141,312,111,30,75,14,22,5,25,2013
180,Andray Blatche,BKN,82,1555,85,206,49,36,30,4,15,18,18,2013
181,Michael Beasley,PHX,75,1554,111,243,90,21,51,15,24,8,13,2013
182,Eric Bledsoe,LAC,76,1553,233,531,168,65,106,24,38,25,40,2013
183,Elton Brand,DAL,72,1527,70,169,41,29,20,6,15,7,22,2013
184,Marcus Morris,PHX,77,1524,62,146,40,22,29,3,8,10,12,2013
185,C.J. Watson,BKN,80,1521,161,373,110,51,52,17,41,28,23,2013
186,Jeffery Taylor,CHA,77,1507,63,149,40,23,18,7,15,1,22,2013
187,Alan Anderson,TOR,65,1495,103,231,78,25,43,19,16,9,16,2013
188,Josh McRoberts,CHA,67,1487,141,310,113,28,72,10,31,7,21,2013
189,Gary Neal,SAS,68,1484,129,305,82,47,45,15,22,13,34,2013
190,Jonas Valanciunas,TOR,62,1482,45,100,35,10,15,5,15,0,10,2013
191,Trevor Ariza,WAS,56,1471,113,254,85,28,54,16,15,9,19,2013
192,Taj Gibson,CHI,65,1459,61,138,45,16,18,6,21,2,14,2013
193,Beno Udrih,ORL,66,1457,302,675,231,71,113,46,72,26,45,2013
194,Shaun Livingston,CLE,66,1455,215,484,161,54,67,31,63,15,39,2013
195,Avery Bradley,BOS,50,1435,104,239,73,31,36,8,29,9,22,2013
196,JaVale McGee,DEN,79,1434,24,51,21,3,16,3,2,1,2,2013
197,Byron Mullens,CHA,53,1428,81,173,70,11,35,11,24,2,9,2013
198,Rajon Rondo,BOS,38,1423,420,922,338,82,163,39,136,30,52,2013
199,Devin Harris,ATL,58,1421,197,455,136,61,74,18,44,27,34,2013
200,Mo Williams,UTA,46,1418,285,630,225,60,102,54,69,14,46,2013
201,Austin Rivers,NOH,61,1418,127,299,82,45,34,9,39,10,35,2013
202,Udonis Haslem,MIA,75,1414,38,93,21,17,10,4,7,8,9,2013
203,Nick Young,PHI,59,1411,84,188,64,20,29,8,27,6,14,2013
204,Keith Bogans,BKN,74,1408,76,171,57,19,21,17,19,8,11,2013
205,Shannon Brown,PHX,59,1402,108,246,78,30,31,13,34,12,18,2013
206,Manu Ginobili,SAS,60,1393,274,626,196,78,135,29,32,45,33,2013
207,Tyler Hansbrough,IND,81,1365,36,81,27,9,17,7,3,1,8,2013
208,CJ Miles,CLE,65,1364,63,140,49,14,26,11,12,3,11,2013
209,Chris Kaman,DAL,66,1363,51,117,36,15,19,5,12,3,12,2013
210,Earl Clark,LAL,59,1363,65,163,32,33,27,3,2,13,20,2013
211,Jae Crowder,DAL,78,1353,94,213,69,25,33,13,23,6,19,2013
212,Luc Mbah a Moute,MIL,58,1326,55,128,37,18,23,6,8,4,14,2013
213,Brian Roberts,NOH,78,1324,219,512,145,74,66,17,62,15,59,2013
214,Ian Mahinmi,IND,80,1322,27,66,15,12,8,1,6,2,10,2013
215,Ekpe Udoh,MIL,76,1312,43,97,32,11,10,9,13,3,8,2013
216,Marreese Speights,CLE,79,1300,47,106,35,12,17,9,9,4,8,2013
217,Tobias Harris,ORL,55,1299,69,150,57,12,33,8,16,5,7,2013
218,Toney Douglas,SAC,71,1288,151,357,96,55,59,12,25,18,37,2013
219,AJ Price,WAS,57,1278,205,457,158,47,64,28,66,23,24,2013
220,Eric Gordon,NOH,42,1264,137,310,101,36,56,21,24,12,24,2013
221,Pablo Prigioni,NYK,78,1263,236,580,128,108,75,9,44,26,82,2013
222,Andrew Nicholson,ORL,75,1249,44,102,30,14,11,7,12,3,11,2013
223,Quincy Pondexter,MEM,59,1243,61,139,44,17,25,10,9,6,11,2013
224,Andre Drummond,DET,60,1243,30,64,26,4,17,4,5,0,4,2013
225,Terrence Ross,TOR,73,1239,53,126,33,20,18,8,7,8,12,2013
226,D.J. Augustin,IND,76,1226,170,383,127,43,48,19,60,18,25,2013
227,Jamaal Tinsley,UTA,66,1221,290,651,219,71,122,36,61,20,51,2013
228,Will Bynum,DET,65,1219,231,536,157,74,122,16,19,24,50,2013
229,Roger Mason Jr.,NOH,69,1218,74,165,57,17,30,11,16,4,13,2013
230,Greg Stiemsma,MIN,76,1209,30,62,28,2,19,1,8,1,1,2013
231,Chuck Hayes,SAC,74,1209,112,252,84,28,59,7,18,12,16,2013
232,Meyers Leonard,POR,69,1206,33,81,18,15,8,4,6,4,11,2013
233,Kris Humphries,BKN,65,1191,32,79,17,15,6,2,9,6,9,2013
234,Willie Green,LAC,72,1188,55,130,35,20,20,2,13,7,13,2013
235,Steve Blake,LAL,45,1175,173,396,123,50,78,15,30,13,37,2013
236,Brendan Haywood,CHA,61,1162,29,64,23,6,10,5,8,1,5,2013
237,DeShawn Stevenson,ATL,56,1158,52,113,43,9,24,3,16,4,5,2013
238,Garrett Temple,WAS,51,1155,115,262,83,32,37,16,30,16,16,2013
239,Brandan Wright,DAL,64,1149,38,84,30,8,12,6,12,3,5,2013
240,Alec Burks,UTA,64,1137,92,199,77,15,37,14,26,4,11,2013
241,Zaza Pachulia,ATL,52,1134,79,178,59,20,35,8,16,6,14,2013
242,Festus Ezeli,GSW,78,1120,22,57,9,13,3,1,5,4,9,2013
243,Lou Williams,ATL,39,1119,139,317,100,39,45,11,44,13,26,2013
244,DeMarre Carroll,UTA,66,1111,61,135,48,13,32,4,12,5,8,2013
245,Greg Smith,HOU,70,1110,25,63,12,13,10,1,1,1,12,2013
246,Damien Wilkins,PHI,61,1095,91,209,64,27,24,17,23,6,21,2013
247,Charlie Villanueva,DET,69,1092,54,125,37,17,25,5,7,8,9,2013
248,Richard Hamilton,CHI,50,1088,119,261,96,23,68,8,20,8,15,2013
249,Marquis Daniels,MIL,59,1085,65,153,42,23,26,4,12,8,15,2013
250,Gerald Green,IND,60,1080,50,116,34,16,14,5,15,3,13,2013
251,Wilson Chandler,DEN,43,1079,58,143,31,27,24,3,4,13,14,2013
252,Enes Kanter,UTA,70,1078,31,69,24,7,9,4,11,1,6,2013
253,Stephen Jackson,SAS,55,1075,80,179,61,19,40,8,13,5,14,2013
254,Glen Davis,ORL,34,1064,70,161,49,21,26,4,19,7,14,2013
255,Draymond Green,GSW,79,1061,53,118,41,12,22,8,11,5,7,2013
256,Thomas Robinson,HOU,70,1056,46,107,31,15,23,6,2,7,8,2013
257,Landry Fields,TOR,51,1037,60,143,37,23,21,8,8,8,15,2013
258,Ivan Johnson,ATL,69,1035,46,107,31,15,21,1,9,3,12,2013
259,Francisco Garcia,HOU,58,1029,63,145,44,19,28,7,9,7,12,2013
260,Jermaine O'Neal,PHX,55,1029,42,95,31,11,21,2,8,2,9,2013
261,Dahntay Jones,ATL,78,1016,48,105,39,9,17,8,14,3,6,2013
262,Andrea Bargnani,TOR,35,1003,38,87,27,11,14,9,4,2,9,2013
263,Aaron Brooks,HOU,53,997,114,258,84,30,46,15,23,8,22,2013
264,Iman Shumpert,NYK,45,996,75,185,40,35,27,1,12,6,29,2013
265,Reggie Jackson,OKC,70,992,122,282,84,38,44,14,26,14,24,2013
266,Sebastian Telfair,TOR,59,980,153,335,124,29,69,14,41,5,24,2013
267,Darrell Arthur,MEM,59,970,33,72,27,6,14,5,8,0,6,2013
268,Jimmer Fredette,SAC,69,966,92,214,62,30,38,8,16,8,22,2013
269,Anthony Tolliver,ATL,62,963,32,70,26,6,13,4,9,1,5,2013
270,Eric Maynor,POR,64,963,182,415,131,51,85,11,35,17,34,2013
271,Wesley Johnson,PHX,50,953,34,75,27,7,13,6,8,3,4,2013
272,Jason Richardson,PHI,33,936,51,113,40,11,13,4,23,5,6,2013
273,Chris Singleton,WAS,57,924,37,87,24,13,9,5,10,3,10,2013
274,Nando De Colo,SAS,72,920,138,326,88,50,51,11,26,28,22,2013
275,Daniel Gibson,CLE,46,919,82,189,57,25,27,12,18,8,17,2013
276,MarShon Brooks,BKN,73,912,76,178,50,26,28,10,12,12,14,2013
277,Matt Bonner,SAS,68,909,36,88,20,16,9,6,5,5,11,2013
278,John Jenkins,ATL,61,902,56,126,42,14,24,7,11,4,10,2013
279,Anderson Varejao,CLE,25,901,84,200,52,32,34,8,10,4,28,2013
280,Mike Miller,MIA,59,900,99,229,68,31,44,10,14,12,19,2013
281,Will Barton,POR,73,894,58,128,46,12,27,5,14,3,9,2013
282,Jared Sullinger,BOS,45,892,35,81,24,11,7,3,14,5,6,2013
283,Jonas Jerebko,DET,49,892,43,95,34,9,29,2,3,3,6,2013
284,Trevor Booker,WAS,48,887,40,93,27,13,13,3,11,7,6,2013
285,James Johnson,SAC,54,878,58,136,38,20,20,6,12,9,11,2013
286,Jason Smith,NOH,51,876,34,78,24,10,7,9,8,2,8,2013
287,Mike James,DAL,45,862,139,319,98,41,35,20,43,11,30,2013
288,Chris Copeland,NYK,56,862,27,68,13,14,6,3,4,8,6,2013
289,Luke Walton,CLE,50,857,166,363,135,31,77,25,33,7,24,2013
290,Ronnie Brewer,OKC,60,852,50,119,31,19,13,8,10,4,15,2013
291,DeJuan Blair,SAS,61,851,45,103,32,13,26,1,5,7,6,2013
292,Chris Wilcox,BOS,61,830,22,49,17,5,9,0,8,0,5,2013
293,Earl Watson,UTA,48,829,190,401,169,21,95,30,44,3,18,2013
294,John Henson,MIL,63,827,31,68,25,6,10,3,12,0,6,2013
295,John Lucas III,TOR,63,827,105,249,66,39,29,13,24,8,31,2013
296,Chris Duhon,LAL,46,820,133,316,83,50,46,14,23,17,33,2013
297,Victor Claver,POR,49,812,43,94,35,8,15,11,9,4,4,2013
298,DeQuan Jones,ORL,63,803,16,34,14,2,6,2,6,0,2,2013
299,Rashard Lewis,MIA,55,792,30,71,19,11,8,2,9,5,6,2013
300,Andrew Bogut,GSW,32,786,67,150,51,16,34,3,14,1,15,2013
301,Hasheem Thabeet,OKC,66,770,11,25,8,3,3,2,3,0,3,2013
302,Samuel Dalembert,MIL,47,765,21,44,19,2,12,2,5,0,2,2013
303,Gustavo Ayon,MIL,54,735,71,154,59,12,43,9,7,2,10,2013
304,Luke Babbitt,POR,62,730,29,73,14,15,4,3,7,4,11,2013
305,Jeff Adrien,CHA,52,713,36,80,28,8,18,3,7,3,5,2013
306,Patrick Beverley,HOU,41,712,117,290,61,56,41,13,7,24,32,2013
307,Kendall Marshall,PHX,48,702,143,330,99,44,41,18,40,14,30,2013
308,Ronny Turiaf,LAC,65,701,35,78,27,8,19,3,5,0,8,2013
309,Royal Ivey,PHI,53,698,32,72,24,8,9,5,10,2,6,2013
310,Darius Miller,NOH,52,694,44,100,32,12,18,3,11,2,10,2013
311,Cartier Martin,WAS,41,694,20,44,16,4,5,5,6,1,3,2013
312,Nazr Mohammed,CHI,63,693,26,61,17,9,10,4,3,3,6,2013
313,Sam Young,IND,56,693,42,102,24,18,12,8,4,4,14,2013
314,Darius Morris,LAL,48,683,76,189,39,37,15,6,18,9,28,2013
315,Amar'e Stoudemire,NYK,29,682,13,33,6,7,1,1,4,2,5,2013
316,Austin Daye,MEM,55,675,42,98,28,14,18,6,4,7,7,2013
317,Ryan Hollins,LAC,60,663,11,25,8,3,3,1,4,1,2,2013
318,Patty Mills,SAS,58,656,62,144,42,20,20,9,13,6,14,2013
319,Jeremy Pargo,PHI,39,655,92,218,58,34,24,9,25,13,21,2013
320,Lance Thomas,NOH,59,646,17,38,13,4,6,2,5,2,2,2013
321,Mickael Gelabale,MIN,36,644,26,58,20,6,6,1,13,2,4,2013
322,Kyle O'Quinn,ORL,57,638,52,110,46,6,38,5,3,3,3,2013
323,Xavier Henry,NOH,50,625,13,29,10,3,6,0,4,1,2,2013
324,Chris Andersen,MIA,42,624,17,42,9,8,6,1,2,6,2,2013
325,Orlando Johnson,IND,51,619,47,113,28,19,11,5,12,6,13,2013
326,Kevin Love,MIN,18,618,42,94,32,10,16,6,10,2,8,2013
327,Jan Vesely,WAS,50,601,28,62,22,6,8,8,6,4,2,2013
328,Doron Lamb,ORL,47,578,32,70,26,6,9,8,9,2,4,2013
329,Derek Fisher,OKC,33,575,47,104,37,10,18,8,11,2,8,2013
330,Richard Jefferson,GSW,56,568,31,66,27,4,13,7,7,0,4,2013
331,Joel Anthony,MIA,62,566,13,36,3,10,2,0,1,5,5,2013
332,Rodrigue Beaubois,DAL,45,549,84,192,60,24,20,17,23,5,19,2013
333,Jerry Stackhouse,BKN,37,544,35,85,20,15,9,6,5,6,9,2013
334,Arnett Moultrie,PHI,47,542,10,23,7,3,7,0,0,2,1,2013
335,Donatas Motiejunas,HOU,44,537,31,77,16,15,11,2,3,5,10,2013
336,Sasha Pavlovic,POR,39,528,32,75,21,11,12,3,6,4,7,2013
337,Ish Smith,MIL,52,516,87,201,60,27,29,6,25,3,24,2013
338,Aaron Gray,TOR,42,513,33,75,24,9,16,1,7,1,8,2013
339,Leandro Barbosa,BOS,41,513,58,125,49,9,19,8,22,3,6,2013
340,Ronnie Price,POR,39,510,73,170,49,24,25,1,23,8,16,2013
341,Chase Budinger,MIN,23,508,25,54,21,4,9,1,11,0,4,2013
342,Jannero Pargo,CHA,32,507,67,152,49,18,25,9,15,5,13,2013
343,Omri Casspi,CLE,43,503,28,63,21,7,10,4,7,1,6,2013
344,Mirza Teletovic,BKN,53,499,23,58,11,12,9,0,2,9,3,2013
345,Andris Biedrins,GSW,53,495,14,31,11,3,4,2,5,1,2,2013
346,Hakim Warrick,CHA,28,489,25,54,21,4,13,3,5,2,2,2013
347,Joel Freeland,POR,51,477,13,29,10,3,6,2,2,2,1,2013
348,Khris Middleton,DET,27,475,28,64,20,8,13,2,5,3,5,2013
349,Jordan Hill,LAL,29,458,13,32,7,6,2,3,2,2,4,2013
350,Bernard James,DAL,46,457,6,13,5,1,0,0,5,0,1,2013
351,Travis Outlaw,SAC,38,444,21,49,14,7,9,3,2,4,3,2013
352,Daequan Cook,CHI,49,441,19,45,12,7,8,3,1,5,2,2013
353,Charles Jenkins,PHI,59,441,44,100,32,12,12,5,15,5,7,2013
354,Grant Hill,LAC,29,437,26,60,18,8,8,4,6,2,6,2013
355,James White,NYK,57,435,29,73,14,15,6,0,8,5,10,2013
356,Kenyon Martin,NYK,18,431,8,21,3,5,2,0,1,1,4,2013
357,Evan Fournier,DEN,38,428,44,96,36,8,26,5,5,4,4,2013
358,Chauncey Billups,LAC,22,418,49,108,39,10,23,8,8,7,3,2013
359,Shelvin Mack,ATL,31,416,68,147,57,11,27,7,23,4,7,2013
360,Kim English,DET,41,407,26,59,19,7,14,1,4,1,6,2013
361,James Anderson,HOU,39,401,42,106,20,22,15,0,5,8,14,2013
362,Jordan Hamilton,DEN,40,397,23,51,18,5,14,4,0,2,3,2013
363,Kurt Thomas,NYK,39,392,21,51,12,9,5,0,7,4,5,2013
364,Marquis Teague,CHI,48,392,63,138,51,12,24,5,22,6,6,2013
365,Cory Joseph,SAS,28,388,53,116,43,10,19,11,13,4,6,2013
366,Cole Aldrich,SAC,45,388,9,22,5,4,2,1,2,0,4,2013
367,Dominic McGuire,IND,26,387,20,45,15,5,4,3,8,1,4,2013
368,Mickael Pietrus,TOR,19,386,9,22,5,4,3,1,1,0,4,2013
369,Jason Collins,WAS,38,385,8,19,5,3,1,1,3,1,2,2013
370,Anthony Morrow,DAL,41,383,13,31,8,5,2,0,6,2,3,2013
371,Reggie Williams,CHA,40,380,39,89,28,11,11,6,11,5,6,2013
372,Linas Kleiza,TOR,20,376,16,39,9,7,3,3,3,1,6,2013
373,Mike Scott,ATL,40,376,12,30,6,6,3,0,3,1,5,2013
374,Lou Amundson,NOH,39,371,11,22,11,0,4,0,7,0,0,2013
375,Jeff Ayres,IND,37,369,15,35,10,5,6,4,0,1,4,2013
376,Timofey Mozgov,DEN,40,366,9,22,5,4,4,0,1,2,2,2013
377,Tyrus Thomas,CHA,26,360,19,43,14,5,8,4,2,0,5,2013
378,Johan Petro,ATL,31,352,16,36,12,4,7,2,3,2,2,2013
379,Jared Jeffries,POR,38,350,14,35,7,7,5,1,1,1,6,2013
380,Quincy Acy,TOR,29,342,11,29,4,7,4,0,0,2,5,2013
381,Dominique Jones,DAL,29,338,83,201,48,35,22,9,17,10,25,2013
382,Kevin Jones,CLE,32,334,10,23,7,3,3,0,4,1,2,2013
383,Anthony Randolph,DEN,39,329,12,27,9,3,5,2,2,1,2,2013
384,Hamed Haddadi,PHX,30,322,12,24,12,0,6,2,4,0,0,2013
385,Terrence Williams,BOS,24,318,38,94,20,18,12,1,7,6,12,2013
386,Rasheed Wallace,NYK,21,296,6,14,4,2,4,0,0,1,1,2013
387,DeAndre Liggins,OKC,39,290,15,34,11,4,9,1,1,0,4,2013
388,Malcolm Lee,MIN,16,289,20,46,14,6,6,2,6,1,5,2013
389,Nolan Smith,POR,40,288,35,78,27,8,14,3,10,3,5,2013
390,Chris Johnson,MIN,30,284,8,18,6,2,4,0,2,1,1,2013
391,Perry Jones III,OKC,38,280,10,24,6,4,2,2,2,1,3,2013
392,Terrence Jones,HOU,19,276,15,36,9,6,3,1,5,2,4,2013
393,Tony Wroten,MEM,35,272,43,91,38,5,25,3,10,4,1,2013
394,Kwame Brown,PHI,22,270,9,19,8,1,2,3,3,0,1,2013
395,Kent Bazemore,GSW,61,266,22,47,19,3,9,3,7,1,2,2013
396,Donald Sloan,NOH,23,263,38,91,23,15,11,2,10,2,13,2013
397,Corey Maggette,DET,18,257,19,47,10,9,8,1,1,4,5,2013
398,Troy Murphy,DAL,14,256,7,18,3,4,1,2,0,0,4,2013
399,Marcus Camby,NYK,24,250,14,29,13,1,10,0,3,1,0,2013
400,DeSagana Diop,CHA,22,226,13,27,12,1,6,0,6,0,1,2013
401,Viacheslav Kravtsov,DET,25,224,9,23,4,5,3,1,0,0,5,2013
402,James Jones,MIA,38,221,13,35,4,9,3,0,1,3,6,2013
403,Tyshawn Taylor,BKN,38,220,21,50,13,8,9,1,3,5,3,2013
404,Jeremy Evans,UTA,37,215,11,26,7,4,4,2,1,0,4,2013
405,Josh Howard,MIN,11,207,4,8,4,0,2,0,2,0,0,2013
406,Robert Sacre,LAL,32,203,6,14,4,2,3,0,1,1,1,2013
407,Maalik Wayns,LAC,27,202,27,66,15,12,7,2,6,2,10,2013
408,Ben Hansbrough,IND,28,200,21,46,17,4,8,3,6,1,3,2013
409,Shavlik Randolph,BOS,16,198,4,10,2,2,0,1,1,2,0,2013
410,Devin Ebanks,LAL,19,197,10,25,5,5,3,1,1,2,3,2013
411,Samardo Samuels,CLE,18,196,8,21,3,5,1,0,2,0,5,2013
412,Hedo Turkoglu,ORL,11,189,23,51,18,5,7,4,7,0,5,2013
413,Jon Leuer,MEM,28,186,8,19,5,3,2,1,2,1,2,2013
414,Earl Barron,NYK,12,158,5,12,3,2,2,0,1,1,1,2013
415,Drew Gooden,MIL,16,151,6,14,4,2,3,1,0,1,1,2013
416,Diante Garrett,PHX,19,149,31,71,22,9,9,3,10,3,6,2013
417,Jeremy Lamb,OKC,23,147,5,11,4,1,2,1,1,0,1,2013
418,Vladimir Radmanovic,CHI,25,144,8,20,4,4,4,0,0,2,2,2013
419,Justin Holiday,PHI,9,142,15,31,14,1,5,2,7,0,1,2013
420,Aron Baynes,SAS,16,141,5,11,4,1,2,1,1,0,1,2013
421,Terrel Harris,NOH,20,137,9,19,8,1,7,0,1,0,1,2013
422,Brandon Roy,MIN,5,122,23,54,15,8,8,4,3,5,3,2013
423,Al Harrington,ORL,10,119,10,23,7,3,3,2,2,1,2,2013
424,Daniel Orton,OKC,13,104,4,10,2,2,2,0,0,1,1,2013
425,Chris Johnson,MEM,8,102,2,4,2,0,1,0,1,0,0,2013
426,Josh Childress,BKN,14,100,5,11,4,1,3,0,1,1,0,2013
427,Tornike Shengelia,BKN,19,93,3,6,3,0,1,2,0,0,0,2013
428,DJ White,BOS,12,86,4,8,4,0,2,1,1,0,0,2013
429,Keyon Dooling,MEM,7,82,8,18,6,2,3,0,3,1,1,2013
430,Chris Quinn,CLE,7,78,9,21,6,3,1,1,4,1,2,2013
431,Danny Granger,IND,5,74,3,7,2,1,0,0,2,0,1,2013
432,Jeremy Tyler,ATL,21,68,1,2,1,0,0,0,1,0,0,2013
433,Joel Przybilla,MIL,12,68,4,8,4,0,1,1,2,0,0,2013
434,Chris Douglas-Roberts,DAL,6,63,4,11,1,3,1,0,0,1,2,2013
435,Josh Selby,MEM,10,59,4,9,3,1,2,1,0,1,0,2013
436,Jarvis Varnado,MIA,13,58,3,8,1,2,0,0,1,0,2,2013
437,Luke Zeller,PHX,16,58,3,6,3,0,1,1,1,0,0,2013
438,Malcolm Thomas,CHI,12,57,4,8,4,0,2,0,2,0,0,2013
439,Miles Plumlee,IND,14,55,2,6,0,2,0,0,0,1,1,2013
440,Kris Joseph,BKN,10,54,1,2,1,0,1,0,0,0,0,2013
441,Kevin Murphy,UTA,17,52,2,4,2,0,1,0,1,0,0,2013
442,Juwan Howard,MIA,7,51,6,16,2,4,1,0,1,2,2,2013
443,Fab Melo,BOS,6,36,0,0,0,0,0,0,0,0,0,2013
444,Cory Higgins,CHA,6,32,5,12,3,2,3,0,0,0,2,2013
445,Dexter Pittman,MEM,11,32,0,0,0,0,0,0,0,0,0,2013
446,Tyler Honeycutt,SAC,9,32,2,5,1,1,1,0,0,1,0,2013
447,Lazar Hayward,MIN,4,31,3,6,3,0,2,0,1,0,0,2013
448,Josh Harrellson,MIA,6,31,0,0,0,0,0,0,0,0,0,2013
449,Quentin Richardson,NYK,1,29,1,2,1,0,1,0,0,0,0,2013
450,Julyan Stone,DEN,4,28,2,4,2,0,0,2,0,0,0,2013
451,Solomon Jones,NYK,2,26,0,0,0,0,0,0,0,0,0,2013
452,Quincy Miller,DEN,7,26,3,6,3,0,3,0,0,0,0,2013
453,Jared Cunningham,DAL,8,26,1,3,0,1,0,0,0,1,0,2013
454,Brandon Rush,GSW,2,25,2,5,1,1,0,0,1,0,1,2013
455,Eddy Curry,DAL,2,25,0,0,0,0,0,0,0,0,0,2013
456,Scott Machado,HOU,6,21,6,13,5,1,3,1,1,0,1,2013
457,Will Conroy,MIN,4,20,0,0,0,0,0,0,0,0,0,2013
458,Tim Ohlbrecht,HOU,3,12,1,2,1,0,1,0,0,0,0,2013
459,Josh Akognon,DAL,3,9,1,2,1,0,0,0,1,0,0,2013
460,DaJuan Summers,LAC,2,7,1,2,1,0,1,0,0,0,0,2013
461,Andrew Goudelock,LAL,1,6,0,0,0,0,0,0,0,0,0,2013
462,Matt Carroll,CHA,1,6,1,2,1,0,1,0,0,0,0,2013
463,Darius Johnson-Odom,LAL,4,6,1,2,1,0,0,0,1,0,0,2013
464,Henry Sims,NOH,2,5,0,0,0,0,0,0,0,0,0,2013
465,Darko Milicic,BOS,1,4,0,0,0,0,0,0,0,0,0,2013
466,Justin Dentmon,DAL,2,4,0,0,0,0,0,0,0,0,0,2013
467,Chris Wright,DAL,3,4,0,0,0,0,0,0,0,0,0,2013
468,Damion James,BKN,2,0,0,0,0,0,0,0,0,0,0,2013
0,Kevin Durant,OKC,66,2546,231,542,151,80,95,24,32,28,52,2012
1,Pau Gasol,LAL,65,2430,237,519,192,45,124,31,37,13,32,2012
2,Rudy Gay,MEM,65,2422,147,329,112,35,48,40,24,13,22,2012
3,Blake Griffin,LAC,66,2392,210,525,105,105,50,12,43,29,76,2012
4,John Wall,WAS,66,2386,530,1200,390,140,229,47,114,77,63,2012
5,Marc Gasol,MEM,65,2371,204,460,152,52,92,20,40,14,38,2012
6,Brandon Jennings,MIL,66,2331,365,807,288,77,141,38,109,26,51,2012
7,Russell Westbrook,OKC,66,2331,362,829,257,105,148,30,79,18,87,2012
8,Josh Smith,ATL,66,2329,257,597,174,83,122,23,29,40,43,2012
9,LeBron James,MIA,62,2326,387,872,289,98,157,39,93,37,61,2012
10,Kobe Bryant,LAL,58,2232,264,580,212,52,135,29,48,26,26,2012
11,Wesley Matthews,POR,66,2228,113,258,81,32,53,5,23,17,15,2012
12,Andre Iguodala,PHI,62,2209,339,741,276,63,107,63,106,14,49,2012
13,DeMar DeRozan,TOR,63,2206,128,299,85,43,50,9,26,14,29,2012
14,Jrue Holiday,PHI,65,2196,290,636,234,56,86,64,84,14,42,2012
15,Jeff Teague,ATL,66,2183,321,734,229,92,126,26,77,38,54,2012
16,Chris Paul,LAC,60,2180,543,1238,391,152,231,38,122,44,108,2012
17,Mike Conley,MEM,62,2174,404,856,356,48,158,71,127,11,37,2012
18,Tyreke Evans,SAC,63,2162,283,665,184,99,111,25,48,39,60,2012
19,Kris Humphries,NJN,62,2162,90,207,63,27,22,12,29,8,19,2012
20,Antawn Jamison,CLE,65,2151,131,296,97,34,68,10,19,17,17,2012
21,Kevin Love,MIN,55,2146,111,257,76,35,39,4,33,11,24,2012
22,Luol Deng,CHI,54,2129,157,346,125,32,87,11,27,8,24,2012
23,Brandon Knight,DET,66,2129,251,550,203,48,90,30,83,19,29,2012
24,Joe Johnson,ATL,60,2127,232,527,169,63,85,16,68,23,40,2012
25,Ty Lawson,DEN,61,2124,401,906,297,104,202,41,54,37,67,2012
26,David Lee,GSW,57,2121,162,382,104,58,53,8,43,30,28,2012
27,Monta Ellis,MIL,58,2120,346,791,247,99,144,28,75,34,65,2012
28,Marcin Gortat,PHX,66,2114,59,139,38,21,15,2,21,13,8,2012
29,Andrew Bynum,LAL,60,2112,85,187,68,17,30,13,25,4,13,2012
30,Paul Millsap,UTA,64,2100,150,339,111,39,59,17,35,10,29,2012
31,Tayshaun Prince,DET,63,2087,153,340,119,34,57,26,36,8,26,2012
32,Arron Afflalo,DEN,62,2086,149,357,90,59,65,11,14,17,42,2012
33,Greg Monroe,DET,66,2082,152,328,128,24,81,14,33,8,16,2012
34,Dirk Nowitzki,DAL,62,2079,136,332,76,60,45,18,13,14,46,2012
35,Gerald Wallace,NJN,58,2076,164,376,116,48,68,16,32,15,33,2012
36,Al Jefferson,UTA,61,2075,134,309,93,41,49,8,36,3,38,2012
37,Paul Pierce,BOS,61,2075,274,588,234,40,87,36,111,20,20,2012
38,Dwight Howard,ORL,54,2070,104,270,42,62,22,5,15,5,57,2012
39,Luis Scola,HOU,66,2067,140,332,88,52,53,18,17,18,34,2012
40,Danny Granger,IND,62,2062,109,251,76,33,30,19,27,10,23,2012
41,Tyson Chandler,NYK,62,2061,56,130,38,18,23,3,12,4,14,2012
42,Jared Dudley,PHX,65,2020,112,256,80,32,44,12,24,9,23,2012
43,Gordon Hayward,UTA,66,2015,207,448,173,34,86,36,51,4,30,2012
44,Chris Bosh,MIA,57,2007,103,237,72,31,37,14,21,10,21,2012
45,Jason Terry,DAL,63,2000,226,512,166,60,96,33,37,19,41,2012
46,Deron Williams,NJN,55,1999,481,1114,329,152,167,60,102,51,101,2012
47,LaMarcus Aldridge,POR,55,1995,134,340,62,72,31,10,21,20,52,2012
48,Marco Belinelli,NOH,66,1966,101,214,89,12,30,28,31,4,8,2012
49,Ryan Anderson,ORL,61,1964,54,129,33,21,18,9,6,6,15,2012
50,Steve Nash,PHX,62,1962,664,1458,534,130,299,104,131,38,92,2012
51,Paul George,IND,66,1958,158,354,120,38,64,18,38,13,25,2012
52,Rajon Rondo,BOS,53,1957,620,1370,490,130,221,46,223,59,71,2012
53,DeMarcus Cousins,SAC,64,1950,102,222,84,18,64,11,9,8,10,2012
54,Carlos Boozer,CHI,66,1949,125,283,92,33,60,6,26,7,26,2012
55,James Harden,OKC,62,1946,229,536,151,78,88,17,46,30,48,2012
56,Joakim Noah,CHI,64,1945,160,351,129,31,72,20,37,13,18,2012
57,Roy Hibbert,IND,65,1937,108,242,82,26,53,7,22,6,20,2012
58,David West,IND,66,1925,140,326,94,46,51,23,20,11,35,2012
59,Tony Parker,SAS,60,1923,463,1071,318,145,173,48,97,50,95,2012
60,Shawn Marion,DAL,63,1920,132,307,89,43,48,11,30,9,34,2012
61,Raymond Felton,POR,60,1906,390,881,289,101,162,36,91,36,65,2012
62,Landry Fields,NYK,66,1894,169,383,124,45,88,11,25,10,35,2012
63,Darren Collison,IND,60,1878,287,643,218,69,85,46,87,22,47,2012
64,Carmelo Anthony,NYK,55,1876,200,463,137,63,101,9,27,25,38,2012
65,Caron Butler,LAC,63,1871,78,178,56,22,39,5,12,12,10,2012
66,Brandon Bass,BOS,59,1868,55,133,32,23,13,3,16,7,16,2012
67,Kevin Garnett,BOS,60,1864,175,397,128,47,87,9,32,14,33,2012
68,Gerald Henderson,CHA,55,1831,126,284,94,32,51,18,25,10,22,2012
69,Alonzo Gee,CLE,63,1827,113,271,68,45,33,10,25,16,29,2012
70,Mario Chalmers,MIA,64,1825,222,480,186,36,97,32,57,16,20,2012
71,Andre Miller,DEN,66,1809,441,972,351,90,286,25,40,31,59,2012
72,Chandler Parsons,HOU,63,1804,134,312,90,44,44,10,36,21,23,2012
73,Jose Calderon,TOR,53,1799,468,1024,380,88,187,63,130,23,65,2012
74,DeAndre Jordan,LAC,66,1798,17,38,13,4,7,0,6,1,3,2012
75,Serge Ibaka,OKC,66,1792,28,65,19,9,14,1,4,0,9,2012
76,Kemba Walker,CHA,66,1792,289,603,264,25,105,29,130,4,21,2012
77,Nicolas Batum,POR,59,1791,84,198,54,30,26,6,22,14,16,2012
78,Marcus Thornton,SAC,51,1780,98,215,79,19,50,10,19,8,11,2012
79,O.J. Mayo,MEM,66,1771,169,365,142,27,80,28,34,13,14,2012
80,JJ Redick,ORL,65,1764,164,398,94,70,65,9,20,20,50,2012
81,Al Harrington,DEN,64,1761,88,209,55,33,40,10,5,16,17,2012
82,Courtney Lee,HOU,58,1757,88,204,60,28,26,10,24,12,16,2012
83,Thaddeus Young,PHI,63,1755,74,163,59,15,26,15,18,4,11,2012
84,Jordan Crawford,WAS,64,1753,190,412,158,32,100,25,33,14,18,2012
85,Goran Dragic,HOU,66,1752,351,790,263,88,106,54,103,52,36,2012
86,Luke Ridnour,MIN,53,1750,252,589,167,85,113,22,32,15,70,2012
87,Richard Jefferson,GSW,63,1748,88,204,60,28,30,8,22,10,18,2012
88,Kendrick Perkins,OKC,65,1744,78,170,64,14,39,10,15,3,11,2012
89,Devin Harris,UTA,63,1741,316,695,253,63,125,51,77,19,44,2012
90,Elton Brand,PHI,60,1732,97,221,70,27,25,11,34,1,26,2012
91,Nick Young,LAC,62,1729,56,125,43,13,23,7,13,4,9,2012
92,Metta World Peace,LAL,64,1720,140,309,111,29,42,22,47,8,21,2012
93,Brandon Rush,GSW,65,1717,88,214,50,38,24,9,17,19,19,2012
94,Evan Turner,PHI,65,1712,180,398,142,38,66,35,41,9,29,2012
95,Ramon Sessions,LAL,64,1707,354,802,260,94,132,49,79,26,68,2012
96,Jameer Nelson,ORL,57,1706,325,790,185,140,133,21,31,43,97,2012
97,Iman Shumpert,NYK,59,1705,164,391,101,63,63,5,33,15,48,2012
98,Greivis Vasquez,NOH,66,1705,359,762,315,44,160,51,104,14,30,2012
99,Randy Foye,LAC,65,1682,146,328,110,36,79,5,26,20,16,2012
100,Lou Williams,PHI,64,1682,221,478,185,36,78,39,68,11,25,2012
101,Channing Frye,PHX,64,1670,88,206,58,30,25,13,20,13,17,2012
102,Jason Thompson,SAC,64,1657,79,177,60,19,41,8,11,5,14,2012
103,Isaiah Thomas,SAC,65,1655,266,587,211,55,140,23,48,14,41,2012
104,Ersan Ilyasova,MIL,60,1655,71,168,45,26,26,9,10,13,13,2012
105,Hedo Turkoglu,ORL,53,1653,233,562,137,96,105,16,16,41,55,2012
106,Dorell Wright,GSW,61,1650,94,218,64,30,34,9,21,10,20,2012
107,MarShon Brooks,NJN,56,1648,131,296,97,34,51,13,33,19,15,2012
108,Rodney Stuckey,DET,55,1643,210,467,163,47,82,22,59,16,31,2012
109,Jodie Meeks,PHI,66,1643,54,118,44,10,17,11,16,4,6,2012
110,Zaza Pachulia,ATL,58,1640,79,180,57,22,29,9,19,12,10,2012
111,Anthony Morrow,NJN,62,1636,61,141,42,19,22,12,8,6,13,2012
112,Ronnie Brewer,CHI,66,1635,137,313,98,39,54,13,31,13,26,2012
113,Tim Duncan,SAS,58,1634,132,292,104,28,69,11,24,12,16,2012
114,Dwyane Wade,MIA,49,1625,225,497,178,47,117,22,39,20,27,2012
115,Jamal Crawford,POR,60,1613,191,430,143,48,57,12,74,24,24,2012
116,Klay Thompson,GSW,66,1608,133,298,101,32,52,19,30,13,19,2012
117,Jason Richardson,ORL,54,1591,107,259,62,45,40,14,8,15,30,2012
118,Udonis Haslem,MIA,64,1589,42,98,28,14,18,3,7,4,10,2012
119,Ray Allen,BOS,46,1565,109,229,98,11,42,16,40,7,4,2012
120,James Johnson,TOR,62,1561,122,269,97,25,67,16,14,4,21,2012
121,Kyrie Irving,CLE,51,1558,275,627,198,77,131,33,34,22,55,2012
122,Amir Johnson,TOR,64,1553,79,173,64,15,27,12,25,3,12,2012
123,Amar'e Stoudemire,NYK,47,1543,52,126,30,22,22,0,8,6,16,2012
124,Vince Carter,DAL,61,1542,139,317,100,39,57,14,29,18,21,2012
125,Carlos Delfino,MIL,54,1537,123,267,102,21,55,13,34,4,17,2012
126,JaVale McGee,DEN,61,1535,31,69,24,7,20,2,2,3,4,2012
127,Kawhi Leonard,SAS,64,1534,70,174,36,34,21,9,6,15,19,2012
128,Ed Davis,TOR,66,1534,60,135,45,15,23,5,17,2,13,2012
129,Jarrett Jack,NOH,45,1530,285,609,246,39,96,43,107,12,27,2012
130,Tony Allen,MEM,58,1525,79,167,70,9,42,17,11,4,5,2012
131,Danny Green,SAS,66,1522,86,194,64,22,46,8,10,13,9,2012
132,Kyle Lowry,HOU,47,1510,310,695,235,75,111,39,85,29,46,2012
133,Derek Fisher,OKC,63,1508,170,360,150,20,68,32,50,4,16,2012
134,Marvin Williams,ATL,57,1499,71,171,42,29,22,3,17,10,19,2012
135,Shane Battier,MIA,65,1499,82,182,64,18,33,10,21,8,10,2012
136,Patrick Patterson,HOU,64,1483,53,132,27,26,15,3,9,10,16,2012
137,Al-Farouq Aminu,NOH,66,1477,66,141,57,9,33,5,19,2,7,2012
138,Mo Williams,LAC,52,1472,160,361,119,41,75,16,28,15,26,2012
139,Kyle Korver,CHI,65,1469,112,239,97,15,50,16,31,7,8,2012
140,Drew Gooden,MIL,56,1469,144,316,116,28,77,19,20,12,16,2012
141,Wesley Johnson,MIN,65,1468,59,127,50,9,31,9,10,5,4,2012
142,Jonas Jerebko,DET,64,1468,43,98,31,12,18,6,7,2,10,2012
143,Jason Maxiell,DET,65,1466,41,87,36,5,19,7,10,0,5,2012
144,Byron Mullens,CHA,65,1465,57,119,52,5,30,7,15,0,5,2012
145,Bismack Biyombo,CHA,63,1455,27,55,26,1,9,1,16,0,1,2012
146,Samuel Dalembert,HOU,65,1447,33,71,28,5,17,4,7,3,2,2012
147,Mike Dunleavy,MIL,55,1445,117,257,94,23,57,16,21,10,13,2012
148,Derrick Brown,CHA,65,1443,67,143,58,9,21,4,33,3,6,2012
149,Tyler Hansbrough,IND,66,1442,30,76,14,16,7,7,0,3,13,2012
150,Matt Barnes,LAL,63,1440,126,273,105,21,57,27,21,9,12,2012
151,Chris Singleton,WAS,66,1431,49,105,42,7,16,10,16,1,6,2012
152,Glen Davis,ORL,61,1427,47,113,28,19,19,2,7,7,12,2012
153,Boris Diaw,SAS,57,1425,205,457,158,47,75,23,60,12,35,2012
154,Tristan Thompson,CLE,60,1424,27,60,21,6,10,4,7,0,6,2012
155,Derrick Williams,MIN,66,1418,38,94,20,18,12,1,7,10,8,2012
156,D.J. Augustin,CHA,48,1408,307,659,262,45,114,22,126,9,36,2012
157,Ricky Rubio,MIN,41,1404,336,784,224,112,147,29,48,44,68,2012
158,Shannon Brown,PHX,59,1400,69,154,53,16,25,10,18,5,11,2012
159,Ben Gordon,DET,52,1398,127,288,93,34,55,10,28,12,22,2012
160,Leandro Barbosa,IND,64,1381,96,227,61,35,28,13,20,11,24,2012
161,Jason Kidd,DAL,48,1379,264,584,208,56,97,42,69,10,46,2012
162,Grant Hill,PHX,49,1378,107,237,84,23,33,14,37,7,16,2012
163,Derrick Favors,UTA,65,1376,43,92,37,6,19,5,13,2,4,2012
164,Derrick Rose,CHI,39,1375,307,676,245,62,94,33,118,23,39,2012
165,Chris Kaman,NOH,47,1372,101,216,87,14,43,10,34,5,9,2012
166,Avery Bradley,BOS,64,1368,87,199,62,25,19,9,34,6,19,2012
167,DeJuan Blair,SAS,64,1363,78,181,53,25,31,7,15,10,15,2012
168,Marcus Camby,HOU,59,1352,107,227,94,13,64,20,10,4,9,2012
169,Danilo Gallinari,DEN,43,1351,116,253,95,21,60,17,18,10,11,2012
170,Trevor Ariza,NOH,41,1350,135,299,106,29,46,19,41,13,16,2012
171,Joel Anthony,MIA,64,1350,9,20,7,2,4,0,3,1,1,2012
172,Marreese Speights,MEM,60,1345,48,103,41,7,27,10,4,1,6,2012
173,Omri Casspi,CLE,65,1341,66,149,49,17,36,2,11,6,11,2012
174,Matt Bonner,SAS,65,1326,61,148,35,26,15,10,10,14,12,2012
175,Nick Collison,OKC,63,1307,82,204,42,40,29,5,8,6,34,2012
176,Chase Budinger,HOU,58,1298,74,162,60,14,31,9,20,3,11,2012
177,Ekpe Udoh,MIL,61,1290,57,127,44,13,21,7,16,6,7,2012
178,Corey Brewer,DEN,59,1287,88,194,70,18,56,3,11,6,12,2012
179,Taj Gibson,CHI,63,1284,47,115,26,21,12,4,10,5,16,2012
180,Anthony Parker,CLE,51,1280,120,275,85,35,46,18,21,12,23,2012
181,Shelden Williams,NJN,58,1276,35,85,20,15,11,4,5,3,12,2012
182,George Hill,IND,50,1274,145,327,108,37,50,15,43,16,21,2012
183,Nikola Pekovic,MIN,47,1264,31,74,19,12,10,2,7,1,11,2012
184,Kevin Martin,HOU,40,1264,110,254,76,34,27,18,31,12,22,2012
185,Trevor Booker,WAS,50,1261,40,94,26,14,16,7,3,2,12,2012
186,Norris Cole,MIA,65,1260,133,302,97,36,59,10,28,16,20,2012
187,John Salmons,SAC,46,1250,93,211,68,25,35,15,18,8,17,2012
188,JJ Hickson,POR,54,1244,45,114,21,24,16,1,4,8,16,2012
189,Steve Blake,LAL,53,1237,175,388,137,38,71,27,39,16,22,2012
190,Kirk Hinrich,ATL,48,1237,132,301,95,37,50,11,34,14,23,2012
191,Markieff Morris,PHX,63,1227,65,137,58,7,28,8,22,3,4,2012
192,Chris Duhon,ORL,63,1226,151,360,93,58,54,13,26,12,46,2012
193,Stephen Jackson,SAS,47,1212,118,262,92,26,63,14,15,9,17,2012
194,Gary Neal,SAS,56,1206,117,277,74,43,44,17,13,15,28,2012
195,Nate Robinson,GSW,51,1192,231,539,154,77,79,25,50,20,57,2012
196,Kevin Seraphin,WAS,57,1176,33,73,26,7,19,2,5,3,4,2012
197,C.J. Watson,CHI,49,1159,200,441,159,41,63,17,79,11,30,2012
198,Rodrigue Beaubois,DAL,53,1150,152,354,102,50,42,20,40,12,38,2012
199,Brendan Haywood,DAL,54,1146,19,44,13,6,7,2,4,0,6,2012
200,CJ Miles,UTA,56,1145,69,141,66,3,41,16,9,2,1,2012
201,Martell Webster,MIN,47,1140,40,93,27,13,16,3,8,3,10,2012
202,Ian Mahinmi,DAL,61,1139,12,32,4,8,1,1,2,1,7,2012
203,Jimmer Fredette,SAC,61,1135,108,242,82,26,56,13,13,13,13,2012
204,Dominic McGuire,GSW,64,1127,110,263,67,43,40,4,23,18,25,2012
205,Dante Cunningham,MEM,64,1124,37,85,26,11,14,4,8,4,7,2012
206,Tiago Splitter,SAS,59,1121,65,161,34,31,19,5,10,9,22,2012
207,Nene,WAS,39,1110,80,179,61,19,49,5,7,9,10,2012
208,DJ White,CHA,58,1098,47,105,36,11,13,8,15,4,7,2012
209,Shaun Livingston,MIL,58,1092,122,273,93,29,54,11,28,7,22,2012
210,Gustavo Ayon,NOH,54,1088,74,166,56,18,34,7,15,9,9,2012
211,Michael Beasley,MIN,47,1087,45,99,36,9,26,5,5,4,5,2012
212,Beno Udrih,MIL,59,1080,227,516,165,62,81,17,67,13,49,2012
213,Jan Vesely,WAS,57,1078,47,104,37,10,26,5,6,3,7,2012
214,Delonte West,DAL,44,1060,139,309,108,31,56,18,34,6,25,2012
215,Linas Kleiza,TOR,49,1057,46,109,29,17,13,3,13,2,15,2012
216,Dahntay Jones,IND,65,1052,63,141,48,15,23,9,16,6,9,2012
217,Chuck Hayes,SAC,54,1040,77,163,68,9,46,6,16,4,5,2012
218,Kenneth Faried,DEN,46,1037,36,80,28,8,21,5,2,1,7,2012
219,Earl Watson,UTA,50,1032,217,455,196,21,119,26,51,7,14,2012
220,J.J. Barea,MIN,41,1032,232,530,166,66,97,29,40,19,47,2012
221,Andrea Bargnani,TOR,31,1032,61,132,51,10,25,12,14,0,10,2012
222,Lamar Odom,DAL,50,1027,83,194,55,28,30,17,8,11,17,2012
223,Steve Novak,NYK,54,1020,12,30,6,6,4,0,2,1,5,2012
224,Tyrus Thomas,CHA,54,1013,35,73,32,3,17,3,12,2,1,2012
225,Luc Mbah a Moute,MIL,43,1009,29,66,21,8,14,2,5,2,6,2012
226,Quincy Pondexter,MEM,64,1002,27,60,21,6,6,5,10,2,4,2012
227,Carl Landry,NOH,41,999,38,88,26,12,7,6,13,3,9,2012
228,Josh Howard,UTA,43,991,50,109,41,9,22,6,13,2,7,2012
229,Daequan Cook,OKC,57,989,15,32,13,2,4,3,6,1,1,2012
230,Ben Wallace,DET,62,980,43,97,32,11,18,7,7,2,9,2012
231,Wayne Ellington,MIN,51,973,33,80,19,14,12,2,5,2,12,2012
232,Omer Asik,CHI,66,971,32,75,21,11,11,0,10,3,8,2012
233,JR Smith,NYK,35,967,84,213,39,45,30,0,9,16,29,2012
234,DeShawn Stevenson,NJN,51,960,41,105,18,23,8,2,8,3,20,2012
235,Troy Murphy,LAL,59,956,51,118,35,16,14,5,16,7,9,2012
236,Jason Smith,NOH,40,947,34,74,28,6,15,2,11,4,2,2012
237,Jeremy Lin,NYK,35,940,216,482,166,50,126,11,29,12,38,2012
238,Kenyon Martin,LAC,42,940,18,44,10,8,7,0,3,2,6,2012
239,Alec Burks,UTA,59,939,55,116,49,6,32,9,8,3,3,2012
240,Ivan Johnson,ATL,56,934,32,72,24,8,10,5,9,2,6,2012
241,Willie Green,ATL,53,922,40,91,29,11,18,2,9,6,5,2012
242,Damien Wilkins,DET,60,922,44,102,30,14,13,7,10,5,9,2012
243,Mickael Pietrus,BOS,42,921,25,55,20,5,11,4,5,1,4,2012
244,Spencer Hawes,PHI,37,920,98,207,87,11,48,12,27,4,7,2012
245,Johan Petro,NJN,59,920,45,99,36,9,28,3,5,3,6,2012
246,Daniel Gibson,CLE,35,916,76,171,57,19,29,13,15,3,16,2012
247,Thabo Sefolosha,OKC,42,914,47,105,36,11,20,4,12,2,9,2012
248,Robin Lopez,PHX,64,895,20,46,14,6,9,1,4,0,6,2012
249,Sebastian Telfair,PHX,60,894,138,325,89,49,50,17,22,9,40,2012
250,Charles Jenkins,GSW,51,893,170,385,125,45,61,16,48,11,34,2012
251,Anthony Tolliver,MIN,51,881,22,47,19,3,12,0,7,0,3,2012
252,Corey Maggette,CHA,32,881,39,85,32,7,18,2,12,2,5,2012
253,Enes Kanter,UTA,66,874,8,18,6,2,3,0,3,0,2,2012
254,Quentin Richardson,ORL,48,866,38,94,20,18,8,6,6,6,12,2012
255,Tracy McGrady,ATL,52,837,110,259,71,39,35,8,28,11,28,2012
256,Jordan Farmar,NJN,39,831,129,290,97,32,39,21,37,12,20,2012
257,Samardo Samuels,CLE,54,825,20,44,16,4,12,2,2,2,2,2012
258,Aaron Gray,TOR,49,813,27,56,25,2,18,2,5,0,2,2012
259,Nikola Vucevic,PHI,51,812,31,72,21,10,9,3,9,1,9,2012
260,Kurt Thomas,POR,53,803,46,107,31,15,13,4,14,9,6,2012
261,Francisco Garcia,SAC,49,798,31,69,24,7,10,6,8,3,4,2012
262,Raja Bell,UTA,34,796,38,86,28,10,9,7,12,1,9,2012
263,Sundiata Gaines,NJN,57,793,126,282,96,30,34,14,48,9,21,2012
264,Manu Ginobili,SAS,34,792,151,333,120,31,87,19,14,14,17,2012
265,Kosta Koufos,DEN,48,792,15,33,12,3,2,4,6,1,2,2012
266,Brandan Wright,DAL,49,791,13,33,6,7,3,1,2,0,7,2012
267,Anderson Varejao,CLE,25,785,43,95,34,9,20,7,7,3,6,2012
268,Emeka Okafor,NOH,27,782,24,54,18,6,9,1,8,2,4,2012
269,Gerald Green,NJN,31,781,34,77,25,9,11,4,10,3,6,2012
270,Shelvin Mack,WAS,64,779,131,299,94,37,48,4,42,8,29,2012
271,Donte Greene,SAC,53,777,34,74,28,6,21,3,4,1,5,2012
272,Reggie Evans,LAC,56,771,17,38,13,4,5,2,6,1,3,2012
273,Michael Redd,PHX,51,770,33,78,21,12,15,2,4,3,9,2012
274,Greg Stiemsma,BOS,55,767,28,61,23,5,8,6,9,2,3,2012
275,Xavier Henry,NOH,45,759,35,74,31,4,10,7,14,2,2,2012
276,Vladimir Radmanovic,ATL,49,755,54,123,39,15,20,4,15,9,6,2012
277,Lou Amundson,IND,60,753,14,32,10,4,9,0,1,1,3,2012
278,Mike Miller,MIA,39,752,42,93,33,9,12,9,12,5,4,2012
279,Reggie Williams,CHA,33,747,60,130,50,10,33,5,12,1,9,2012
280,Andris Biedrins,GSW,47,739,16,38,10,6,2,2,6,1,5,2012
281,Zach Randolph,MEM,28,735,48,114,30,18,25,3,2,2,16,2012
282,Stephen Curry,GSW,26,732,138,309,105,33,62,17,26,12,21,2012
283,Jared Jeffries,NYK,39,729,26,66,12,14,6,2,4,5,9,2012
284,Rashard Lewis,WAS,28,729,27,59,22,5,10,2,10,3,2,2012
285,John Lucas III,CHI,49,725,108,238,86,22,36,12,38,8,14,2012
286,Josh McRoberts,LAL,50,718,51,113,40,11,23,9,8,5,6,2012
287,Gary Forbes,TOR,48,713,54,115,47,7,20,13,14,4,3,2012
288,Rudy Fernandez,DEN,31,710,75,168,57,18,47,2,8,12,6,2012
289,Jerryd Bayless,TOR,31,705,118,262,92,26,42,17,33,10,16,2012
290,Richard Hamilton,CHI,28,697,84,187,65,19,40,11,14,5,14,2012
291,Roger Mason Jr.,WAS,52,696,47,102,39,8,19,9,11,2,6,2012
292,Nazr Mohammed,OKC,63,692,14,30,12,2,9,0,3,0,2,2012
293,Timofey Mozgov,DEN,44,687,22,50,16,6,11,4,1,4,2,2012
294,Jannero Pargo,ATL,50,671,96,226,62,34,37,3,22,9,25,2012
295,Donald Sloan,CLE,33,669,105,243,72,33,29,14,29,4,29,2012
296,James Jones,MIA,51,666,19,42,15,4,8,1,6,2,2,2012
297,Keyon Dooling,BOS,46,661,51,110,43,8,16,5,22,3,5,2012
298,Toney Douglas,NYK,38,656,77,186,45,32,32,5,8,12,20,2012
299,Larry Sanders,MIL,52,643,33,73,26,7,11,4,11,4,3,2012
300,Jordan Williams,NJN,43,635,11,27,6,5,1,0,5,2,3,2012
301,Lance Thomas,NOH,42,629,12,25,11,1,3,0,8,0,1,2012
302,Andray Blatche,WAS,26,626,28,65,19,9,15,2,2,3,6,2012
303,Lavoy Allen,PHI,41,624,34,72,30,4,10,8,12,0,4,2012
304,Henry Walker,NYK,32,620,37,82,29,8,18,2,9,4,4,2012
305,Chauncey Billups,LAC,20,607,80,178,62,18,39,7,16,6,12,2012
306,Austin Daye,DET,41,603,33,73,26,7,16,7,3,3,4,2012
307,James Anderson,SAS,51,603,41,89,34,7,14,11,9,3,4,2012
308,Matt Carroll,CHA,53,596,38,84,30,8,15,5,10,4,4,2012
309,Baron Davis,NYK,29,595,135,310,95,40,78,4,13,11,29,2012
310,Jermaine O'Neal,BOS,25,570,10,22,8,2,6,1,1,1,1,2012
311,Jeremy Tyler,GSW,42,568,16,38,10,6,6,0,4,2,4,2012
312,AJ Price,IND,44,568,86,198,60,26,31,10,19,9,17,2012
313,Earl Clark,ORL,45,559,18,46,8,10,2,1,5,2,8,2012
314,Mike Bibby,NYK,39,557,80,191,49,31,27,6,16,5,26,2012
315,Jon Leuer,MIL,46,555,25,57,18,7,12,1,5,0,7,2012
316,Jordan Hill,LAL,39,551,16,36,12,4,9,3,0,0,4,2012
317,Terrence Williams,SAC,30,550,65,156,39,26,20,3,16,13,13,2012
318,Nolan Smith,POR,44,541,62,149,37,25,15,8,14,10,15,2012
319,Josh Harrellson,NYK,37,540,11,28,5,6,3,0,2,3,3,2012
320,Luke Babbitt,POR,40,537,16,39,9,7,3,3,3,5,2,2012
321,Sasha Pavlovic,BOS,45,527,18,41,13,5,6,4,3,3,2,2012
322,Ryan Hollins,BOS,39,522,9,20,7,2,3,2,2,0,2,2012
323,Ronnie Price,PHX,36,517,67,152,49,18,30,7,12,1,17,2012
324,Anthony Randolph,MIN,34,517,19,48,9,10,7,1,1,5,5,2012
325,Shawne Williams,NJN,25,514,16,42,6,10,0,2,4,2,8,2012
326,Will Bynum,DET,36,514,66,153,45,21,24,6,15,3,18,2012
327,Jamaal Tinsley,UTA,37,507,123,256,113,10,73,19,21,2,8,2012
328,Hakim Warrick,PHX,35,503,30,65,25,5,14,2,9,2,3,2012
329,Reggie Jackson,OKC,45,501,71,169,44,27,24,8,12,10,17,2012
330,Travis Outlaw,SAC,39,500,16,36,12,4,8,2,2,2,2,2012
331,Josh Childress,PHX,34,491,34,79,23,11,6,2,15,2,9,2012
332,Chris Andersen,DEN,32,486,6,13,5,1,4,1,0,0,1,2012
333,Marquis Daniels,BOS,38,483,47,107,34,13,15,10,9,8,5,2012
334,Chris Wilcox,BOS,28,481,12,28,8,4,4,1,3,0,4,2012
335,Tobias Harris,MIL,42,479,22,47,19,3,12,2,5,0,3,2012
336,Darko Milicic,MIN,28,472,17,36,15,2,8,0,7,1,1,2012
337,Von Wafer,ORL,33,469,29,63,24,5,16,5,3,1,4,2012
338,Craig Smith,POR,47,464,19,42,15,4,9,2,4,1,3,2012
339,Eric Bledsoe,LAC,40,464,66,152,46,20,22,4,20,10,10,2012
340,Alan Anderson,TOR,17,461,26,56,22,4,12,4,6,2,2,2012
341,Manny Harris,CLE,26,456,31,67,26,5,14,5,7,3,2,2012
342,Mehmet Okur,NJN,17,454,30,68,22,8,10,5,7,4,4,2012
343,Rasual Butler,TOR,34,453,19,44,13,6,9,0,4,1,5,2012
344,Joel Przybilla,POR,27,449,6,15,3,3,1,1,1,0,3,2012
345,Lance Stephenson,IND,42,442,46,101,37,9,20,7,10,2,7,2012
346,Ryan Gomes,LAC,32,425,12,27,9,3,3,1,5,0,3,2012
347,Jeremy Pargo,MEM,44,424,55,117,48,7,24,6,18,3,4,2012
348,Cory Higgins,CHA,38,423,36,76,32,4,12,5,15,1,3,2012
349,Andrew Goudelock,LAL,40,419,20,54,6,14,3,0,3,0,14,2012
350,Bobby Simmons,LAC,28,418,11,26,7,4,3,2,2,2,2,2012
351,Jonny Flynn,POR,29,416,96,224,64,32,32,8,24,10,22,2012
352,Devin Ebanks,LAL,24,396,12,26,10,2,6,2,2,0,2,2012
353,Cartier Martin,WAS,17,391,10,20,10,0,2,0,8,0,0,2012
354,Sam Young,PHI,35,375,15,32,13,2,8,2,3,0,2,2012
355,Jamaal Magloire,TOR,34,374,6,15,3,3,2,0,1,0,3,2012
356,Ben Uzoh,TOR,18,370,61,142,41,20,17,6,18,7,13,2012
357,Andrew Bogut,MIL,12,364,31,70,23,8,15,3,5,2,6,2012
358,Luke Walton,CLE,30,364,35,78,27,8,17,5,5,3,5,2012
359,Jimmy Butler,CHI,42,359,14,33,9,5,2,3,4,2,3,2012
360,Walker Russell,DET,28,357,58,128,46,12,26,5,15,5,7,2012
361,Royal Ivey,OKC,34,354,10,25,5,5,2,0,3,1,4,2012
362,Al Horford,ATL,11,348,24,54,18,6,11,2,5,2,4,2012
363,DeMarre Carroll,UTA,24,348,18,38,16,2,8,5,3,0,2,2012
364,Maurice Evans,WAS,24,343,9,19,8,1,3,1,4,0,1,2012
365,Lester Hudson,MEM,16,334,36,84,24,12,15,4,5,4,8,2012
366,Semih Erden,CLE,28,333,9,20,7,2,7,0,0,1,1,2012
367,E'Twaun Moore,BOS,38,331,34,77,25,9,9,3,13,6,3,2012
368,DeSagana Diop,CHA,27,325,23,53,16,7,7,3,6,2,5,2012
369,Terrel Harris,MIA,22,318,26,58,20,6,12,2,6,2,4,2012
370,Eric Gordon,NOH,9,310,31,67,26,5,14,3,9,1,4,2012
371,Jason Collins,ATL,30,308,10,23,7,3,2,0,5,2,1,2012
372,Dexter Pittman,MIA,35,301,9,20,7,2,5,0,2,0,2,2012
373,JaJuan Johnson,BOS,36,298,6,14,4,2,2,0,2,1,1,2012
374,Tony Battie,PHI,27,295,16,37,11,5,3,4,4,1,4,2012
375,Solomon Jones,NOH,21,292,9,21,6,3,2,2,2,0,3,2012
376,Ronny Turiaf,MIA,17,279,10,23,7,3,4,1,2,1,2,2012
377,Brian Cardinal,DAL,44,277,16,40,8,8,4,1,3,2,6,2012
378,Brian Cook,WAS,32,276,10,21,9,1,7,1,1,0,1,2012
379,Jerry Stackhouse,ATL,30,273,14,33,9,5,3,2,4,3,2,2012
380,Eduardo Najera,CHA,22,270,12,24,12,0,8,2,2,0,0,2012
381,Jason Kapono,LAL,27,269,11,25,8,3,3,1,4,1,2,2012
382,Dominique Jones,DAL,33,268,42,100,26,16,13,5,8,8,8,2012
383,Cory Joseph,SAS,29,266,34,86,16,18,9,4,3,3,15,2012
384,James Singleton,WAS,12,262,15,36,9,6,6,0,3,3,3,2012
385,Patty Mills,SAS,16,261,39,90,27,12,11,10,6,4,8,2012
386,Jordan Hamilton,DEN,26,258,20,46,14,6,11,2,1,4,2,2012
387,Mickell Gladness,GSW,26,252,5,11,4,1,3,0,1,0,1,2012
388,Malcolm Lee,MIN,19,243,31,68,25,6,9,3,13,4,2,2012
389,Jon Brockman,MIL,35,239,9,19,8,1,4,1,3,0,1,2012
390,Josh Selby,MEM,28,237,30,66,24,6,9,3,12,1,5,2012
391,Ish Smith,ORL,26,234,41,93,30,11,14,3,13,3,8,2012
392,Luke Harangody,CLE,21,231,6,15,3,3,3,0,0,0,3,2012
393,Jeremy Evans,UTA,29,217,13,29,10,3,2,4,4,0,3,2012
394,Wilson Chandler,DEN,8,215,17,41,10,7,6,2,2,1,6,2012
395,Gilbert Arenas,MEM,17,211,18,41,13,5,3,1,9,1,4,2012
396,Anthony Carter,TOR,24,209,34,74,28,6,10,4,14,4,2,2012
397,DaJuan Summers,NOH,15,208,10,23,7,3,4,1,2,1,2,2012
398,Hamed Haddadi,MEM,34,206,8,16,8,0,7,0,1,0,0,2012
399,Yi Jianlian,DAL,30,203,5,10,5,0,0,3,2,0,0,2012
400,T.J. Ford,SAS,14,191,45,107,28,17,22,2,4,5,12,2012
401,Juwan Howard,MIA,28,190,10,24,6,4,2,2,2,1,3,2012
402,Kwame Brown,GSW,9,187,4,9,3,1,2,0,1,0,1,2012
403,Daniel Orton,ORL,16,187,5,12,3,2,2,0,1,0,2,2012
404,Chris Wright,GSW,24,186,4,8,4,0,2,0,2,0,0,2012
405,Jerome Dyson,NOH,9,180,18,39,15,3,3,2,10,1,2,2012
406,Charlie Villanueva,DET,13,180,6,12,6,0,2,3,1,0,0,2012
407,Julyan Stone,DEN,22,179,37,81,30,7,27,1,2,1,6,2012
408,Chris Johnson,NOH,27,175,2,5,1,1,1,0,0,0,1,2012
409,Cole Aldrich,OKC,26,173,3,6,3,0,1,0,2,0,0,2012
410,Damion James,NJN,7,170,3,8,1,2,1,0,0,1,1,2012
411,Darius Morris,LAL,19,169,21,47,16,5,9,0,7,0,5,2012
412,Elliot Williams,POR,24,149,6,13,5,1,2,1,2,1,0,2012
413,Brad Miller,MIN,15,146,24,52,20,4,11,1,8,1,3,2012
414,Jeff Foster,IND,11,141,4,9,3,1,1,1,1,1,0,2012
415,Lazar Hayward,OKC,26,141,4,10,2,2,0,0,2,0,2,2012
416,Hasheem Thabeet,POR,20,139,0,0,0,0,0,0,0,0,0,2012
417,Eric Maynor,OKC,9,137,22,53,13,9,7,2,4,3,6,2012
418,Brook Lopez,NJN,5,136,6,15,3,3,2,0,1,0,3,2012
419,Vernon Macklin,DET,23,135,5,10,5,0,1,0,4,0,0,2012
420,Josh Davis,MEM,15,130,6,15,3,3,2,0,1,0,3,2012
421,Marcus Morris,HOU,17,126,3,7,2,1,2,0,0,0,1,2012
422,Armon Johnson,NJN,9,124,11,26,7,4,1,1,5,1,3,2012
423,Jamario Moon,CHA,8,123,5,10,5,0,4,0,1,0,0,2012
424,Solomon Alabi,TOR,14,122,3,7,2,1,2,0,0,0,1,2012
425,Brian Scalabrine,CHI,27,122,15,32,13,2,12,0,1,0,2,2012
426,Mike James,CHI,11,120,29,63,24,5,11,3,10,2,3,2012
427,Trey Thompkins,LAC,24,119,3,6,3,0,3,0,0,0,0,2012
428,Carldell Johnson,NOH,15,119,22,47,19,3,5,4,10,0,3,2012
429,Mikki Moore,GSW,7,118,5,12,3,2,1,0,2,1,1,2012
430,Renaldo Balkman,NYK,14,115,5,11,4,1,2,1,1,0,1,2012
431,DeAndre Liggins,ORL,17,115,5,11,4,1,4,0,0,0,1,2012
432,Larry Hughes,ORL,9,114,7,16,5,2,3,0,2,1,1,2012
433,Earl Boykins,HOU,8,111,17,38,13,4,4,0,9,1,3,2012
434,Hassan Whiteside,SAC,18,109,0,0,0,0,0,0,0,0,0,2012
435,Jerome Jordan,NYK,21,108,4,11,1,3,1,0,0,0,3,2012
436,Sean Williams,BOS,11,107,5,10,5,0,4,1,0,0,0,2012
437,Jeff Ayres,IND,20,106,4,11,1,3,1,0,0,0,3,2012
438,Christian Eyenga,LAL,7,102,5,10,5,0,4,0,1,0,0,2012
439,Darryl Watkins,NOH,5,98,3,7,2,1,1,1,0,0,1,2012
440,Courtney Fortson,HOU,10,95,10,23,7,3,1,1,5,1,2,2012
441,Mychel Thompson,CLE,5,95,7,14,7,0,2,2,3,0,0,2012
442,Keith Bogans,NJN,5,94,3,6,3,0,2,1,0,0,0,2012
443,Justin Dentmon,TOR,6,91,10,23,7,3,2,0,5,2,1,2012
444,Craig Brackins,PHI,14,88,8,18,6,2,1,3,2,0,2,2012
445,Tyler Honeycutt,SAC,15,88,7,14,7,0,4,0,3,0,0,2012
446,Justin Harper,ORL,14,84,2,5,1,1,0,0,1,0,1,2012
447,Erick Dampier,ATL,15,83,4,8,4,0,2,1,1,0,0,2012
448,Eddy Curry,MIA,14,83,1,3,0,1,0,0,0,1,0,2012
449,Larry Owens,NJN,7,75,4,10,2,2,2,0,0,1,1,2012
450,Greg Smith,HOU,8,69,1,3,0,1,0,0,0,0,1,2012
451,Morris Almond,WAS,4,67,2,4,2,0,1,0,1,0,0,2012
452,Jeff Adrien,HOU,8,63,1,2,1,0,0,0,1,0,0,2012
453,Trey Johnson,NOH,11,61,4,9,3,1,1,1,1,1,0,2012
454,D.J. Kennedy,CLE,2,59,3,6,3,0,2,0,1,0,0,2012
455,Andres Nocioni,PHI,11,56,1,2,1,0,0,1,0,0,0,2012
456,Edwin Ubiles,WAS,4,52,1,2,1,0,0,1,0,0,0,2012
457,Jerry Smith,NJN,5,46,4,10,2,2,0,1,1,0,2,2012
458,Travis Leslie,LAC,10,45,5,11,4,1,3,0,1,0,1,2012
459,Andre Emmett,NJN,6,45,1,2,1,0,0,0,1,0,0,2012
460,Eric Dawson,SAS,4,39,0,0,0,0,0,0,0,0,0,2012
461,Jeff Foote,NOH,4,39,0,0,0,0,0,0,0,0,0,2012
462,Darington Hobson,MIL,5,39,6,12,6,0,3,0,3,0,0,2012
463,Xavier Silas,PHI,2,39,3,8,1,2,0,1,0,0,2,2012
464,Derrick Byars,SAS,2,37,1,3,0,1,0,0,0,0,1,2012
465,Blake Ahearn,UTA,4,30,1,2,1,0,1,0,0,0,0,2012
466,Dennis Horner,NJN,8,22,0,0,0,0,0,0,0,0,0,2012
467,Kelenna Azubuike,DAL,3,18,0,0,0,0,0,0,0,0,0,2012
468,Kyrylo Fesenko,IND,3,17,1,2,1,0,1,0,0,0,0,2012
469,Ryan Reid,OKC,5,17,0,0,0,0,0,0,0,0,0,2012
470,Francisco Elson,PHI,5,16,1,2,1,0,0,0,1,0,0,2012
471,Malcolm Thomas,SAS,3,15,1,2,1,0,1,0,0,0,0,2012
472,Ike Diogu,SAS,2,14,0,0,0,0,0,0,0,0,0,2012
473,Dan Gadzuric,NYK,2,13,0,0,0,0,0,0,0,0,0,2012
474,Keith Benson,GSW,3,9,0,0,0,0,0,0,0,0,0,2012
475,Earl Barron,GSW,2,9,0,0,0,0,0,0,0,0,0,2012
476,Brian Skinner,MEM,1,4,0,0,0,0,0,0,0,0,0,2012
477,Hamady Ndiaye,WAS,3,3,0,0,0,0,0,0,0,0,0,2012
0,Monta Ellis,GSW,80,3227,450,1057,293,157,171,37,85,57,100,2011
1,LaMarcus Aldridge,POR,81,3212,170,411,99,71,59,14,26,13,58,2011
2,Luol Deng,CHI,82,3208,230,517,173,57,104,18,51,20,37,2011
3,Dorell Wright,GSW,82,3147,242,578,148,94,88,15,45,36,58,2011
4,Blake Griffin,LAC,82,3112,312,743,193,119,108,27,58,23,96,2011
5,LeBron James,MIA,79,3063,554,1260,402,152,175,51,176,61,91,2011
6,Kevin Durant,OKC,78,3038,214,476,166,48,107,13,46,12,36,2011
7,Pau Gasol,LAL,82,3037,273,609,210,63,128,29,53,24,39,2011
8,Derrick Rose,CHI,81,3026,623,1409,460,163,231,57,172,63,100,2011
9,Al Jefferson,UTA,82,2941,149,338,109,40,59,12,38,4,36,2011
10,Dwight Howard,ORL,78,2935,107,271,50,57,20,10,20,13,44,2011
11,Jrue Holiday,PHI,82,2901,531,1159,434,97,203,83,148,37,60,2011
12,Ray Allen,BOS,80,2890,219,461,196,23,120,22,54,8,15,2011
13,Brook Lopez,NJN,82,2889,129,290,97,32,39,14,44,4,28,2011
14,Chris Paul,NOH,80,2880,782,1735,611,171,252,98,261,63,108,2011
15,Mike Conley,MEM,81,2872,528,1121,463,65,236,71,156,25,40,2011
16,Amar'e Stoudemire,NYK,78,2870,202,491,115,87,78,6,31,28,59,2011
17,DeMar DeRozan,TOR,82,2851,148,329,115,33,64,19,32,7,26,2011
18,Russell Westbrook,OKC,82,2848,670,1476,534,136,270,52,212,25,111,2011
19,Dwyane Wade,MIA,76,2823,346,794,244,102,124,17,103,55,47,2011
20,Elton Brand,PHI,81,2809,120,272,88,32,38,16,34,5,27,2011
21,Chris Bosh,MIA,77,2795,144,331,101,43,53,10,38,17,26,2011
22,Kobe Bryant,LAL,82,2779,388,871,293,95,166,50,77,51,44,2011
23,Boris Diaw,CHA,82,2778,337,739,272,65,138,46,88,15,50,2011
24,Paul Pierce,BOS,80,2774,260,567,213,47,103,29,81,27,20,2011
25,Danny Granger,IND,79,2763,203,458,151,52,88,16,47,17,35,2011
26,Wesley Matthews,POR,82,2758,164,366,126,38,53,19,54,18,20,2011
27,D.J. Augustin,CHA,82,2757,498,1114,380,118,173,36,171,27,91,2011
28,Carmelo Anthony,NYK,77,2751,221,517,146,75,101,18,27,34,41,2011
29,Raymond Felton,DEN,75,2737,625,1440,435,190,294,55,86,59,131,2011
30,Beno Udrih,SAC,79,2734,386,858,300,86,143,52,105,39,47,2011
31,Zach Randolph,MEM,75,2724,163,366,123,40,91,17,15,5,35,2011
32,Jason Richardson,ORL,80,2715,147,350,91,56,54,18,19,13,43,2011
33,Al Horford,ATL,77,2704,266,617,181,85,87,22,72,28,57,2011
34,Gerald Wallace,POR,71,2693,173,385,134,39,73,15,46,8,31,2011
35,Jason Kidd,DAL,80,2653,655,1478,487,168,217,73,197,60,108,2011
36,Andre Miller,POR,81,2650,566,1272,426,140,292,27,107,43,97,2011
37,Josh Smith,ATL,77,2645,255,577,188,67,119,20,49,37,30,2011
38,Lamar Odom,LAL,82,2639,249,557,190,59,98,43,49,20,39,2011
39,David Lee,GSW,73,2634,233,562,137,96,76,22,39,36,60,2011
40,Kevin Love,MIN,73,2611,184,401,151,33,63,32,56,12,21,2011
41,John Wall,WAS,69,2606,574,1277,445,129,221,47,177,53,76,2011
42,Paul Millsap,UTA,76,2605,187,421,140,47,58,24,58,12,35,2011
43,Kevin Martin,HOU,80,2603,198,446,148,50,62,35,51,22,28,2011
44,Trevor Ariza,NOH,75,2600,162,361,125,37,57,19,49,14,23,2011
45,Marc Gasol,MEM,81,2587,200,435,165,35,104,30,31,12,23,2011
46,Jason Terry,DAL,82,2564,334,762,240,94,134,44,62,33,61,2011
47,Kyle Lowry,HOU,75,2563,500,1172,328,172,170,50,108,58,114,2011
48,Tayshaun Prince,DET,78,2562,215,487,158,57,75,28,55,19,38,2011
49,Joe Johnson,ATL,72,2555,338,780,234,104,94,22,118,45,59,2011
50,John Salmons,MIL,73,2554,252,597,159,93,66,39,54,28,65,2011
51,Channing Frye,PHX,77,2541,96,235,53,43,29,9,15,14,29,2011
52,Landry Fields,NYK,82,2541,155,374,91,64,55,13,23,34,30,2011
53,Hedo Turkoglu,ORL,81,2540,343,794,235,108,150,33,52,36,72,2011
54,Tony Parker,SAS,78,2528,513,1192,347,166,175,61,111,77,89,2011
55,Rajon Rondo,BOS,68,2527,760,1672,608,152,315,64,229,58,94,2011
56,Nicolas Batum,POR,80,2522,123,281,88,35,50,14,24,17,18,2011
57,Dirk Nowitzki,DAL,73,2504,190,444,126,64,66,19,41,20,44,2011
58,Steve Nash,PHX,75,2497,855,1948,617,238,376,113,128,77,161,2011
59,Stephen Curry,GSW,74,2489,432,960,336,96,185,47,104,35,61,2011
60,Andre Iguodala,PHI,67,2469,422,937,329,93,158,72,99,33,60,2011
61,Deron Williams,NJN,65,2465,667,1459,542,125,257,100,185,34,91,2011
62,Richard Jefferson,SAS,81,2459,107,249,72,35,40,9,23,17,18,2011
63,David West,NOH,70,2451,164,383,109,55,69,17,23,17,38,2011
64,Jeff Green,BOS,75,2428,108,239,85,23,41,11,33,6,17,2011
65,Manu Ginobili,SAS,80,2425,393,899,280,113,164,49,67,58,55,2011
66,Luis Scola,HOU,74,2412,185,446,109,76,52,22,35,13,63,2011
67,Metta World Peace,LAL,82,2410,175,385,140,35,65,27,48,8,27,2011
68,Grant Hill,PHX,80,2409,200,478,122,78,53,13,56,24,54,2011
69,Stephen Jackson,CHA,67,2405,241,530,193,48,138,19,36,8,40,2011
70,Wilson Chandler,DEN,72,2400,120,289,71,49,47,5,19,22,27,2011
71,Shane Battier,MEM,82,2369,185,418,137,48,62,36,39,19,29,2011
72,Michael Beasley,MIN,73,2362,158,356,118,40,72,25,21,16,24,2011
73,Darren Collison,IND,79,2360,403,949,260,143,117,44,99,34,109,2011
74,Travis Outlaw,NJN,82,2358,84,193,59,25,22,18,19,9,16,2011
75,Andrea Bargnani,TOR,66,2353,119,275,82,37,39,11,32,5,32,2011
76,Arron Afflalo,DEN,69,2324,168,385,119,49,79,4,36,17,32,2011
77,Jameer Nelson,ORL,76,2319,456,1085,283,173,168,41,74,52,121,2011
78,Chauncey Billups,NYK,72,2310,387,871,290,97,174,25,91,39,58,2011
79,DeMarcus Cousins,SAC,81,2310,204,448,164,40,115,21,28,17,23,2011
80,Glen Davis,BOS,78,2298,92,214,62,30,39,8,15,8,22,2011
81,Andrew Bogut,MIL,65,2298,131,297,96,35,62,11,23,12,23,2011
82,Derek Fisher,LAL,82,2297,224,498,174,50,96,39,39,15,35,2011
83,Jamal Crawford,ATL,76,2297,241,534,189,52,81,28,80,22,30,2011
84,Nene,DEN,75,2291,149,341,106,43,66,16,24,12,31,2011
85,Emeka Okafor,NOH,72,2287,42,90,36,6,12,7,17,1,5,2011
86,Mike Bibby,MIA,80,2285,265,572,223,42,93,36,94,15,27,2011
87,JJ Hickson,CLE,80,2256,91,207,66,25,36,9,21,9,16,2011
88,Devin Harris,UTA,71,2254,503,1100,409,94,180,109,120,34,60,2011
89,Shawn Marion,DAL,80,2253,110,257,73,37,37,7,29,13,24,2011
90,Roy Hibbert,IND,81,2244,166,366,132,34,101,10,21,4,30,2011
91,Greg Monroe,DET,80,2222,105,225,90,15,60,12,18,11,4,2011
92,Kevin Garnett,BOS,71,2220,171,375,138,33,95,9,34,10,23,2011
93,Serge Ibaka,OKC,82,2216,22,53,13,9,9,1,3,2,7,2011
94,JaVale McGee,WAS,79,2193,38,78,36,2,30,2,4,1,1,2011
95,James Harden,OKC,82,2188,176,419,109,67,69,11,29,19,48,2011
96,Rodney Stuckey,DET,70,2183,361,807,276,85,124,38,114,33,52,2011
97,Andray Blatche,WAS,64,2172,144,341,91,53,44,14,33,17,36,2011
98,Brandon Jennings,MIL,63,2169,305,688,227,78,97,33,97,37,41,2011
99,Luke Ridnour,MIN,71,2159,384,895,257,127,143,47,67,26,101,2011
100,Kirk Hinrich,ATL,72,2157,288,636,228,60,87,46,95,18,42,2011
101,Tim Duncan,SAS,76,2156,203,459,150,53,83,32,35,23,30,2011
102,Rudy Gay,MEM,54,2152,153,338,121,32,54,29,38,12,20,2011
103,George Hill,SAS,76,2148,193,463,116,77,52,28,36,28,49,2011
104,Jared Dudley,PHX,82,2139,108,247,77,31,40,9,28,12,19,2011
105,Thaddeus Young,PHI,82,2135,82,188,58,24,32,8,18,5,19,2011
106,Ramon Sessions,CLE,81,2133,419,945,312,107,158,59,95,37,70,2011
107,Ben Gordon,DET,82,2131,171,403,110,61,63,19,28,22,39,2011
108,Eric Gordon,LAC,56,2112,244,546,186,58,108,36,42,19,39,2011
109,Tyreke Evans,SAC,57,2107,319,728,229,90,114,37,78,34,56,2011
110,Danilo Gallinari,DEN,62,2104,104,240,72,32,45,6,21,14,18,2011
111,Ty Lawson,DEN,80,2102,377,893,238,139,175,18,45,36,103,2011
112,Jose Calderon,TOR,68,2102,605,1276,539,66,295,75,169,17,49,2011
113,Raja Bell,UTA,68,2097,118,260,94,24,45,21,28,5,19,2011
114,Ryan Gomes,LAC,76,2095,118,275,79,39,52,12,15,14,25,2011
115,Luc Mbah a Moute,MIL,79,2093,68,160,44,24,20,6,18,7,17,2011
116,Anthony Parker,CLE,72,2091,218,474,180,38,102,27,51,8,30,2011
117,Chuck Hayes,HOU,74,2079,202,439,167,35,89,26,52,8,27,2011
118,Wesley Johnson,MIN,79,2069,148,324,120,28,73,21,26,16,12,2011
119,Jodie Meeks,PHI,74,2062,78,175,59,19,23,11,25,6,13,2011
120,Kris Humphries,NJN,74,2061,84,191,61,23,26,16,19,8,15,2011
121,Tyson Chandler,DAL,74,2059,32,74,22,10,7,3,12,0,10,2011
122,Vince Carter,PHX,73,2052,146,346,92,54,40,26,26,23,31,2011
123,Thabo Sefolosha,OKC,79,2049,111,237,96,15,52,15,29,2,13,2011
124,DeAndre Jordan,LAC,80,2047,42,87,39,3,27,5,7,2,1,2011
125,Nick Young,WAS,64,2034,75,164,61,14,28,14,19,3,11,2011
126,Marcin Gortat,PHX,80,2033,70,172,38,32,19,3,16,13,19,2011
127,Carl Landry,NOH,76,2008,63,151,38,25,11,7,20,6,19,2011
128,Andrei Kirilenko,UTA,64,1999,192,400,176,16,95,28,53,4,12,2011
129,Brandon Bass,ORL,76,1980,57,141,30,27,19,6,5,9,18,2011
130,Toney Douglas,NYK,81,1971,244,578,154,90,74,28,52,37,53,2011
131,CJ Miles,UTA,78,1969,135,304,101,34,54,13,34,12,22,2011
132,JR Smith,DEN,79,1967,175,412,113,62,79,9,25,26,36,2011
133,Marco Belinelli,NOH,80,1957,92,199,77,15,39,16,22,8,7,2011
134,Samuel Dalembert,SAC,80,1938,67,146,55,12,30,8,17,3,9,2011
135,Carlos Boozer,CHI,59,1882,145,336,99,46,59,10,30,8,38,2011
136,O.J. Mayo,MEM,71,1869,145,320,115,30,62,34,19,16,14,2011
137,Daniel Gibson,CLE,67,1865,201,456,147,54,63,32,52,17,37,2011
138,Marvin Williams,ATL,65,1864,88,195,69,19,25,7,37,5,14,2011
139,Anthony Morrow,NJN,58,1856,68,144,60,8,22,16,22,5,3,2011
140,Amir Johnson,TOR,72,1853,81,176,67,14,33,12,22,5,9,2011
141,Antawn Jamison,CLE,56,1842,93,219,60,33,37,6,17,9,24,2011
142,Eric Bledsoe,LAC,81,1841,289,641,226,63,144,26,56,24,39,2011
143,Rashard Lewis,WAS,57,1825,92,214,62,30,26,15,21,11,19,2011
144,Rudy Fernandez,POR,78,1821,193,439,140,53,77,20,43,33,20,2011
145,Evan Turner,PHI,78,1797,159,347,130,29,69,16,45,13,16,2011
146,Gilbert Arenas,ORL,70,1796,274,632,190,84,116,31,43,19,65,2011
147,Jordan Farmar,NJN,73,1796,368,799,305,63,128,55,122,26,37,2011
148,Mo Williams,LAC,58,1789,380,840,300,80,185,41,74,16,64,2011
149,Ronnie Brewer,CHI,81,1781,140,308,112,28,59,21,32,8,20,2011
150,Marcus Thornton,SAC,73,1776,135,289,116,19,55,23,38,11,8,2011
151,Keyon Dooling,MIL,80,1756,243,531,198,45,87,21,90,16,29,2011
152,Brandon Rush,IND,67,1754,62,140,46,16,19,11,16,9,7,2011
153,Jason Thompson,SAC,75,1748,88,196,68,20,32,10,26,4,16,2011
154,Lou Williams,PHI,75,1747,252,538,218,34,102,35,81,13,21,2011
155,Taj Gibson,CHI,80,1742,58,138,36,22,16,4,16,6,16,2011
156,Chase Budinger,HOU,78,1737,127,286,95,32,57,20,18,7,25,2011
157,DeJuan Blair,SAS,81,1734,77,175,56,21,33,8,15,10,11,2011
158,Courtney Lee,HOU,81,1727,100,238,62,38,30,10,22,10,28,2011
159,Jarrett Jack,NOH,83,1722,242,530,196,46,90,29,77,16,30,2011
160,Spencer Hawes,PHI,81,1718,121,269,94,27,41,22,31,10,17,2011
161,Kwame Brown,CHA,66,1714,43,93,36,7,18,5,13,2,5,2011
162,Omri Casspi,SAC,71,1702,74,160,62,12,34,12,16,3,9,2011
163,Darko Milicic,MIN,69,1686,104,227,85,19,40,16,29,4,15,2011
164,Tracy McGrady,DET,72,1686,252,558,198,54,115,30,53,28,26,2011
165,Gary Neal,SAS,80,1684,96,228,60,36,22,14,24,18,18,2011
166,Mike Dunleavy,IND,61,1683,105,244,71,34,49,13,9,10,24,2011
167,Willie Green,NOH,77,1674,74,164,58,16,24,8,26,8,8,2011
168,J.J. Barea,DAL,81,1669,317,713,238,79,106,49,83,31,48,2011
169,Charlie Villanueva,DET,76,1666,48,103,41,7,26,6,9,3,4,2011
170,Al Harrington,DEN,73,1664,101,235,68,33,43,11,14,14,19,2011
171,Gerald Henderson,CHA,68,1661,101,223,80,21,43,9,28,5,16,2011
172,Baron Davis,CLE,58,1649,391,857,316,75,230,31,55,18,57,2011
173,Kyle Korver,CHI,82,1649,124,265,107,17,68,16,23,7,10,2011
174,Sasha Vujacic,NJN,66,1647,132,294,102,30,46,25,31,10,20,2011
175,Dante Cunningham,CHA,78,1637,43,97,32,11,17,3,12,4,7,2011
176,Reggie Williams,GSW,80,1626,121,283,80,41,44,14,22,15,26,2011
177,Darrell Arthur,MEM,80,1608,53,116,43,10,26,9,8,1,9,2011
178,Ed Davis,TOR,65,1602,40,83,37,3,20,7,10,1,2,2011
179,Josh McRoberts,IND,72,1597,150,349,101,49,56,19,26,12,37,2011
180,Carlos Delfino,MIL,49,1590,112,249,87,25,46,16,25,8,17,2011
181,Steve Blake,LAL,79,1581,170,380,130,40,76,22,32,14,26,2011
182,Mario Chalmers,MIA,70,1579,177,400,131,46,66,13,52,23,23,2011
183,Sam Young,MEM,78,1577,71,154,59,12,36,13,10,3,9,2011
184,Joakim Noah,CHI,48,1576,107,235,86,21,56,10,20,3,18,2011
185,Nenad Krstic,BOS,71,1571,27,62,19,8,12,0,7,0,8,2011
186,Shannon Brown,LAL,82,1568,96,221,67,29,34,13,20,10,19,2011
187,Earl Watson,UTA,80,1567,278,607,227,51,119,28,80,11,40,2011
188,Randy Foye,LAC,63,1551,170,378,132,38,81,10,41,15,23,2011
189,James Jones,MIA,81,1549,43,101,28,15,12,5,11,6,9,2011
190,Maurice Evans,WAS,73,1549,45,100,35,10,8,6,21,7,3,2011
191,Marcus Camby,POR,59,1541,121,251,112,9,75,16,21,2,7,2011
192,Derrick Favors,UTA,78,1536,39,85,32,7,19,6,7,3,4,2011
193,Tyler Hansbrough,IND,70,1536,41,101,22,19,9,4,9,3,16,2011
194,Nick Collison,OKC,71,1524,69,156,51,18,31,7,13,3,15,2011
195,JJ Redick,ORL,59,1513,102,245,61,41,30,12,19,19,22,2011
196,Corey Brewer,DAL,69,1510,89,199,68,21,37,18,13,9,12,2011
197,Ersan Ilyasova,MIL,60,1505,56,131,37,19,18,3,16,10,9,2011
198,Andrew Bynum,LAL,54,1500,73,170,49,24,19,8,22,7,17,2011
199,Richard Hamilton,DET,55,1498,171,368,145,26,86,21,38,10,16,2011
200,Jerryd Bayless,TOR,71,1495,266,590,208,58,89,26,93,17,41,2011
201,Tony Allen,MEM,72,1494,104,219,93,11,51,16,26,5,6,2011
202,Joel Anthony,MIA,75,1463,24,55,17,7,7,3,7,5,2,2011
203,Keith Bogans,CHI,82,1461,101,220,83,18,38,18,27,4,14,2011
204,Al-Farouq Aminu,LAC,81,1452,60,132,48,12,26,8,14,6,6,2011
205,Austin Daye,DET,72,1446,78,179,55,23,34,11,10,16,7,2011
206,Matt Bonner,SAS,66,1432,60,140,40,20,13,11,16,14,6,2011
207,Ryan Anderson,ORL,64,1424,52,124,32,20,14,7,11,10,10,2011
208,Hakim Warrick,PHX,80,1415,69,160,47,22,22,3,22,6,16,2011
209,Sonny Weems,TOR,59,1413,104,232,80,24,47,11,22,7,17,2011
210,Corey Maggette,MIL,67,1400,84,196,56,28,27,10,19,14,14,2011
211,Andris Biedrins,GSW,59,1397,60,137,43,17,24,6,13,6,11,2011
212,Leandro Barbosa,TOR,58,1395,119,262,95,24,58,15,22,15,9,2011
213,Antonio McDyess,SAS,73,1386,84,197,55,29,30,10,15,11,18,2011
214,Francisco Garcia,SAC,58,1386,71,160,53,18,21,11,21,10,8,2011
215,Al Thornton,GSW,71,1384,62,145,41,21,14,7,20,8,13,2011
216,Anthony Tolliver,MIN,65,1362,82,187,59,23,20,18,21,11,12,2011
217,Brendan Haywood,DAL,72,1331,19,47,10,9,3,0,7,5,4,2011
218,Shawne Williams,NYK,64,1323,47,113,28,19,12,3,13,6,13,2011
219,Brandon Roy,POR,47,1310,129,310,77,52,34,9,34,24,28,2011
220,Aaron Brooks,PHX,59,1284,233,521,178,55,91,40,47,15,40,2011
221,Nazr Mohammed,OKC,75,1280,23,50,19,4,9,4,6,1,3,2011
222,Paul George,IND,61,1265,65,144,51,14,27,3,21,3,11,2011
223,Shaun Livingston,CHA,73,1261,164,351,141,23,57,18,66,8,15,2011
224,Zaza Pachulia,ATL,79,1244,58,124,50,8,23,9,18,4,4,2011
225,Ben Wallace,DET,54,1238,72,156,60,12,27,6,27,7,5,2011
226,Goran Dragic,HOU,70,1234,204,477,135,69,72,24,39,16,53,2011
227,Kenyon Martin,DEN,48,1233,109,243,84,25,55,6,23,9,16,2011
228,Gordon Hayward,UTA,72,1218,81,180,63,18,32,13,18,4,14,2011
229,Eric Maynor,OKC,82,1199,238,552,162,76,95,15,52,29,47,2011
230,Carlos Arroyo,BOS,64,1185,125,266,109,16,43,8,58,3,13,2011
231,Ryan Hollins,CLE,70,1182,26,58,20,6,8,2,10,4,2,2011
232,Wayne Ellington,MIN,62,1181,72,170,46,26,21,17,8,13,13,2011
233,Kurt Thomas,CHI,52,1178,60,135,45,15,26,5,14,3,12,2011
234,Vladimir Radmanovic,GSW,74,1169,79,182,55,24,31,10,14,8,16,2011
235,DeShawn Stevenson,DAL,72,1158,77,181,50,27,24,4,22,10,17,2011
236,Zydrunas Ilgauskas,MIA,72,1145,26,58,20,6,8,1,11,1,5,2011
237,Ronny Turiaf,NYK,64,1141,92,221,55,37,21,6,28,12,25,2011
238,Donte Greene,SAC,69,1127,48,107,37,11,19,8,10,4,7,2011
239,Will Bynum,DET,61,1125,195,463,122,73,59,13,50,25,48,2011
240,Jordan Hill,HOU,72,1124,29,68,19,10,8,3,8,3,7,2011
241,Alonzo Gee,CLE,56,1117,38,86,28,10,14,2,12,1,9,2011
242,Yi Jianlian,WAS,63,1112,25,57,18,7,10,3,5,1,6,2011
243,Mickael Pietrus,PHX,57,1107,33,77,22,11,14,2,6,3,8,2011
244,Jason Smith,NOH,77,1102,36,77,31,5,12,6,13,3,2,2011
245,Martell Webster,MIN,46,1094,53,117,42,11,19,10,13,5,6,2011
246,C.J. Watson,CHI,82,1090,186,418,140,46,60,10,70,16,30,2011
247,Trevor Booker,WAS,65,1063,35,78,27,8,14,2,11,0,8,2011
248,Jamario Moon,LAC,59,1042,52,114,42,10,21,9,12,4,6,2011
249,Linas Kleiza,TOR,39,1032,40,93,27,13,9,6,12,2,11,2011
250,Ekpe Udoh,GSW,58,1030,40,92,28,12,13,2,13,4,8,2011
251,Jordan Crawford,WAS,42,1027,117,245,106,11,56,20,30,9,2,2011
252,Matt Barnes,LAL,53,1020,71,163,50,21,24,17,9,14,7,2011
253,Brad Miller,HOU,60,1015,145,322,113,32,66,19,28,9,23,2011
254,Nate Robinson,OKC,59,1013,111,240,93,18,46,13,34,4,14,2011
255,Chris Wilcox,DET,57,995,43,92,37,6,24,4,9,4,2,2011
256,Anderson Varejao,CLE,31,994,45,103,32,13,11,5,16,5,8,2011
257,Robin Lopez,PHX,67,991,8,18,6,2,4,1,1,0,2,2011
258,Omer Asik,CHI,82,989,32,67,29,3,8,1,20,1,2,2011
259,Jonny Flynn,MIN,53,983,182,434,112,70,60,21,31,9,61,2011
260,Eddie House,MIA,56,978,62,142,44,18,23,4,17,12,6,2011
261,Jeff Teague,ATL,70,962,138,313,101,37,47,7,47,17,20,2011
262,Stephen Graham,NJN,59,958,40,89,31,9,11,5,15,3,6,2011
263,Quentin Richardson,ORL,57,955,38,88,26,12,16,8,2,3,9,2011
264,Christian Eyenga,CLE,44,947,35,77,28,7,14,5,9,2,5,2011
265,Jeff Foster,IND,56,940,46,111,27,19,12,4,11,2,17,2011
266,Marquis Daniels,BOS,49,938,64,146,46,18,26,1,19,6,12,2011
267,Manny Harris,CLE,54,933,85,195,60,25,35,10,15,7,18,2011
268,Andres Nocioni,PHI,54,931,45,97,38,7,10,12,16,2,5,2011
269,Jason Maxiell,DET,57,930,17,36,15,2,7,0,8,1,1,2011
270,Shelden Williams,NYK,59,910,32,77,19,13,10,2,7,4,9,2011
271,Josh Childress,PHX,54,894,42,98,28,14,15,3,10,4,10,2011
272,Johan Petro,NJN,77,893,44,100,32,12,15,4,13,2,10,2011
273,Nikola Pekovic,MIN,65,887,27,59,22,5,8,4,10,0,5,2011
274,Chris Douglas-Roberts,MIL,44,884,50,114,36,14,13,6,17,7,7,2011
275,Larry Sanders,MIL,60,872,16,39,9,7,4,1,4,5,2,2011
276,Patrick Patterson,HOU,52,867,41,98,25,16,11,2,12,3,13,2011
277,Caron Butler,DAL,29,867,46,113,25,21,13,4,8,7,14,2011
278,Earl Boykins,MIL,57,862,141,319,104,37,35,13,56,14,23,2011
279,Tyrus Thomas,CHA,41,861,29,61,26,3,16,4,6,2,1,2011
280,Drew Gooden,MIL,35,860,47,103,38,9,21,11,6,6,3,2011
281,Greivis Vasquez,MEM,70,860,151,318,135,16,59,29,47,9,7,2011
282,Pooh Jeter,SAC,62,858,162,361,125,37,62,23,40,17,20,2011
283,James Posey,IND,49,839,34,88,14,20,7,0,7,6,14,2011
284,Mike Miller,MIA,41,838,51,116,37,14,21,3,13,8,6,2011
285,Chris Kaman,LAC,32,838,46,99,39,7,27,4,8,2,5,2011
286,James Johnson,TOR,38,821,89,189,78,11,44,12,22,5,6,2011
287,Erick Dampier,MIA,51,815,22,48,18,4,8,1,9,2,2,2011
288,Reggie Evans,TOR,30,798,38,83,31,7,16,5,10,2,5,2011
289,AJ Price,IND,50,795,111,263,70,41,26,8,36,11,30,2011
290,Gary Forbes,DEN,63,791,49,120,27,22,20,0,7,7,15,2011
291,Henry Walker,NYK,61,784,34,85,17,17,8,4,5,8,9,2011
292,Patty Mills,POR,64,782,109,253,74,35,30,3,41,18,17,2011
293,Chris Duhon,ORL,51,774,118,292,62,56,32,6,24,15,41,2011
294,T.J. Ford,IND,41,773,141,349,74,67,46,8,20,19,48,2011
295,Rasual Butler,CHI,47,770,27,62,19,8,13,4,2,5,3,2011
296,Julian Wright,TOR,52,766,58,123,51,7,31,8,12,2,5,2011
297,Dominic McGuire,CHA,52,760,43,90,39,4,22,3,14,1,3,2011
298,Shaquille O'Neal,BOS,37,752,26,53,25,1,20,2,3,1,0,2011
299,Kendrick Perkins,OKC,29,742,26,62,16,10,9,3,4,1,9,2011
300,Tiago Splitter,SAS,60,738,26,62,16,10,6,5,5,2,8,2011
301,Marreese Speights,PHI,64,734,30,63,27,3,19,4,4,1,2,2011
302,Quincy Pondexter,NOH,66,734,28,64,20,8,8,9,3,1,7,2011
303,Chris Andersen,DEN,45,732,20,45,15,5,8,1,6,2,3,2011
304,Acie Law,GSW,51,726,84,187,65,19,32,7,26,8,11,2011
305,Ronnie Price,UTA,59,717,56,126,42,14,24,6,12,3,11,2011
306,Sebastian Telfair,MIN,37,711,111,267,66,45,26,17,23,14,31,2011
307,Samardo Samuels,CLE,37,701,17,37,14,3,3,2,9,2,1,2011
308,Lou Amundson,GSW,46,691,17,37,14,3,11,1,2,1,2,2011
309,DJ White,CHA,47,685,19,43,14,5,6,0,8,2,3,2011
310,Jon Brockman,MIL,63,677,18,42,12,6,5,2,5,3,3,2011
311,Damien Wilkins,ATL,52,676,41,90,33,8,12,5,16,2,6,2011
312,Josh Powell,ATL,54,653,22,47,19,3,9,4,6,1,2,2011
313,Luke Harangody,CLE,49,641,30,75,15,15,5,3,7,4,11,2011
314,Kevin Seraphin,WAS,58,635,10,23,7,3,4,1,2,0,3,2011
315,Brian Cardinal,DAL,56,618,40,101,19,21,8,5,6,11,10,2011
316,Peja Stojakovic,DAL,33,616,29,68,19,10,11,2,6,2,8,2011
317,Francisco Elson,UTA,62,610,33,75,24,9,10,5,9,2,7,2011
318,Jared Jeffries,NYK,42,601,36,87,21,15,8,2,11,3,12,2011
319,Daequan Cook,OKC,43,598,20,45,15,5,8,4,3,0,5,2011
320,Semih Erden,CLE,41,595,20,43,17,3,8,2,7,1,2,2011
321,Jason Collins,ATL,49,593,22,48,18,4,7,4,7,1,3,2011
322,Juwan Howard,MIA,57,592,23,59,10,13,5,1,4,6,7,2011
323,Anthony Randolph,MIN,40,590,33,75,24,9,12,5,7,2,7,2011
324,Dahntay Jones,IND,45,589,33,71,28,5,12,5,11,0,5,2011
325,Joey Graham,CLE,39,586,18,43,11,7,5,1,5,2,5,2011
326,Craig Smith,LAC,48,586,31,68,25,6,10,3,12,1,5,2011
327,Luther Head,SAC,36,586,70,152,58,12,23,9,26,3,9,2011
328,Matt Carroll,CHA,54,582,23,52,17,6,10,0,7,1,5,2011
329,Derrick Brown,NYK,49,575,33,71,28,5,12,7,9,2,3,2011
330,Von Wafer,BOS,58,552,35,72,33,2,21,4,8,1,1,2011
331,Cartier Martin,WAS,52,542,18,39,15,3,9,3,3,1,2,2011
332,Aaron Gray,NOH,41,531,16,34,14,2,6,4,4,1,1,2011
333,Solomon Jones,IND,39,528,30,67,23,7,3,2,18,1,6,2011
334,Xavier Henry,MEM,38,527,18,40,14,4,5,2,7,1,3,2011
335,Timofey Mozgov,DEN,45,524,15,37,8,7,4,1,3,0,7,2011
336,Joey Dorsey,TOR,43,522,27,55,26,1,16,4,6,0,1,2011
337,Joel Przybilla,CHA,36,520,13,28,11,2,3,1,7,0,2,2011
338,Rodrigue Beaubois,DAL,28,496,64,149,43,21,20,4,19,4,17,2011
339,Hilton Armstrong,ATL,53,489,14,32,10,4,3,6,1,0,4,2011
340,Ian Mahinmi,DAL,56,488,8,21,3,5,1,0,2,3,2,2011
341,Darnell Jackson,SAC,59,486,14,33,9,5,5,3,1,2,3,2011
342,Luke Walton,LAL,54,484,62,137,49,13,31,7,11,4,9,2011
343,Jermaine Taylor,SAC,34,482,32,68,28,4,13,7,8,1,3,2011
344,Ike Diogu,LAC,36,470,2,4,2,0,2,0,0,0,0,2011
345,Troy Murphy,BOS,35,466,23,56,13,10,6,5,2,1,9,2011
346,Earl Clark,ORL,42,464,9,20,7,2,4,2,1,1,1,2011
347,Anthony Carter,NYK,33,463,69,158,49,20,28,8,13,5,15,2011
348,Jeremy Evans,UTA,49,463,24,55,17,7,2,2,13,1,6,2011
349,Dan Gadzuric,NJN,42,463,14,34,8,6,3,3,2,3,3,2011
350,Kyrylo Fesenko,UTA,53,456,18,37,17,1,10,2,5,0,1,2011
351,Delonte West,BOS,24,453,64,137,55,9,27,11,17,5,4,2011
352,Brian Cook,LAC,40,447,15,35,10,5,5,1,4,0,5,2011
353,Ish Smith,MEM,43,442,79,182,55,24,29,4,22,8,16,2011
354,Ben Uzoh,NJN,42,438,69,146,61,8,16,6,39,5,3,2011
355,Kosta Koufos,DEN,50,433,7,15,6,1,2,0,4,0,1,2011
356,Jermaine O'Neal,BOS,24,431,12,25,11,1,5,3,3,0,1,2011
357,Lazar Hayward,MIN,42,419,28,59,25,3,12,8,5,3,0,2011
358,Josh Howard,WAS,18,409,24,51,21,3,9,4,8,0,3,2011
359,Damion James,NJN,25,403,20,44,16,4,7,4,5,2,2,2011
360,Jawad Williams,CLE,26,391,22,49,17,5,8,4,5,1,4,2011
361,Brandan Wright,NJN,37,379,12,26,10,2,4,3,3,0,2,2011
362,Tony Battie,PHI,38,377,12,26,10,2,5,2,3,0,2,2011
363,Hasheem Thabeet,HOU,47,373,4,10,2,2,1,0,1,0,2,2011
364,David Andersen,NOH,40,372,13,28,11,2,7,0,4,2,0,2011
365,Eduardo Najera,CHA,31,372,20,44,16,4,9,2,5,1,3,2011
366,Melvin Ely,DEN,30,366,14,32,10,4,5,0,5,1,3,2011
367,Sasha Pavlovic,BOS,31,362,16,36,12,4,3,1,8,3,1,2011
368,Quinton Ross,NJN,36,353,10,23,7,3,1,3,3,0,3,2011
369,Udonis Haslem,MIA,13,345,6,16,2,4,0,0,2,2,2,2011
370,Alexis Ajinca,TOR,34,340,10,23,7,3,3,2,2,1,2,2011
371,Rodney Carney,MEM,27,335,11,25,8,3,3,3,2,0,3,2011
372,DJ Mbenga,NOH,41,330,6,14,4,2,1,0,3,1,1,2011
373,Leon Powe,MEM,30,328,7,15,6,1,1,1,4,0,1,2011
374,Othyus Jeffers,WAS,17,322,20,46,14,6,8,4,2,3,3,2011
375,Roger Mason Jr.,NYK,26,319,20,46,14,6,11,1,2,2,4,2011
376,Earl Barron,POR,21,305,11,26,7,4,3,0,4,1,3,2011
377,Sundiata Gaines,NJN,24,300,42,99,27,15,11,6,10,3,12,2011
378,Jason Williams,MEM,27,295,52,113,43,9,24,7,12,1,8,2011
379,Chris Quinn,SAS,41,292,42,99,27,15,14,3,10,5,10,2011
380,Zabian Dowdell,PHX,24,292,51,115,38,13,21,7,10,7,6,2011
381,Terrence Williams,HOU,21,290,38,83,31,7,16,6,9,4,3,2011
382,James Anderson,SAS,25,286,18,40,14,4,3,5,6,2,2,2011
383,Jeremy Lin,GSW,29,285,42,100,26,16,16,2,8,6,10,2011
384,Armon Johnson,POR,38,277,45,107,28,17,19,0,9,8,9,2011
385,Garrett Temple,CHA,24,230,32,69,27,5,10,4,13,3,2,2011
386,Derrick Caracter,LAL,41,215,7,14,7,0,2,2,3,0,0,2011
387,Steve Novak,SAS,30,215,3,7,2,1,1,0,1,0,1,2011
388,Sean Marks,POR,29,208,4,9,3,1,0,0,3,0,1,2011
389,DaJuan Summers,DET,22,199,2,4,2,0,0,0,2,0,0,2011
390,Jeff Adrien,GSW,23,196,10,22,8,2,3,2,3,1,1,2011
391,Jarron Collins,POR,28,181,2,5,1,1,0,0,1,1,0,2011
392,DeSagana Diop,CHA,16,181,7,17,4,3,0,3,1,0,3,2011
393,Malik Allen,ORL,18,178,4,12,0,4,0,0,0,0,4,2011
394,Charlie Bell,GSW,19,171,13,31,8,5,7,0,1,4,1,2011
395,Mehmet Okur,UTA,13,168,19,48,9,10,6,1,2,0,10,2011
396,Hamed Haddadi,MEM,30,168,5,10,5,0,3,0,2,0,0,2011
397,Avery Bradley,BOS,31,162,12,27,9,3,4,2,3,1,2,2011
398,Mustafa Shakur,WAS,22,159,25,56,19,6,11,3,5,3,3,2011
399,Jamaal Magloire,MIA,18,158,3,6,3,0,0,1,2,0,0,2011
400,Royal Ivey,OKC,25,155,7,15,6,1,3,1,2,0,1,2011
401,Larry Owens,WAS,12,143,8,17,7,1,3,2,2,0,1,2011
402,Cole Aldrich,OKC,18,141,4,10,2,2,1,0,1,1,1,2011
403,Chris Johnson,POR,14,139,3,6,3,0,3,0,0,0,0,2011
404,Luke Babbitt,POR,24,137,6,15,3,3,1,0,2,2,1,2011
405,Dominique Jones,DAL,18,135,19,50,7,12,3,1,3,6,6,2011
406,Michael Redd,MIL,10,134,12,27,9,3,5,1,3,0,3,2011
407,Willie Warren,LAC,19,134,27,65,16,11,8,3,5,4,7,2011
408,Ime Udoka,SAS,20,130,13,31,8,5,2,4,2,1,4,2011
409,Devin Ebanks,LAL,20,118,2,4,2,0,2,0,0,0,0,2011
410,Mario West,NJN,6,116,10,24,6,4,1,3,2,1,3,2011
411,Lance Stephenson,IND,12,115,21,44,19,2,11,1,7,0,2,2011
412,Jason Kapono,PHI,24,111,4,9,3,1,1,2,0,1,0,2011
413,Garret Siler,PHX,21,101,3,6,3,0,2,0,1,0,0,2011
414,Trey Johnson,LAL,8,94,11,22,11,0,6,2,3,0,0,2011
415,Danny Green,SAS,8,91,2,5,1,1,0,1,0,0,1,2011
416,Yao Ming,HOU,5,91,4,9,3,1,2,1,0,0,1,2011
417,Brian Scalabrine,CHI,18,88,6,14,4,2,3,1,0,1,1,2011
418,Byron Mullens,OKC,13,85,0,0,0,0,0,0,0,0,0,2011
419,Etan Thomas,ATL,13,82,2,4,2,0,0,0,2,0,0,2011
420,Hamady Ndiaye,WAS,16,80,0,0,0,0,0,0,0,0,0,2011
421,Lester Hudson,WAS,11,73,17,37,14,3,6,1,7,1,2,2011
422,Darius Songaila,PHI,10,71,2,4,2,0,1,0,1,0,0,2011
423,Theo Ratliff,LAL,10,70,3,6,3,0,1,0,2,0,0,2011
424,Kyle Weaver,UTA,5,69,7,16,5,2,3,1,1,1,1,2011
425,Joe Smith,LAL,16,69,4,8,4,0,1,3,0,0,0,2011
426,Sherron Collins,CHA,20,66,8,17,7,1,4,0,3,1,0,2011
427,Renaldo Balkman,NYK,8,63,2,6,0,2,0,0,0,0,2,2011
428,Solomon Alabi,TOR,12,59,2,4,2,0,2,0,0,0,0,2011
429,DeMarre Carroll,HOU,12,50,4,10,2,2,1,0,1,0,2,2011
430,Jerry Stackhouse,MIA,7,50,3,7,2,1,0,0,2,0,1,2011
431,Fabricio Oberto,POR,5,45,0,0,0,0,0,0,0,0,0,2011
432,Antonio Daniels,PHI,4,35,2,4,2,0,1,1,0,0,0,2011
433,Pops Mensah-Bonsu,NOH,7,35,2,4,2,0,0,1,1,0,0,2011
434,Craig Brackins,PHI,3,33,1,2,1,0,1,0,0,0,0,2011
435,Antoine Wright,SAC,7,31,0,0,0,0,0,0,0,0,0,2011
436,Maurice Ager,MIN,4,29,1,2,1,0,0,1,0,0,0,2011
437,Andy Rautins,NYK,5,24,3,6,3,0,3,0,0,0,0,2011
438,Morris Peterson,OKC,4,23,1,3,0,1,0,0,0,0,1,2011
439,Marcus Banks,TOR,3,22,3,7,2,1,1,0,1,0,1,2011
440,Pape Sy,ATL,3,21,2,5,1,1,1,0,0,0,1,2011
441,Patrick Ewing,NOH,7,19,2,4,2,0,1,1,0,0,0,2011
442,Marcus Cousin,UTA,4,18,0,0,0,0,0,0,0,0,0,2011
443,Mike Harris,HOU,4,16,1,3,0,1,0,0,0,0,1,2011
444,Bobby Simmons,SAS,2,16,2,4,2,0,1,1,0,0,0,2011
445,Ronald Dupree,TOR,3,13,1,3,0,1,0,0,0,0,1,2011
446,Dexter Pittman,MIA,2,11,0,0,0,0,0,0,0,0,0,2011
447,John Lucas III,CHI,2,10,1,2,1,0,1,0,0,0,0,2011
448,Brian Skinner,MIL,2,6,0,0,0,0,0,0,0,0,0,2011
449,Orien Greene,NJN,3,5,1,2,1,0,1,0,0,0,0,2011
450,Gani Lawal,PHX,1,2,0,0,0,0,0,0,0,0,0,2011
451,Hassan Whiteside,SAC,1,2,0,0,0,0,0,0,0,0,0,2011
0,Kevin Durant,OKC,82,3239,231,513,180,51,102,24,54,19,32,2010
1,Andre Iguodala,PHI,82,3193,472,1031,385,87,216,72,97,32,55,2010
2,Rudy Gay,MEM,80,3175,153,336,123,30,69,27,27,14,16,2010
3,Stephen Jackson,CHA,81,3129,300,647,253,47,200,23,30,17,30,2010
4,Gerald Wallace,CHA,76,3120,161,363,120,41,81,16,23,6,35,2010
5,O.J. Mayo,MEM,82,3114,242,531,195,47,132,26,37,19,28,2010
6,Zach Randolph,MEM,81,3051,149,341,106,43,78,19,9,9,34,2010
7,Jeff Green,OKC,82,3043,134,306,96,38,36,20,40,14,24,2010
8,Dirk Nowitzki,DAL,81,3039,218,521,133,85,70,27,36,19,66,2010
9,Brook Lopez,NJN,82,3027,187,409,152,35,95,15,42,8,27,2010
10,David Lee,NYK,81,3019,295,738,147,148,87,14,46,27,121,2010
11,LeBron James,CLE,76,2966,651,1496,457,194,315,50,92,104,90,2010
12,Rajon Rondo,BOS,81,2963,794,1773,609,185,362,70,177,49,136,2010
13,David West,NOH,81,2949,239,562,155,84,94,28,33,20,64,2010
14,LaMarcus Aldridge,POR,78,2922,160,370,110,50,63,9,38,10,40,2010
15,Aaron Brooks,HOU,82,2919,434,985,317,117,187,44,86,52,65,2010
16,Boris Diaw,CHA,82,2906,325,738,237,88,125,28,84,34,54,2010
17,Stephen Curry,GSW,80,2896,472,1054,362,110,215,34,113,34,76,2010
18,Joe Johnson,ATL,76,2886,369,847,260,109,111,38,111,44,65,2010
19,Jason Kidd,DAL,80,2881,724,1567,605,119,267,97,241,33,86,2010
20,Derrick Rose,CHI,78,2871,469,1043,364,105,153,31,180,48,57,2010
21,Josh Smith,ATL,81,2871,342,790,236,106,156,27,53,54,52,2010
22,Al Horford,ATL,81,2845,189,434,133,56,84,5,44,16,40,2010
23,Dwight Howard,ORL,82,2843,144,362,70,74,53,5,12,14,60,2010
24,Amar'e Stoudemire,PHX,82,2838,82,201,45,37,34,2,9,14,23,2010
25,Kobe Bryant,LAL,73,2836,365,831,264,101,166,39,59,40,61,2010
26,John Salmons,MIL,81,2825,223,510,159,64,68,30,61,21,43,2010
27,Ray Allen,BOS,80,2819,210,452,178,32,120,24,34,11,21,2010
28,Russell Westbrook,OKC,82,2813,652,1442,514,138,262,65,187,31,107,2010
29,Deron Williams,UTA,76,2802,798,1750,644,154,374,83,187,48,106,2010
30,Andrea Bargnani,TOR,80,2799,93,214,65,28,39,8,18,13,15,2010
31,Dwyane Wade,MIA,77,2793,501,1148,355,146,175,63,117,62,84,2010
32,Caron Butler,DAL,74,2784,156,357,111,45,52,20,39,15,30,2010
33,Nene,DEN,82,2755,203,467,142,61,76,20,46,16,45,2010
34,Danilo Gallinari,NYK,81,2747,135,306,99,36,44,12,43,15,21,2010
35,Rasual Butler,LAC,82,2702,116,250,98,18,45,25,28,8,10,2010
36,Tyreke Evans,SAC,72,2677,414,960,282,132,123,40,119,30,102,2010
37,Carlos Boozer,UTA,78,2673,247,535,206,41,123,14,69,4,37,2010
38,Luis Scola,HOU,82,2672,169,415,92,77,61,11,20,18,59,2010
39,Brandon Jennings,MIL,82,2671,470,1075,335,135,191,51,93,45,90,2010
40,Steve Nash,PHX,81,2660,892,2001,675,217,403,127,145,65,152,2010
41,Luol Deng,CHI,70,2651,143,316,113,30,61,14,38,12,18,2010
42,Monta Ellis,GSW,64,2647,340,777,243,97,154,25,64,36,61,2010
43,Raymond Felton,CHA,80,2643,446,1010,328,118,230,29,69,48,70,2010
44,Carmelo Anthony,DEN,69,2634,222,504,162,60,119,16,27,22,38,2010
45,Trevor Ariza,HOU,72,2629,276,614,214,62,116,33,65,28,34,2010
46,Chris Kaman,LAC,76,2609,120,274,86,34,62,10,14,5,29,2010
47,Metta World Peace,LAL,77,2605,234,515,187,47,102,41,44,20,27,2010
48,Lamar Odom,LAL,82,2585,267,594,207,60,110,44,53,16,44,2010
49,Mike Conley,MEM,80,2569,425,925,350,75,198,61,91,17,58,2010
50,Jason Terry,DAL,77,2540,292,672,204,88,100,29,75,22,66,2010
51,Chris Bosh,TOR,70,2526,166,388,110,56,58,27,25,10,46,2010
52,Baron Davis,LAC,75,2523,598,1306,488,110,274,86,128,32,78,2010
53,Richard Jefferson,SAS,81,2520,158,356,118,40,58,22,38,14,26,2010
54,Andre Miller,POR,82,2500,445,1003,332,113,180,36,116,46,67,2010
55,Rodney Stuckey,DET,73,2499,348,767,277,71,122,50,105,33,38,2010
56,Brandon Rush,IND,82,2491,112,269,67,45,24,7,36,5,40,2010
57,Chauncey Billups,DEN,73,2490,409,912,315,94,169,41,105,36,58,2010
58,Jason Richardson,PHX,79,2485,143,330,99,44,50,21,28,25,19,2010
59,Corey Brewer,MIN,82,2482,193,419,160,33,58,61,41,13,20,2010
60,Kirk Hinrich,CHI,74,2481,330,698,292,38,122,33,137,18,20,2010
61,Beno Udrih,SAC,79,2477,372,824,292,80,139,44,109,33,47,2010
62,Carl Landry,SAC,80,2469,66,161,37,29,12,8,17,1,28,2010
63,Marc Gasol,MEM,69,2469,165,378,117,48,68,22,27,16,32,2010
64,Marvin Williams,ATL,81,2468,93,209,70,23,30,15,25,8,15,2010
65,Al Jefferson,MIN,76,2463,137,306,105,32,45,13,47,3,29,2010
66,Jamal Crawford,ATL,79,2460,238,519,195,43,100,44,51,18,25,2010
67,Tim Duncan,SAS,78,2438,246,541,197,49,124,25,48,17,32,2010
68,Grant Hill,PHX,81,2430,193,446,133,60,80,20,33,16,44,2010
69,Brandon Roy,POR,65,2419,305,706,209,96,89,18,102,50,46,2010
70,Paul Pierce,BOS,71,2411,218,471,183,35,83,32,68,10,25,2010
71,Antawn Jamison,CLE,66,2406,84,193,59,25,40,4,15,10,15,2010
72,Pau Gasol,LAL,65,2403,218,500,154,64,84,27,43,14,50,2010
73,Shawn Marion,DAL,75,2385,107,251,70,37,29,5,36,7,30,2010
74,Courtney Lee,NJN,71,2375,121,268,95,26,40,16,39,9,17,2010
75,Emeka Okafor,NOH,82,2370,55,127,38,17,22,4,12,1,16,2010
76,Rashard Lewis,ORL,72,2369,107,257,64,43,44,12,8,12,31,2010
77,Mo Williams,CLE,69,2359,368,799,305,63,225,30,50,25,38,2010
78,Jason Thompson,SAC,75,2358,124,281,91,33,48,9,34,13,20,2010
79,Brendan Haywood,DAL,77,2355,43,96,33,10,8,3,22,2,8,2010
80,Thabo Sefolosha,OKC,82,2348,145,314,121,24,52,26,43,6,18,2010
81,Troy Murphy,IND,72,2344,150,354,96,54,49,15,32,6,48,2010
82,Jonny Flynn,MIN,81,2340,356,808,260,96,129,46,85,25,71,2010
83,Michael Beasley,MIA,78,2328,100,231,69,31,31,9,29,13,18,2010
84,Earl Watson,IND,79,2322,399,949,248,151,146,30,72,34,117,2010
85,Wilson Chandler,NYK,65,2320,138,334,80,58,46,6,28,17,41,2010
86,Marcus Camby,POR,74,2315,186,393,165,21,94,27,44,4,17,2010
87,Vince Carter,ORL,75,2311,236,585,123,113,77,26,20,60,53,2010
88,Elton Brand,PHI,76,2297,109,258,69,40,29,9,31,5,35,2010
89,Anthony Parker,CLE,81,2289,157,349,122,35,69,20,33,13,22,2010
90,Carlos Delfino,MIL,75,2279,202,455,151,51,75,20,56,17,34,2010
91,Danny Granger,IND,62,2278,171,407,106,65,54,20,32,20,45,2010
92,Paul Millsap,UTA,82,2277,131,287,106,25,56,12,38,8,17,2010
93,George Hill,SAS,78,2276,226,517,161,65,55,43,63,20,45,2010
94,Hedo Turkoglu,TOR,74,2272,304,696,216,88,101,35,80,35,53,2010
95,Andray Blatche,WAS,81,2256,170,386,124,46,87,12,25,15,31,2010
96,Jarrett Jack,TOR,82,2243,413,911,328,85,162,50,116,27,58,2010
97,Jonas Jerebko,DET,80,2233,58,125,49,9,23,10,16,3,6,2010
98,Andrew Bogut,MIL,69,2230,127,302,79,48,60,9,10,17,31,2010
99,Eric Gordon,LAC,62,2229,186,401,157,29,87,23,47,16,13,2010
100,Derek Fisher,LAL,82,2228,201,434,169,32,90,43,36,9,23,2010
101,Arron Afflalo,DEN,82,2221,138,297,117,21,62,12,43,2,19,2010
102,Devin Harris,NJN,64,2221,423,921,348,75,210,39,99,38,37,2010
103,Ryan Gomes,MIN,76,2210,124,279,93,31,44,22,27,9,22,2010
104,Taj Gibson,CHI,82,2204,70,157,53,17,18,9,26,5,12,2010
105,Al Harrington,NYK,72,2195,110,251,79,31,38,14,27,14,17,2010
106,Mike Bibby,ATL,80,2195,310,663,267,43,149,47,71,27,16,2010
107,Channing Frye,PHX,81,2190,113,279,60,53,28,10,22,25,28,2010
108,Udonis Haslem,MIA,78,2177,52,123,33,19,15,4,14,4,15,2010
109,Shane Battier,HOU,67,2168,164,372,120,44,69,18,33,15,29,2010
110,Anderson Varejao,CLE,76,2166,87,199,62,25,44,6,12,7,18,2010
111,Steve Blake,LAC,80,2159,380,862,278,102,148,45,85,34,68,2010
112,Kendrick Perkins,BOS,78,2154,80,180,60,20,36,8,16,4,16,2010
113,Manu Ginobili,SAS,75,2150,370,817,293,77,173,45,75,39,38,2010
114,Mehmet Okur,UTA,73,2149,119,259,98,21,46,12,40,11,10,2010
115,Thaddeus Young,PHI,67,2145,97,226,65,32,33,14,18,8,24,2010
116,Samuel Dalembert,PHI,82,2124,64,143,49,15,28,8,13,5,10,2010
117,Darren Collison,NOH,76,2109,432,971,325,107,171,45,109,27,80,2010
118,Matt Barnes,ORL,81,2097,134,323,79,55,53,15,11,24,31,2010
119,JR Smith,DEN,75,2082,183,403,146,37,96,15,35,12,25,2010
120,Quentin Richardson,MIA,76,2082,93,202,77,16,36,15,26,5,11,2010
121,Corey Maggette,GSW,70,2081,172,401,115,57,67,14,34,22,35,2010
122,Al Thornton,WAS,75,2079,90,209,61,29,26,16,19,9,20,2010
123,Chris Duhon,NYK,67,2072,378,878,256,122,150,19,87,30,92,2010
124,Kevin Garnett,BOS,69,2060,185,409,146,39,116,14,16,8,31,2010
125,Roy Hibbert,IND,81,2035,158,355,119,39,75,11,33,5,34,2010
126,Wesley Matthews,UTA,82,2025,124,273,99,25,54,12,33,7,18,2010
127,Anthony Morrow,GSW,69,2018,104,248,64,40,30,7,27,15,25,2010
128,Martell Webster,POR,82,2005,62,143,43,19,20,10,13,10,9,2010
129,Jermaine O'Neal,MIA,70,1992,92,211,65,27,34,10,21,8,19,2010
130,Jared Dudley,PHX,82,1991,115,261,84,31,47,11,26,14,17,2010
131,Kenyon Martin,DEN,58,1986,109,252,75,34,45,10,20,7,27,2010
132,Andrew Bynum,LAL,65,1977,68,157,47,21,22,7,18,1,20,2010
133,Ben Wallace,DET,69,1976,105,224,91,14,49,13,29,6,8,2010
134,Brad Miller,CHI,82,1950,154,328,134,20,63,16,55,10,10,2010
135,Peja Stojakovic,NOH,62,1947,92,202,74,18,35,18,21,5,13,2010
136,Omri Casspi,SAC,77,1931,95,206,79,16,46,13,20,1,15,2010
137,Joakim Noah,CHI,64,1925,132,286,110,22,52,14,44,11,11,2010
138,Lou Williams,PHI,64,1912,268,595,209,59,129,25,55,24,35,2010
139,Spencer Hawes,SAC,72,1904,158,347,127,31,77,16,34,13,18,2010
140,Ersan Ilyasova,MIL,81,1898,84,198,54,30,24,11,19,18,12,2010
141,Dahntay Jones,IND,76,1892,150,357,93,57,51,12,30,9,48,2010
142,Marcus Thornton,NOH,73,1872,114,247,95,19,46,16,33,6,13,2010
143,Luc Mbah a Moute,MIL,73,1866,81,192,51,30,21,11,19,9,21,2010
144,Jameer Nelson,ORL,65,1860,353,850,209,144,146,26,37,56,88,2010
145,Charlie Villanueva,DET,78,1847,53,116,43,10,25,6,12,4,6,2010
146,Jose Calderon,TOR,68,1817,404,899,313,91,167,51,95,15,76,2010
147,JJ Redick,ORL,82,1808,158,392,82,76,50,18,14,30,46,2010
148,Mario Chalmers,MIA,73,1807,246,544,194,52,88,18,88,22,30,2010
149,Mike Miller,WAS,54,1805,212,456,180,32,77,43,60,13,19,2010
150,Jared Jeffries,HOU,70,1793,101,241,62,39,38,8,16,4,35,2010
151,C.J. Watson,GSW,65,1788,180,423,117,63,68,9,40,22,41,2010
152,Rasheed Wallace,BOS,79,1780,80,178,62,18,34,10,18,3,15,2010
153,Chuck Hayes,HOU,82,1773,139,317,100,39,61,9,30,9,30,2010
154,Jrue Holiday,PHI,73,1767,280,614,226,54,120,39,67,19,35,2010
155,Terrence Williams,NJN,78,1763,223,514,155,68,78,20,57,27,41,2010
156,Luke Ridnour,MIL,82,1758,324,744,228,96,98,34,96,40,56,2010
157,Drew Gooden,LAC,70,1756,47,109,32,15,20,2,10,4,11,2010
158,Ronnie Brewer,MEM,58,1742,154,334,128,26,78,12,38,9,17,2010
159,Nenad Krstic,OKC,76,1741,52,120,36,16,19,7,10,2,14,2010
160,James Harden,OKC,76,1738,137,299,112,25,63,20,29,8,17,2010
161,Ramon Sessions,MIN,82,1732,258,582,192,66,106,30,56,13,53,2010
162,James Posey,NOH,77,1731,117,261,90,27,53,11,26,10,17,2010
163,Chris Douglas-Roberts,NJN,67,1730,93,214,65,28,27,11,27,13,15,2010
164,Ben Gordon,DET,62,1730,166,375,123,43,60,27,36,16,27,2010
165,Tony Parker,SAS,56,1728,317,741,210,107,109,27,74,52,55,2010
166,Kevin Love,MIN,60,1714,136,284,124,12,68,27,29,4,8,2010
167,Chris Paul,NOH,45,1712,480,1092,348,132,173,48,127,42,90,2010
168,Jason Williams,ORL,82,1703,298,719,175,123,121,17,37,41,82,2010
169,Shannon Brown,LAL,82,1700,108,255,69,39,30,19,20,12,27,2010
170,Chris Andersen,DEN,76,1695,33,74,25,8,15,4,6,0,8,2010
171,JJ Hickson,CLE,81,1691,40,95,25,15,15,3,7,5,10,2010
172,Mickael Pietrus,ORL,75,1687,49,122,25,24,14,9,2,9,15,2010
173,Andrei Kirilenko,UTA,58,1681,158,328,146,12,91,17,38,1,11,2010
174,Flip Murray,CHI,75,1673,135,304,101,34,76,8,17,13,21,2010
175,Randy Foye,WAS,70,1667,228,511,173,55,75,27,71,22,33,2010
176,Will Bynum,DET,63,1666,283,640,209,74,96,28,85,30,44,2010
177,Tayshaun Prince,DET,49,1664,161,361,122,39,35,25,62,13,26,2010
178,DeMar DeRozan,TOR,77,1664,53,119,40,13,15,6,19,4,9,2010
179,Yi Jianlian,NJN,52,1655,47,108,33,14,17,6,10,3,11,2010
180,Kyle Lowry,HOU,68,1651,305,713,202,103,133,26,43,32,71,2010
181,Kevin Martin,HOU,46,1633,111,265,68,43,32,13,23,10,33,2010
182,Juwan Howard,POR,73,1632,61,139,44,17,28,4,12,4,13,2010
183,Donte Greene,SAC,76,1630,71,156,57,14,35,8,14,8,6,2010
184,Antonio McDyess,SAS,77,1617,83,193,56,27,24,16,16,12,15,2010
185,Charlie Bell,MIL,71,1611,104,240,72,32,29,16,27,15,17,2010
186,Damien Wilkins,MIN,80,1585,135,302,103,32,43,27,33,10,22,2010
187,Carlos Arroyo,MIA,72,1585,225,510,165,60,62,19,84,18,42,2010
188,Keith Bogans,SAS,79,1559,95,212,73,22,42,13,18,12,10,2010
189,Hakim Warrick,CHI,76,1557,52,123,33,19,16,8,9,9,10,2010
190,Nick Collison,OKC,75,1557,38,86,28,10,17,5,6,2,8,2010
191,Willie Green,PHI,73,1553,152,359,97,55,36,15,46,18,37,2010
192,Richard Hamilton,DET,46,1552,202,436,170,32,108,20,42,10,22,2010
193,Jason Maxiell,DET,76,1550,39,90,27,12,17,3,7,3,9,2010
194,J.J. Barea,DAL,78,1545,258,579,195,63,83,33,79,27,36,2010
195,Roger Mason Jr.,SAS,79,1514,137,311,100,37,51,14,35,16,21,2010
196,Delonte West,CLE,60,1500,196,429,159,37,86,26,47,12,25,2010
197,CJ Miles,UTA,63,1497,105,227,88,17,53,14,21,7,10,2010
198,Dorell Wright,MIA,72,1496,91,194,79,12,30,7,42,7,5,2010
199,DeJuan Blair,SAS,82,1494,65,149,46,19,27,4,15,11,8,2010
200,Chase Budinger,HOU,74,1488,88,201,63,25,33,11,19,6,19,2010
201,Mike Dunleavy,IND,67,1486,103,236,73,30,44,13,16,8,22,2010
202,Andres Nocioni,SAC,75,1477,75,169,56,19,28,4,24,7,12,2010
203,Jordan Farmar,LAL,82,1474,127,289,92,35,45,25,22,10,25,2010
204,D.J. Augustin,CHA,80,1472,193,428,151,42,80,16,55,14,28,2010
205,Amir Johnson,TOR,82,1453,48,107,37,11,15,11,11,3,8,2010
206,Goran Dragic,PHX,80,1442,241,578,145,96,90,15,40,32,64,2010
207,Rudy Fernandez,POR,62,1441,127,275,106,21,58,13,35,10,11,2010
208,Anthony Tolliver,GSW,46,1428,87,201,60,27,31,7,22,11,16,2010
209,Nick Young,WAS,74,1421,48,101,43,5,15,8,20,0,5,2010
210,Rafer Alston,MIA,52,1421,176,384,144,32,61,25,58,13,19,2010
211,Darius Songaila,NOH,75,1410,70,160,50,20,42,3,5,3,17,2010
212,Antoine Wright,TOR,67,1392,71,156,57,14,26,9,22,5,9,2010
213,Wayne Ellington,MIN,76,1384,74,158,64,10,29,13,22,2,8,2010
214,Sonny Weems,TOR,69,1368,101,226,77,24,41,11,25,3,21,2010
215,Zydrunas Ilgauskas,CLE,64,1339,48,108,36,12,27,2,7,5,7,2010
216,Serge Ibaka,OKC,73,1323,10,23,7,3,4,0,3,2,1,2010
217,Joel Anthony,MIA,80,1322,12,29,7,5,1,1,5,2,3,2010
218,Sam Young,MEM,80,1321,52,113,43,9,27,7,9,2,7,2010
219,Ty Lawson,DEN,65,1317,203,453,156,47,85,22,49,15,32,2010
220,Maurice Evans,ATL,79,1317,48,105,39,9,19,0,20,3,6,2010
221,Jerryd Bayless,POR,74,1304,172,391,125,47,40,16,69,21,26,2010
222,Erick Dampier,DAL,55,1280,31,75,18,13,3,3,12,3,10,2010
223,Eric Maynor,OKC,81,1269,266,594,204,62,105,34,65,13,49,2010
224,Shaquille O'Neal,CLE,53,1240,80,182,58,22,44,3,11,8,14,2010
225,Craig Smith,LAC,75,1232,84,196,56,28,26,5,25,4,24,2010
226,Ryan Hollins,MIN,73,1223,51,107,46,5,16,8,22,1,4,2010
227,Kris Humphries,NJN,69,1221,32,67,29,3,11,6,12,0,3,2010
228,Tyrus Thomas,CHA,54,1220,56,120,48,8,37,3,8,4,4,2010
229,Eddie House,NYK,68,1217,85,200,55,30,36,5,14,10,20,2010
230,T.J. Ford,IND,47,1189,180,421,119,61,72,13,34,19,42,2010
231,Gilbert Arenas,WAS,32,1169,230,498,192,38,100,29,63,11,27,2010
232,Lou Amundson,PHX,79,1168,31,69,24,7,14,4,6,1,6,2010
233,Tyson Chandler,CHA,51,1163,16,33,15,1,6,3,6,0,1,2010
234,Matt Bonner,SAS,65,1161,68,166,38,30,15,11,12,13,17,2010
235,DeAndre Jordan,LAC,70,1137,21,51,12,9,7,1,4,2,7,2010
236,Marco Belinelli,TOR,66,1121,89,195,72,17,40,7,25,8,9,2010
237,Earl Boykins,WAS,67,1117,171,390,123,48,54,18,51,17,31,2010
238,Nate Robinson,BOS,56,1116,163,374,115,48,55,13,47,11,37,2010
239,Larry Hughes,CHA,45,1114,137,305,106,31,78,10,18,11,20,2010
240,Trenton Hassell,NJN,52,1106,50,114,36,14,20,5,11,4,10,2010
241,Zaza Pachulia,ATL,78,1089,42,95,31,11,23,1,7,9,2,2010
242,Marcin Gortat,ORL,81,1088,17,41,10,7,5,0,5,1,6,2010
243,Toney Douglas,NYK,56,1087,112,276,60,52,32,9,19,19,33,2010
244,Daniel Gibson,CLE,56,1068,70,153,57,13,36,11,10,7,6,2010
245,Devin Brown,CHI,50,1060,65,140,55,10,27,13,15,4,6,2010
246,Jamario Moon,CLE,61,1052,49,112,35,14,19,6,10,4,10,2010
247,Kurt Thomas,MIL,70,1049,47,112,29,18,9,5,15,5,13,2010
248,Sergio Rodriguez,NYK,66,1048,212,488,148,64,96,13,39,26,38,2010
249,Josh Boone,NJN,62,1045,29,64,23,6,14,2,7,1,5,2010
250,Jarvis Hayes,NJN,45,1032,40,87,33,7,14,12,7,5,2,2010
251,Marreese Speights,PHI,62,1016,36,81,27,9,16,4,7,1,8,2010
252,Robin Lopez,PHX,51,986,7,15,6,1,2,2,2,0,1,2010
253,Nazr Mohammed,CHA,58,984,28,61,23,5,14,1,8,0,5,2010
254,James Singleton,WAS,57,978,31,70,23,8,12,3,8,1,7,2010
255,Jason Kapono,PHI,57,976,39,85,32,7,15,8,9,3,4,2010
256,Morris Peterson,NOH,46,973,41,89,34,7,16,7,11,3,4,2010
257,Keyon Dooling,NJN,53,970,135,300,105,30,49,15,41,18,12,2010
258,JaVale McGee,WAS,59,968,14,30,12,2,6,4,2,0,2,2010
259,Kyle Korver,UTA,52,952,89,189,78,11,49,16,13,8,3,2010
260,Ime Udoka,SAC,69,944,58,127,47,11,27,6,14,5,6,2010
261,Marquis Daniels,BOS,51,937,66,159,39,27,19,5,15,4,23,2010
262,Glen Davis,BOS,54,933,35,91,14,21,7,4,3,4,17,2010
263,Josh Howard,WAS,35,918,48,111,33,15,20,2,11,2,13,2010
264,Nicolas Batum,POR,37,918,44,98,34,10,16,3,15,0,10,2010
265,Austin Daye,DET,69,915,34,73,29,5,18,8,3,3,2,2010
266,Ryan Anderson,ORL,63,910,37,86,25,12,13,6,6,4,8,2010
267,Vladimir Radmanovic,GSW,41,891,45,102,33,12,23,3,7,4,8,2010
268,David Andersen,HOU,63,891,44,100,32,12,14,4,14,2,10,2010
269,Tony Allen,BOS,54,889,72,155,61,11,26,12,23,3,8,2010
270,Hasheem Thabeet,MEM,68,883,11,24,9,2,5,3,1,0,2,2010
271,DeShawn Stevenson,DAL,64,883,56,126,42,14,18,5,19,2,12,2010
272,Sasha Pavlovic,MIN,71,877,58,122,52,6,18,16,18,2,4,2010
273,Marcus Williams,MEM,62,872,161,334,149,12,77,22,50,4,8,2010
274,Ronny Turiaf,GSW,42,872,90,204,66,24,31,9,26,4,20,2010
275,Julian Wright,NOH,68,871,41,87,36,5,19,4,13,3,2,2010
276,AJ Price,IND,56,865,106,257,61,45,31,11,19,12,33,2010
277,Allen Iverson,PHI,28,864,113,254,85,28,39,16,30,12,16,2010
278,Anthony Carter,DEN,54,859,160,356,124,36,82,11,31,9,27,2010
279,Rodney Carney,PHI,68,857,37,81,30,7,16,6,8,2,5,2010
280,Jerry Stackhouse,MIL,42,855,70,159,51,19,22,8,21,7,12,2010
281,Jannero Pargo,CHI,63,828,89,198,69,20,46,4,19,8,12,2010
282,Luther Head,IND,47,813,72,167,49,23,26,5,18,7,16,2010
283,Theo Ratliff,CHA,49,806,25,53,22,3,9,1,12,0,3,2010
284,Ronnie Price,UTA,60,806,123,268,101,22,56,6,39,5,17,2010
285,Stephen Graham,CHA,70,804,23,54,15,8,8,1,6,5,3,2010
286,Shaun Livingston,WAS,36,795,130,279,111,19,54,18,39,6,13,2010
287,DeMarre Carroll,MEM,71,795,33,73,26,7,14,4,8,4,3,2010
288,Leandro Barbosa,PHX,44,786,64,157,35,29,18,6,11,11,18,2010
289,Chris Hunter,GSW,60,783,37,84,27,10,10,1,16,0,10,2010
290,Reggie Williams,GSW,24,781,66,158,40,26,20,11,9,10,16,2010
291,Henry Walker,NYK,35,768,40,95,25,15,16,4,5,4,11,2010
292,Andris Biedrins,GSW,33,763,57,132,39,18,14,6,19,3,15,2010
293,Devean George,GSW,45,761,32,82,14,18,8,2,4,8,10,2010
294,Joey Graham,DEN,62,759,22,52,14,8,9,2,3,4,4,2010
295,James Johnson,CHI,65,757,48,107,37,11,17,6,14,2,9,2010
296,Anthony Randolph,GSW,33,749,42,90,36,6,20,5,11,1,5,2010
297,Jawad Williams,CLE,54,742,34,82,20,14,8,5,7,8,6,2010
298,Travis Outlaw,LAC,34,730,34,83,19,15,11,1,7,6,9,2010
299,Jodie Meeks,PHI,60,719,39,90,27,12,11,3,13,4,8,2010
300,Jeff Teague,ATL,71,718,122,271,95,27,36,16,43,16,11,2010
301,Michael Finley,BOS,46,709,43,100,29,14,18,4,7,8,6,2010
302,Dante Cunningham,POR,63,707,14,33,9,5,6,1,2,1,4,2010
303,Rodrigue Beaubois,DAL,56,700,74,167,55,19,26,6,23,3,16,2010
304,Daequan Cook,MIA,45,691,43,96,33,10,7,4,22,2,8,2010
305,Darko Milicic,MIN,32,685,47,107,34,13,28,1,5,5,8,2010
306,Eduardo Najera,DAL,46,685,29,69,18,11,8,2,8,4,7,2010
307,Joel Przybilla,POR,30,681,8,19,5,3,4,0,1,2,1,2010
308,Solomon Jones,IND,52,675,32,74,22,10,11,1,10,1,9,2010
309,Tracy McGrady,NYK,30,672,99,225,72,27,47,5,20,6,21,2010
310,Kwame Brown,DET,48,660,22,48,18,4,13,1,4,1,3,2010
311,Sebastian Telfair,CLE,43,659,126,278,100,26,51,13,36,5,21,2010
312,Jason Smith,PHI,56,658,33,76,23,10,7,3,13,5,5,2010
313,Jon Brockman,SAC,52,654,22,53,13,9,5,3,5,4,5,2010
314,Fabricio Oberto,WAS,57,650,51,112,41,10,23,4,14,3,7,2010
315,Brandon Bass,ORL,50,648,19,45,12,7,6,3,3,3,4,2010
316,Chucky Atkins,DET,40,644,91,196,77,14,42,13,22,4,10,2010
317,Jordan Hill,HOU,47,624,20,50,10,10,7,2,1,2,8,2010
318,Shelden Williams,BOS,54,597,21,49,14,7,7,2,5,2,5,2010
319,Joe Smith,ATL,64,592,21,47,16,5,10,1,5,3,2,2010
320,Jamaal Tinsley,MEM,38,589,108,230,94,14,60,9,25,3,11,2010
321,Josh Powell,LAL,63,581,35,79,26,9,10,6,10,3,6,2010
322,Francisco Garcia,SAC,25,575,45,94,41,4,12,8,21,3,1,2010
323,Sasha Vujacic,LAL,67,575,41,95,28,13,15,3,10,4,9,2010
324,Quinton Ross,WAS,52,562,12,25,11,1,5,1,5,0,1,2010
325,Derrick Brown,CHA,57,535,19,47,10,9,5,0,5,1,8,2010
326,Josh McRoberts,IND,42,524,44,102,30,14,17,5,8,3,11,2010
327,Bobby Brown,LAC,45,519,88,209,55,33,33,6,16,4,29,2010
328,Tyler Hansbrough,IND,29,511,28,62,22,6,12,1,9,0,6,2010
329,James Jones,MIA,36,503,17,38,13,4,4,1,8,2,2,2010
330,Greg Oden,POR,21,502,19,44,13,6,9,2,2,1,5,2010
331,Ricky Davis,LAC,36,499,39,85,32,7,18,3,11,4,3,2010
332,Michael Redd,MIL,18,492,39,92,25,14,5,8,12,7,7,2010
333,Brian Scalabrine,BOS,52,472,27,63,18,9,7,4,7,0,9,2010
334,Mardy Collins,LAC,43,470,44,95,37,7,13,6,18,3,4,2010
335,Darrell Arthur,MEM,32,457,15,35,10,5,3,1,6,2,3,2010
336,Malik Allen,DEN,51,456,16,40,8,8,3,0,5,4,4,2010
337,Oleksiy Pecherov,MIN,44,447,11,22,11,0,3,1,7,0,0,2010
338,Chris Wilcox,DET,34,441,13,27,12,1,10,1,1,0,1,2010
339,Johan Petro,DEN,36,436,14,31,11,3,9,1,1,1,2,2010
340,Rasho Nesterovic,TOR,42,413,25,53,22,3,14,2,6,1,2,2010
341,Nathan Jawai,MIN,39,412,24,54,18,6,8,4,6,2,4,2010
342,Kyrylo Fesenko,UTA,49,408,15,30,15,0,8,0,7,0,0,2010
343,Anthony Johnson,ORL,31,406,63,152,37,26,18,7,12,9,17,2010
344,Mikki Moore,GSW,23,406,36,86,22,14,9,1,12,6,8,2010
345,Jeff Ayres,POR,39,405,1,3,0,1,0,0,0,0,1,2010
346,DaJuan Summers,DET,44,405,16,37,11,5,6,2,3,1,4,2010
347,Bobby Simmons,NJN,23,395,15,31,14,1,7,6,1,0,1,2010
348,Cartier Martin,WAS,18,390,16,36,12,4,4,2,6,1,3,2010
349,Earl Clark,PHX,51,383,21,50,13,8,6,2,5,0,8,2010
350,Steve Novak,LAC,54,362,6,16,2,4,2,0,0,1,3,2010
351,Jamaal Magloire,MIA,36,359,1,3,0,1,0,0,0,1,0,2010
352,DJ Mbenga,LAL,49,355,8,17,7,1,3,1,3,0,1,2010
353,Gerald Henderson,CHA,43,355,13,28,11,2,5,1,5,1,1,2010
354,Hilton Armstrong,HOU,33,335,21,47,16,5,11,0,5,1,4,2010
355,Garrett Temple,SAS,27,334,21,48,15,6,9,2,4,3,3,2010
356,Sean May,SAC,37,331,17,37,14,3,8,1,5,0,3,2010
357,Royal Ivey,MIL,44,327,27,61,20,7,10,5,5,1,6,2010
358,Etan Thomas,OKC,23,321,1,3,0,1,0,0,0,0,1,2010
359,Malik Hairston,SAS,47,317,16,38,10,6,5,1,4,3,3,2010
360,Dan Gadzuric,MIL,32,314,12,29,7,5,2,1,4,2,3,2010
361,Kenny Thomas,SAC,26,313,15,32,13,2,7,2,4,2,0,2010
362,Aaron Gray,NOH,32,311,22,46,20,2,12,4,4,0,2,2010
363,Reggie Evans,TOR,28,311,8,17,7,1,3,0,4,1,0,2010
364,Dominic McGuire,SAC,51,307,11,23,10,1,7,0,3,1,0,2010
365,Jermaine Taylor,HOU,31,303,16,33,15,1,10,1,4,0,1,2010
366,Jonathan Bender,NYK,25,292,16,36,12,4,6,1,5,0,4,2010
367,Tim Thomas,DAL,18,285,14,31,11,3,4,1,6,0,3,2010
368,Luke Walton,LAL,29,272,40,86,34,6,18,4,12,2,4,2010
369,Brian Cardinal,MIN,29,267,24,50,22,2,15,2,5,0,2,2010
370,Kevin Ollie,OKC,25,263,20,45,15,5,3,4,8,0,5,2010
371,DeSagana Diop,CHA,27,262,5,11,4,1,3,0,1,0,1,2010
372,Jarron Collins,PHX,34,260,6,14,4,2,2,0,2,0,2,2010
373,Jeff Foster,IND,16,255,21,51,12,9,2,2,8,1,8,2010
374,Marcus Banks,TOR,22,244,26,55,23,3,12,3,8,1,2,2010
375,Adam Morrison,LAL,31,241,18,40,14,4,9,2,3,0,4,2010
376,Hamed Haddadi,MEM,36,240,10,20,10,0,9,1,0,0,0,2010
377,J.R. Giddens,NYK,32,239,13,32,7,6,4,1,2,0,6,2010
378,Leon Powe,CLE,20,236,0,0,0,0,0,0,0,0,0,2010
379,Acie Law,CHI,26,234,26,58,20,6,14,1,5,2,4,2010
380,Earl Barron,NYK,7,232,8,21,3,5,1,0,2,1,4,2010
381,Kelenna Azubuike,GSW,9,231,10,22,8,2,5,0,3,1,1,2010
382,Sean Williams,NJN,20,227,1,2,1,0,0,1,0,0,0,2010
383,Chris Richard,CHI,18,224,7,17,4,3,1,0,3,0,3,2010
384,Chris Quinn,NJN,25,223,29,63,24,5,10,3,11,2,3,2010
385,Sundiata Gaines,UTA,32,217,39,82,35,4,20,4,11,2,2,2010
386,Alonzo Gee,WAS,11,182,7,16,5,2,1,2,2,0,2,2010
387,Raja Bell,GSW,6,181,13,27,12,1,5,3,4,1,0,2010
388,Kosta Koufos,UTA,36,172,6,13,5,1,3,0,2,0,1,2010
389,Ian Mahinmi,SAS,26,165,2,4,2,0,1,1,0,0,0,2010
390,Steven Hunter,MEM,21,158,0,0,0,0,0,0,0,0,0,2010
391,Kyle Weaver,OKC,12,144,11,24,9,2,3,2,4,1,1,2010
392,Mario West,ATL,38,142,9,18,9,0,3,1,5,0,0,2010
393,Tony Battie,NJN,15,134,3,6,3,0,0,1,2,0,0,2010
394,Lester Hudson,MEM,25,131,13,29,10,3,7,0,3,0,3,2010
395,Randolph Morris,ATL,28,124,2,5,1,1,1,0,0,0,1,2010
396,Brian Skinner,LAC,16,123,0,0,0,0,0,0,0,0,0,2010
397,Darnell Jackson,MIL,28,122,4,11,1,3,0,0,1,0,3,2010
398,Lindsey Hunter,CHI,13,122,9,20,7,2,4,1,2,1,1,2010
399,Matt Carroll,DAL,25,121,6,12,6,0,2,0,4,0,0,2010
400,Pops Mensah-Bonsu,TOR,20,120,3,7,2,1,1,1,0,0,1,2010
401,Danny Green,CLE,20,115,5,11,4,1,3,0,1,0,1,2010
402,Jason Collins,ATL,24,115,4,9,3,1,3,0,0,0,1,2010
403,Coby Karl,GSW,7,113,15,35,10,5,4,1,5,1,4,2010
404,Marcus Landry,BOS,18,111,0,0,0,0,0,0,0,0,0,2010
405,Joey Dorsey,SAC,15,107,2,6,0,2,0,0,0,0,2,2010
406,DJ White,OKC,12,102,4,9,3,1,2,0,1,0,1,2010
407,Roko Ukic,MIL,13,97,12,28,8,4,2,1,5,0,4,2010
408,Mike Harris,HOU,13,96,3,7,2,1,1,0,1,0,1,2010
409,Alando Tucker,MIN,15,95,4,8,4,0,2,0,2,0,0,2010
410,Primoz Brezec,MIL,21,95,1,2,1,0,0,0,1,0,0,2010
411,Renaldo Balkman,DEN,13,91,7,17,4,3,2,0,2,1,2,2010
412,Sean Marks,NOH,14,75,2,4,2,0,0,2,0,0,0,2010
413,Cedric Jackson,WAS,12,75,14,32,10,4,5,2,3,1,3,2010
414,Othyus Jeffers,UTA,14,72,1,2,1,0,1,0,0,0,0,2010
415,Francisco Elson,PHI,12,66,2,5,1,1,0,0,1,1,0,2010
416,Desmond Mason,SAC,5,65,2,5,1,1,1,0,0,0,1,2010
417,Eddy Curry,NYK,7,62,0,0,0,0,0,0,0,0,0,2010
418,Mike Wilks,OKC,4,59,4,9,3,1,1,0,2,0,1,2010
419,Kareem Rush,LAC,7,58,4,8,4,0,1,2,1,0,0,2010
420,Byron Mullens,OKC,13,54,1,3,0,1,0,0,0,0,1,2010
421,Shavlik Randolph,MIA,6,53,1,2,1,0,1,0,0,0,0,2010
422,Travis Diener,POR,9,51,8,17,7,1,4,1,2,0,1,2010
423,Patrick O'Bryant,TOR,11,51,1,3,0,1,0,0,0,0,1,2010
424,Mike James,WAS,4,46,5,12,3,2,1,1,1,1,1,2010
425,Brian Cook,HOU,14,44,1,2,1,0,1,0,0,0,0,2010
426,Yakhouba Diawara,MIA,6,44,3,6,3,0,1,1,1,0,0,2010
427,Marcus Haislip,SAS,10,44,0,0,0,0,0,0,0,0,0,2010
428,Patty Mills,POR,10,38,5,12,3,2,3,0,0,1,1,2010
429,Will Conroy,HOU,5,36,7,17,4,3,0,2,2,1,2,2010
430,Othello Hunter,ATL,7,33,0,0,0,0,0,0,0,0,0,2010
431,Taylor Griffin,PHX,8,32,1,2,1,0,1,0,0,0,0,2010
432,Alexis Ajinca,CHA,6,30,0,0,0,0,0,0,0,0,0,2010
433,Joe Alexander,CHI,8,29,2,4,2,0,2,0,0,0,0,2010
434,Jason Hart,NOH,5,22,6,13,5,1,1,0,4,0,1,2010
435,Oliver Lafayette,BOS,1,22,2,4,2,0,2,0,0,0,0,2010
436,Antonio Anderson,OKC,1,15,0,0,0,0,0,0,0,0,0,2010
437,Paul Davis,WAS,2,8,3,7,2,1,1,0,1,0,1,2010
438,Ryan Bowen,OKC,1,8,0,0,0,0,0,0,0,0,0,2010
439,Dwayne Jones,PHX,2,7,0,0,0,0,0,0,0,0,0,2010
440,Trey Gilder,MEM,2,5,0,0,0,0,0,0,0,0,0,2010
441,JamesOn Curry,LAC,1,0,0,0,0,0,0,0,0,0,0,2010
0,Andre Iguodala,PHI,82,3269,434,921,381,53,233,61,87,25,28,2009
1,Joe Johnson,ATL,79,3125,455,1071,294,161,122,62,110,53,108,2009
2,O.J. Mayo,MEM,82,3120,262,576,210,52,134,31,45,12,40,2009
3,Antawn Jamison,WAS,81,3096,153,338,121,32,75,15,31,5,27,2009
4,Raymond Felton,CHA,82,3086,553,1266,393,160,215,38,140,48,112,2009
5,Tayshaun Prince,DET,82,3057,253,572,187,66,49,28,110,19,47,2009
6,LeBron James,CLE,81,3054,587,1406,355,232,179,37,139,130,102,2009
7,Dirk Nowitzki,DAL,81,3051,197,473,118,79,66,15,37,20,59,2009
8,Dwyane Wade,MIA,79,3048,589,1341,426,163,232,59,135,57,106,2009
9,Paul Pierce,BOS,81,3036,294,667,215,79,105,30,80,42,37,2009
10,LaMarcus Aldridge,POR,81,3004,157,398,73,84,37,7,29,28,56,2009
11,Chris Paul,NOH,78,3002,861,1945,638,223,325,92,221,101,122,2009
12,Derrick Rose,CHI,81,3000,512,1160,376,136,155,33,188,38,98,2009
13,Pau Gasol,LAL,81,3000,284,654,198,86,108,30,60,17,69,2009
14,Ben Gordon,CHI,82,2999,279,611,226,53,124,22,80,12,41,2009
15,David West,NOH,76,2982,173,436,83,90,52,10,21,30,60,2009
16,Andre Miller,PHI,82,2977,534,1126,476,58,292,47,137,22,36,2009
17,Kobe Bryant,LAL,82,2960,399,914,283,116,172,53,58,50,66,2009
18,John Salmons,CHI,79,2959,249,561,186,63,84,23,79,28,35,2009
19,Vince Carter,NJN,80,2946,376,891,237,139,148,25,64,64,75,2009
20,Rudy Gay,MEM,79,2946,135,307,98,37,52,17,29,10,27,2009
21,Richard Jefferson,MIL,82,2939,199,448,149,50,62,27,60,19,31,2009
22,Chris Bosh,TOR,77,2928,191,436,137,54,66,31,40,15,39,2009
23,Chris Duhon,NYK,79,2906,566,1340,358,208,242,33,83,57,151,2009
24,Brandon Roy,POR,78,2903,400,940,260,140,116,23,121,81,59,2009
25,Jason Kidd,DAL,81,2886,702,1551,555,147,253,68,234,51,96,2009
26,Kevin Durant,OKC,74,2885,205,454,161,44,89,24,48,18,26,2009
27,Ray Allen,BOS,79,2876,218,477,177,41,94,17,66,16,25,2009
28,Jeff Green,OKC,78,2873,155,341,124,31,57,18,49,9,22,2009
29,Rashard Lewis,ORL,79,2859,205,498,117,88,82,26,9,27,61,2009
30,Mo Williams,CLE,81,2834,329,744,243,86,129,32,82,27,59,2009
31,David Lee,NYK,81,2824,174,443,79,95,50,5,24,31,64,2009
32,Dwight Howard,ORL,79,2821,112,296,40,72,29,2,9,22,50,2009
33,Hedo Turkoglu,ORL,77,2815,375,909,216,159,137,35,44,70,89,2009
34,Chauncey Billups,DEN,79,2789,506,1129,389,117,241,54,94,27,90,2009
35,Boris Diaw,CHA,81,2754,333,759,240,93,127,33,80,39,54,2009
36,Mike Bibby,ATL,79,2740,392,869,307,85,189,60,58,40,45,2009
37,Wilson Chandler,NYK,82,2735,170,416,94,76,46,10,38,26,50,2009
38,Jarrett Jack,IND,82,2716,338,796,218,120,122,26,70,23,97,2009
39,Emeka Okafor,CHA,82,2692,53,123,36,17,21,2,13,1,16,2009
40,Eric Gordon,LAC,78,2677,215,496,149,66,79,21,49,25,41,2009
41,Gerald Wallace,CHA,71,2669,189,422,145,44,102,18,25,16,28,2009
42,Russell Westbrook,OKC,82,2668,435,943,362,73,182,37,143,16,57,2009
43,Al Thornton,LAC,71,2654,103,241,68,35,27,12,29,8,27,2009
44,Rajon Rondo,BOS,80,2642,659,1495,482,177,280,41,161,73,104,2009
45,Anthony Parker,TOR,80,2636,269,586,221,48,100,35,86,14,34,2009
46,Mario Chalmers,MIA,82,2626,403,879,330,73,137,47,146,31,42,2009
47,Ryan Gomes,MIN,82,2614,135,307,98,37,56,14,28,15,22,2009
48,Rasual Butler,NOH,82,2614,75,168,57,18,32,9,16,6,12,2009
49,Ronnie Brewer,UTA,81,2605,179,398,139,40,91,10,38,10,30,2009
50,Yao Ming,HOU,77,2589,137,342,69,68,53,7,9,9,59,2009
51,Caron Butler,WAS,67,2585,290,646,224,66,135,33,56,17,49,2009
52,Thaddeus Young,PHI,75,2580,86,184,74,12,40,9,25,4,8,2009
53,Udonis Haslem,MIA,75,2560,85,201,54,31,28,3,23,8,23,2009
54,Al Harrington,NYK,73,2546,102,244,62,40,46,6,10,18,22,2009
55,Tim Duncan,SAS,75,2524,264,600,192,72,113,15,64,25,47,2009
56,Marc Gasol,MEM,82,2521,143,335,94,49,60,10,24,13,36,2009
57,Rodney Stuckey,DET,79,2517,387,848,313,74,102,29,182,32,42,2009
58,Nene,DEN,77,2511,108,243,81,27,53,4,24,7,20,2009
59,Mike Conley,MEM,82,2508,354,784,278,76,137,33,108,28,48,2009
60,Deron Williams,UTA,68,2505,725,1606,569,156,309,53,207,42,114,2009
61,Brook Lopez,NJN,82,2502,86,194,64,22,38,9,17,7,15,2009
62,Roger Mason Jr.,SAS,82,2496,173,391,128,45,43,31,54,25,20,2009
63,Randy Foye,MIN,70,2494,303,681,228,75,122,39,67,41,34,2009
64,Devin Harris,NJN,69,2494,476,1111,317,159,187,32,98,68,91,2009
65,Jason Terry,DAL,74,2491,251,568,185,66,75,22,88,16,50,2009
66,Luis Scola,HOU,82,2488,123,315,54,69,23,12,19,15,54,2009
67,Steve Nash,PHX,74,2484,717,1583,568,149,355,97,116,50,99,2009
68,Troy Murphy,IND,73,2482,172,403,113,59,57,16,40,10,49,2009
69,Jamal Crawford,GSW,65,2478,288,647,217,71,128,27,62,23,48,2009
70,Shawn Marion,TOR,69,2471,139,313,104,35,51,12,41,6,29,2009
71,Tony Parker,SAS,72,2456,496,1179,309,187,112,49,148,82,105,2009
72,Andrea Bargnani,TOR,78,2453,94,209,73,21,26,19,28,8,13,2009
73,Metta World Peace,HOU,69,2452,229,513,174,55,81,46,47,10,45,2009
74,Rafer Alston,ORL,77,2447,406,931,287,119,154,62,71,37,82,2009
75,Grant Hill,PHX,82,2445,186,410,148,38,93,17,38,19,19,2009
76,Derek Fisher,LAL,82,2441,261,584,199,62,97,46,56,22,40,2009
77,Danny Granger,IND,67,2424,183,412,137,46,94,11,32,13,33,2009
78,Josh Smith,ATL,69,2421,169,396,111,58,71,17,23,25,33,2009
79,Jason Richardson,PHX,72,2410,146,320,118,28,77,20,21,7,21,2009
80,Mehmet Okur,UTA,72,2409,120,271,89,31,50,5,34,9,22,2009
81,Kelenna Azubuike,GSW,74,2374,117,272,79,38,43,12,24,8,30,2009
82,Mike Miller,MIN,73,2356,326,751,227,99,104,45,78,42,57,2009
83,Stephen Jackson,GSW,59,2339,381,841,302,79,223,27,52,29,50,2009
84,Michael Finley,SAS,81,2336,114,269,73,41,27,15,31,19,22,2009
85,Jose Calderon,TOR,68,2333,607,1359,462,145,182,76,204,48,97,2009
86,Lamar Odom,LAL,78,2316,204,457,155,49,90,33,32,12,37,2009
87,Raja Bell,CHA,67,2315,142,316,110,32,54,31,25,11,21,2009
88,Anderson Varejao,CLE,81,2306,81,185,58,23,31,8,19,7,16,2009
89,Jason Thompson,SAC,82,2303,93,218,61,32,36,3,22,7,25,2009
90,Paul Millsap,UTA,76,2291,138,293,121,17,64,9,48,3,14,2009
91,Richard Hamilton,DET,67,2279,297,642,249,48,101,31,117,18,30,2009
92,Carmelo Anthony,DEN,66,2277,222,480,186,36,133,25,28,11,25,2009
93,Beno Udrih,SAC,73,2270,342,778,248,94,131,36,81,45,49,2009
94,Spencer Hawes,SAC,77,2259,149,341,106,43,68,10,28,13,30,2009
95,T.J. Ford,IND,74,2258,392,934,242,150,136,28,78,27,123,2009
96,Kendrick Perkins,BOS,76,2254,96,222,66,30,44,4,18,8,22,2009
97,Shaquille O'Neal,PHX,75,2252,126,292,86,40,63,12,11,6,34,2009
98,Baron Davis,LAC,65,2248,501,1095,408,93,239,52,117,30,63,2009
99,Travis Outlaw,POR,81,2246,83,201,48,35,22,10,16,10,25,2009
100,JR Smith,DEN,81,2244,227,498,183,44,133,14,36,10,34,2009
101,Al Horford,ATL,67,2242,163,395,94,69,39,13,42,18,51,2009
102,Nate Robinson,NYK,74,2209,301,723,180,121,126,13,41,30,91,2009
103,Steve Blake,POR,69,2188,348,767,277,71,154,40,83,33,38,2009
104,Tyrus Thomas,CHI,79,2175,77,163,68,9,45,5,18,2,7,2009
105,Ramon Sessions,MIL,79,2173,452,1007,349,103,161,53,135,37,66,2009
106,Delonte West,CLE,64,2152,226,497,181,45,100,20,61,22,23,2009
107,James Posey,NOH,75,2140,82,197,49,33,20,11,18,17,16,2009
108,Rasheed Wallace,DET,66,2123,91,193,80,11,46,17,17,4,7,2009
109,Luc Mbah a Moute,MIL,82,2113,87,192,69,18,45,6,18,9,9,2009
110,Kenyon Martin,DEN,66,2111,132,299,97,35,57,12,28,6,29,2009
111,Brad Miller,CHI,70,2100,234,507,195,39,102,20,73,13,26,2009
112,Charlie Villanueva,MIL,78,2095,137,309,102,35,60,17,25,20,15,2009
113,Sebastian Telfair,MIN,75,2094,343,802,227,116,112,38,77,39,77,2009
114,Marvin Williams,ATL,61,2093,81,180,63,18,30,9,24,6,12,2009
115,Allen Iverson,DET,57,2093,283,634,215,68,93,28,94,32,36,2009
116,Peja Stojakovic,NOH,61,2089,75,182,43,32,18,10,15,17,15,2009
117,Matt Barnes,PHX,77,2082,212,470,166,46,115,26,25,23,23,2009
118,Keyon Dooling,NJN,77,2073,270,645,165,105,86,20,59,42,63,2009
119,Dominic McGuire,WAS,79,2072,198,433,161,37,84,35,42,11,26,2009
120,Jamario Moon,MIA,80,2068,95,217,68,27,23,13,32,7,20,2009
121,Kevin Love,MIN,81,2048,84,179,73,11,46,9,18,4,7,2009
122,Samuel Dalembert,PHI,82,2036,18,38,16,2,12,2,2,1,1,2009
123,Luke Ridnour,MIL,72,2033,365,832,263,102,120,36,107,40,62,2009
124,Shane Battier,HOU,60,2031,137,300,111,26,42,44,25,6,20,2009
125,Hakim Warrick,MEM,82,2029,66,157,41,25,20,15,6,3,22,2009
126,Jermaine O'Neal,MIA,68,2028,122,282,84,38,47,8,29,12,26,2009
127,Michael Beasley,MIA,81,2009,83,208,41,42,19,7,15,15,27,2009
128,Trevor Ariza,LAL,82,1999,145,324,111,34,65,15,31,8,26,2009
129,Aaron Brooks,HOU,80,1998,238,544,170,68,68,42,60,23,45,2009
130,Rudy Fernandez,POR,78,1993,159,361,116,43,70,15,31,25,18,2009
131,Andres Nocioni,SAC,76,1992,102,237,69,33,31,4,34,5,28,2009
132,Francisco Garcia,SAC,65,1975,150,356,94,56,58,12,24,22,34,2009
133,Flip Murray,ATL,80,1975,158,358,116,42,65,19,32,18,24,2009
134,Joel Przybilla,POR,82,1952,27,61,20,7,8,4,8,4,3,2009
135,Amar'e Stoudemire,PHX,53,1948,104,241,71,33,49,7,15,16,17,2009
136,Kevin Martin,SAC,51,1947,138,325,89,49,36,8,45,13,36,2009
137,Courtney Lee,ORL,77,1939,91,230,43,48,18,10,15,11,37,2009
138,Joakim Noah,CHI,80,1938,106,227,91,15,39,6,46,2,13,2009
139,Matt Bonner,SAS,81,1928,82,190,56,26,18,12,26,9,17,2009
140,Marcus Camby,LAC,62,1926,127,266,115,12,72,24,19,1,11,2009
141,Lou Williams,PHI,81,1919,242,552,174,68,94,22,58,28,40,2009
142,D.J. Augustin,CHA,72,1908,250,564,186,64,86,24,76,28,36,2009
143,Quentin Richardson,NYK,72,1894,117,265,86,31,52,12,22,9,22,2009
144,C.J. Watson,GSW,77,1883,206,469,149,57,95,10,44,21,36,2009
145,Kyle Korver,UTA,78,1874,137,282,129,8,87,11,31,1,7,2009
146,Antonio McDyess,DET,62,1866,83,190,59,24,25,4,30,11,13,2009
147,Andris Biedrins,GSW,62,1863,121,278,85,36,33,10,42,10,26,2009
148,Maurice Evans,ATL,80,1840,54,134,28,26,9,10,9,9,17,2009
149,Nick Young,WAS,82,1836,95,203,82,13,37,9,36,2,11,2009
150,Erick Dampier,DAL,80,1836,77,180,51,26,14,4,33,6,20,2009
151,Al Jefferson,MIN,50,1836,79,195,42,37,26,3,13,9,28,2009
152,Daequan Cook,MIA,75,1833,71,172,41,30,21,4,16,12,18,2009
153,Jarvis Hayes,NJN,74,1832,54,124,38,16,19,8,11,9,7,2009
154,Nick Collison,OKC,71,1831,66,144,54,12,32,6,16,2,10,2009
155,Jason Kapono,TOR,80,1831,105,235,80,25,38,12,30,6,19,2009
156,Andrei Kirilenko,UTA,67,1831,175,365,160,15,80,16,64,5,10,2009
157,Jeff Foster,IND,74,1828,130,299,91,39,41,5,45,5,34,2009
158,Willie Green,PHI,81,1828,158,345,129,29,58,21,50,8,21,2009
159,Linas Kleiza,DEN,82,1824,64,143,49,15,30,4,15,4,11,2009
160,Brandon Rush,IND,75,1803,66,156,42,24,21,6,15,7,17,2009
161,Daniel Gibson,CLE,75,1794,132,307,89,43,46,8,35,18,25,2009
162,Anthony Carter,DEN,78,1786,364,826,266,98,183,32,51,32,66,2009
163,Charlie Bell,MIL,70,1782,151,343,110,41,40,22,48,16,25,2009
164,Earl Watson,OKC,68,1776,391,836,337,54,202,33,102,14,40,2009
165,Kevin Garnett,BOS,57,1772,144,324,108,36,91,3,14,14,22,2009
166,Zydrunas Ilgauskas,CLE,65,1766,64,141,51,13,30,7,14,6,7,2009
167,Zach Randolph,LAC,50,1757,103,243,66,37,41,8,17,7,30,2009
168,Bobby Simmons,NJN,71,1729,92,206,70,22,38,12,20,8,14,2009
169,Leandro Barbosa,PHX,70,1705,162,364,122,40,89,17,16,19,21,2009
170,Andray Blatche,WAS,71,1703,118,256,98,20,67,8,23,3,17,2009
171,Marquis Daniels,IND,54,1700,114,270,72,42,34,14,24,6,36,2009
172,Ronny Turiaf,GSW,79,1696,166,391,107,59,44,11,52,17,42,2009
173,Kyle Lowry,HOU,77,1679,275,613,212,63,103,43,66,18,45,2009
174,Luol Deng,CHI,49,1665,94,217,65,29,32,6,27,12,17,2009
175,Josh Howard,DAL,52,1663,83,197,52,31,19,5,28,12,19,2009
176,Mike James,WAS,61,1649,201,439,164,37,68,32,64,7,30,2009
177,Glen Davis,BOS,76,1637,69,160,47,22,28,4,15,3,19,2009
178,CJ Miles,UTA,72,1623,107,223,98,9,63,12,23,1,8,2009
179,J.J. Barea,DAL,79,1600,269,609,198,71,82,21,95,29,42,2009
180,Corey Maggette,GSW,51,1588,92,213,63,29,36,5,22,6,23,2009
181,Brandon Bass,DAL,81,1574,43,100,29,14,8,2,19,4,10,2009
182,Antoine Wright,DAL,65,1552,77,184,47,30,28,2,17,12,18,2009
183,Joey Graham,TOR,78,1541,48,111,33,15,20,2,11,5,10,2009
184,Wally Szczerbiak,CLE,74,1527,82,195,51,31,17,6,28,15,16,2009
185,Darius Songaila,WAS,77,1521,94,199,83,11,51,14,18,1,10,2009
186,Anthony Morrow,GSW,67,1515,80,185,55,25,31,9,15,9,16,2009
187,Bruce Bowen,SAS,80,1506,40,93,27,13,7,4,16,6,7,2009
188,Fred Jones,LAC,52,1495,188,433,131,57,72,13,46,20,37,2009
189,Bobby Jackson,SAC,71,1484,143,331,98,45,49,10,39,18,27,2009
190,Anthony Johnson,ORL,80,1481,200,485,115,85,65,27,23,30,55,2009
191,Larry Hughes,NYK,55,1480,119,271,86,33,55,14,17,13,20,2009
192,Eddie House,BOS,81,1479,92,200,76,16,37,5,34,7,9,2009
193,Zaza Pachulia,ATL,77,1473,57,130,41,16,26,1,14,4,12,2009
194,Carl Landry,HOU,69,1467,39,97,20,19,5,2,13,6,13,2009
195,Darrell Arthur,MEM,76,1464,43,101,28,15,17,3,8,6,9,2009
196,Craig Smith,MIN,74,1460,79,177,60,19,29,13,18,7,12,2009
197,Chris Andersen,DEN,71,1460,31,70,23,8,13,2,8,1,7,2009
198,Nicolas Batum,POR,79,1453,74,171,51,23,28,10,13,13,10,2009
199,Thabo Sefolosha,OKC,66,1453,111,248,85,26,46,7,32,9,17,2009
200,Andrew Bynum,LAL,50,1446,71,160,53,18,28,3,22,6,12,2009
201,Vladimir Radmanovic,CHA,78,1445,81,185,58,23,27,15,16,4,19,2009
202,Tyson Chandler,NOH,45,1445,22,52,14,8,7,2,5,0,8,2009
203,Dahntay Jones,DEN,79,1426,78,175,59,19,28,4,27,3,16,2009
204,Yi Jianlian,NJN,61,1421,60,143,37,23,21,3,13,12,11,2009
205,Jason Maxiell,DET,78,1408,24,49,23,1,12,3,8,0,1,2009
206,Kurt Thomas,SAS,79,1404,66,154,44,22,12,7,25,8,14,2009
207,Kirk Hinrich,CHI,51,1338,197,441,150,47,70,11,69,15,32,2009
208,Mickael Pietrus,ORL,54,1329,65,153,42,23,26,5,11,8,15,2009
209,Greg Oden,POR,61,1314,31,73,20,11,13,3,4,2,9,2009
210,Ben Wallace,CLE,56,1314,44,92,40,4,17,2,21,1,3,2009
211,Ryan Anderson,NJN,66,1312,52,117,39,13,29,3,7,7,6,2009
212,Jared Jeffries,NYK,56,1310,80,193,47,33,22,4,21,7,26,2009
213,Jameer Nelson,ORL,42,1309,226,575,103,123,71,14,18,39,84,2009
214,Sasha Vujacic,LAL,80,1292,113,242,97,16,56,14,27,5,11,2009
215,Keith Bogans,MIL,65,1272,64,154,38,26,20,8,10,12,14,2009
216,George Hill,SAS,77,1270,136,323,85,51,16,16,53,29,22,2009
217,Drew Gooden,SAS,51,1264,48,109,35,13,14,7,14,6,7,2009
218,Marreese Speights,PHI,79,1262,30,72,18,12,12,2,4,6,6,2009
219,Tim Thomas,CHI,64,1247,68,162,42,26,23,8,11,11,15,2009
220,Arron Afflalo,DET,74,1234,44,95,37,7,15,7,15,3,4,2009
221,Leon Powe,BOS,70,1227,46,108,30,16,16,2,12,0,16,2009
222,Sergio Rodriguez,POR,80,1225,286,657,201,85,110,15,76,35,50,2009
223,Von Wafer,HOU,63,1225,71,159,54,17,32,10,12,5,12,2009
224,Rasho Nesterovic,IND,70,1214,109,247,80,29,45,12,23,0,29,2009
225,Michael Redd,MIL,33,1203,88,199,65,23,28,15,22,9,14,2009
226,Tony Battie,ORL,77,1202,31,72,21,10,10,3,8,2,8,2009
227,Mikki Moore,BOS,70,1202,53,123,36,17,16,3,17,2,15,2009
228,Rodney Carney,MIN,67,1199,26,58,20,6,12,3,5,2,4,2009
229,Carlos Boozer,UTA,37,1197,79,173,64,15,41,0,23,4,11,2009
230,Jordan Farmar,LAL,65,1192,155,348,117,38,58,19,40,17,21,2009
231,Tracy McGrady,HOU,35,1181,175,397,128,47,69,32,27,15,32,2009
232,Manu Ginobili,SAS,44,1181,157,357,114,43,58,16,40,23,20,2009
233,Javaris Crittenton,WAS,63,1174,150,340,110,40,69,13,28,13,27,2009
234,Luke Walton,LAL,65,1166,177,380,151,26,93,26,32,7,19,2009
235,Kyle Weaver,OKC,56,1166,101,213,90,11,50,14,26,2,9,2009
236,Quinton Ross,MEM,68,1164,47,108,33,14,10,8,15,6,8,2009
237,Steve Novak,LAC,71,1161,40,94,26,14,12,4,10,3,11,2009
238,Jared Dudley,PHX,68,1156,56,126,42,14,27,6,9,7,7,2009
239,JaVale McGee,WAS,75,1143,23,49,20,3,14,3,3,1,2,2009
240,Nenad Krstic,OKC,46,1141,29,70,17,12,9,3,5,2,10,2009
241,Reggie Evans,PHI,79,1137,26,61,17,9,11,4,2,2,7,2009
242,Anthony Randolph,GSW,63,1129,49,109,38,11,17,7,14,4,7,2009
243,Andrew Bogut,MIL,36,1124,72,158,58,14,36,6,16,3,11,2009
244,JJ Redick,ORL,64,1111,73,169,50,23,25,14,11,11,12,2009
245,Joe Smith,CLE,57,1102,41,92,31,10,15,3,13,4,6,2009
246,Rashad McCants,SAC,58,1100,68,153,51,17,31,12,8,9,8,2009
247,Trenton Hassell,NJN,53,1094,51,116,37,14,16,4,17,10,4,2009
248,Hilton Armstrong,NOH,70,1092,29,60,27,2,10,5,12,0,2,2009
249,Desmond Mason,OKC,39,1064,46,102,36,10,15,10,11,1,9,2009
250,Sasha Pavlovic,CLE,66,1053,72,165,51,21,26,6,19,8,13,2009
251,Chris Wilcox,NYK,62,1050,47,107,34,13,17,6,11,3,10,2009
252,Joel Anthony,MIA,65,1048,27,66,15,12,2,1,12,1,11,2009
253,Lou Amundson,PHX,76,1044,28,61,23,5,17,2,4,2,3,2009
254,DeSagana Diop,CHA,75,1036,32,76,20,12,11,3,6,4,8,2009
255,Ime Udoka,SAS,67,1035,54,117,45,9,22,10,13,3,6,2009
256,Darko Milicic,MEM,61,1034,34,77,25,9,22,0,3,0,9,2009
257,Antonio Daniels,NOH,74,1021,177,407,124,53,68,15,41,17,36,2009
258,Roy Hibbert,IND,70,1009,49,111,36,13,23,1,12,1,12,2009
259,Kwame Brown,DET,58,999,32,71,25,7,9,3,13,4,3,2009
260,Josh Boone,NJN,62,994,31,72,21,10,11,0,10,2,8,2009
261,Francisco Elson,MIL,59,977,32,74,22,10,11,4,7,2,8,2009
262,Chris Quinn,MIA,66,962,132,315,81,51,27,11,43,17,34,2009
263,Dan Gadzuric,MIL,67,941,39,87,30,9,14,0,16,1,8,2009
264,Brevin Knight,UTA,74,938,190,410,160,30,82,11,67,11,19,2009
265,Bobby Brown,MIN,68,931,117,262,89,28,43,11,35,8,20,2009
266,Chris Kaman,LAC,31,921,46,110,28,18,18,1,9,0,18,2009
267,Elton Brand,PHI,29,921,37,86,25,12,16,2,7,1,11,2009
268,Amir Johnson,DET,62,911,20,43,17,3,7,2,8,1,2,2009
269,Brian Cardinal,MIN,64,909,76,173,55,21,38,8,9,12,9,2009
270,Monta Ellis,GSW,25,892,93,211,68,25,46,2,20,8,17,2009
271,Mardy Collins,LAC,48,890,111,250,83,28,46,14,23,11,17,2009
272,Roko Ukic,TOR,72,889,153,344,115,38,35,21,59,15,23,2009
273,Tony Allen,BOS,46,887,66,147,51,15,34,5,12,4,11,2009
274,DeShawn Stevenson,WAS,32,886,98,218,76,22,37,10,29,3,19,2009
275,James Singleton,DAL,62,884,17,39,12,5,7,1,4,3,2,2009
276,Marco Belinelli,GSW,42,882,88,198,66,22,45,8,13,11,11,2009
277,Greg Buckner,MEM,63,878,57,132,39,18,26,4,9,8,10,2009
278,Devin Brown,NOH,63,869,54,129,33,21,15,3,15,8,13,2009
279,Royal Ivey,PHI,71,860,43,94,35,8,18,10,7,3,5,2009
280,Chuck Hayes,HOU,71,858,42,98,28,14,21,1,6,0,14,2009
281,Brent Barry,HOU,56,857,78,176,58,20,25,11,22,4,16,2009
282,Yakhouba Diawara,MIA,63,850,27,67,14,13,4,1,9,3,10,2009
283,Kevin Ollie,MIN,50,850,117,271,80,37,34,12,34,12,25,2009
284,Brian Skinner,LAC,51,843,27,59,22,5,10,2,10,0,5,2009
285,Sean Marks,NOH,60,838,14,36,6,8,0,2,4,4,4,2009
286,Juan Dixon,WAS,50,816,118,255,99,19,61,15,23,3,16,2009
287,Will Bynum,DET,57,803,157,357,114,43,39,13,62,30,13,2009
288,Marcin Gortat,ORL,63,794,14,36,6,8,0,1,5,2,6,2009
289,Ricky Davis,LAC,36,785,82,193,53,29,26,15,12,4,25,2009
290,Renaldo Balkman,DEN,53,780,34,82,20,14,13,1,6,0,14,2009
291,Julian Wright,NOH,54,771,43,91,38,5,17,9,12,3,2,2009
292,DeAndre Jordan,LAC,52,771,11,27,6,5,3,2,1,0,5,2009
293,Mike Taylor,LAC,51,770,106,247,71,35,38,10,23,9,26,2009
294,Channing Frye,POR,63,746,24,59,13,11,9,1,3,4,7,2009
295,Ronnie Price,UTA,52,738,108,235,89,19,50,6,33,8,11,2009
296,Goran Dragic,PHX,55,728,111,252,81,30,55,9,17,7,23,2009
297,Donte Greene,SAC,55,725,30,71,19,11,10,2,7,5,6,2009
298,Travis Diener,IND,55,719,122,302,64,58,31,11,22,18,40,2009
299,Joe Alexander,MIL,59,716,42,90,36,6,23,8,5,4,2,2009
300,Aaron Gray,CHI,56,715,46,100,38,8,24,3,11,1,7,2009
301,Will Solomon,SAC,53,712,133,294,105,28,48,14,43,7,21,2009
302,Adam Morrison,LAL,52,711,41,92,31,10,18,6,7,3,7,2009
303,Jamaal Magloire,MIA,55,709,22,50,16,6,4,4,8,0,6,2009
304,Devean George,DAL,43,708,15,34,11,4,2,2,7,2,2,2009
305,JJ Hickson,CLE,62,705,9,22,5,4,3,1,1,0,4,2009
306,Josh Powell,LAL,60,703,27,60,21,6,9,4,8,3,3,2009
307,Matt Harpring,UTA,63,693,28,61,23,5,9,3,11,1,4,2009
308,Brandan Wright,GSW,39,688,21,49,14,7,8,1,5,3,4,2009
309,Stephen Graham,IND,52,684,33,71,28,5,16,0,12,1,4,2009
310,Fabricio Oberto,SAS,54,677,59,134,43,16,20,6,17,8,8,2009
311,Solomon Jones,ATL,63,675,15,34,11,4,4,3,4,0,4,2009
312,Jerryd Bayless,POR,53,655,78,183,51,27,27,7,17,15,12,2009
313,Damien Wilkins,OKC,41,636,37,84,27,10,12,4,11,1,9,2009
314,Walter Herrmann,DET,59,630,22,49,17,5,6,6,5,3,2,2009
315,James Jones,MIA,40,630,20,47,13,7,6,1,6,3,4,2009
316,Matt Carroll,DAL,55,615,27,57,24,3,16,3,5,1,2,2009
317,Robin Lopez,PHX,60,614,8,17,7,1,3,0,4,0,1,2009
318,Marko Jaric,MEM,53,605,74,164,58,16,34,8,16,11,5,2009
319,Chris Douglas-Roberts,NJN,44,584,52,122,34,18,20,4,10,10,8,2009
320,Malik Allen,MIL,49,579,35,85,20,15,7,6,7,5,10,2009
321,Theo Ratliff,PHI,46,579,9,18,9,0,5,3,1,0,0,2009
322,Kosta Koufos,UTA,48,565,20,41,19,1,6,0,13,0,1,2009
323,Acie Law,ATL,55,559,86,200,58,28,36,5,17,10,18,2009
324,Johan Petro,DEN,49,559,16,35,13,3,7,2,4,0,3,2009
325,Tyronn Lue,ORL,44,521,60,135,45,15,20,5,20,6,9,2009
326,Morris Peterson,NOH,43,515,16,41,7,9,3,2,2,3,6,2009
327,Shelden Williams,MIN,45,513,12,25,11,1,8,0,3,0,1,2009
328,Brian Scalabrine,BOS,39,504,18,42,12,6,5,2,5,3,3,2009
329,Luther Head,MIA,32,497,58,131,43,15,12,8,23,5,10,2009
330,Mike Dunleavy,IND,18,495,44,101,31,13,17,6,8,2,11,2009
331,Shannon Brown,LAL,48,477,38,87,27,11,15,3,9,4,7,2009
332,Juwan Howard,CHA,42,472,26,61,17,9,14,1,2,4,5,2009
333,Malik Rose,OKC,38,469,36,80,28,8,19,3,6,4,4,2009
334,Ryan Hollins,DAL,44,444,7,15,6,1,1,1,4,1,0,2009
335,Rob Kurz,GSW,40,442,20,41,19,1,8,1,10,0,1,2009
336,Darnell Jackson,CLE,51,429,8,20,4,4,1,2,1,2,2,2009
337,Jason Collins,MIN,31,422,11,25,8,3,3,0,5,0,3,2009
338,Stephon Marbury,BOS,23,414,75,176,49,26,23,4,22,10,16,2009
339,Chucky Atkins,OKC,33,412,59,132,45,14,16,3,26,8,6,2009
340,Danilo Gallinari,NYK,28,412,15,41,4,11,3,1,0,2,9,2009
341,Gerald Green,DAL,37,375,15,32,13,2,6,0,7,0,2,2009
342,Melvin Ely,NOH,31,373,18,39,15,3,4,3,8,0,3,2009
343,Sean Williams,NJN,33,366,13,29,10,3,4,1,5,0,3,2009
344,Gabe Pruitt,BOS,47,366,39,88,29,10,16,0,13,4,6,2009
345,Cuttino Mobley,LAC,11,365,12,27,9,3,5,2,2,1,2,2009
346,Jason Hart,DEN,39,348,48,118,26,22,11,3,12,5,17,2009
347,Robert Swift,OKC,26,343,9,20,7,2,4,0,3,0,2,2009
348,Nazr Mohammed,CHA,39,341,8,16,8,0,7,0,1,0,0,2009
349,Paul Davis,LAC,27,320,12,28,8,4,6,2,0,2,2,2009
350,Eduardo Najera,NJN,27,319,19,42,15,4,9,1,5,1,3,2009
351,Corey Brewer,MIN,15,307,25,54,21,4,10,6,5,1,3,2009
352,Etan Thomas,WAS,26,306,6,13,5,1,3,0,2,0,1,2009
353,Sean Singletary,CHA,37,303,29,62,25,4,10,6,9,2,2,2009
354,Sean May,CHA,24,301,10,22,8,2,5,1,2,1,1,2009
355,Quincy Douby,TOR,27,301,25,51,24,1,9,2,13,1,0,2009
356,Darius Miles,MEM,34,298,17,37,14,3,10,1,3,0,3,2009
357,Jacque Vaughn,SAS,30,292,55,128,37,18,13,2,22,5,13,2009
358,Pops Mensah-Bonsu,TOR,22,283,6,12,6,0,5,1,0,0,0,2009
359,Alando Tucker,PHX,30,282,12,28,8,4,4,1,3,3,1,2009
360,Josh McRoberts,IND,33,279,16,39,9,7,7,0,2,1,6,2009
361,Oleksiy Pecherov,WAS,32,277,2,4,2,0,0,1,1,0,0,2009
362,Tarence Kinsey,CLE,49,277,10,23,7,3,2,0,5,2,1,2009
363,Anthony Roberson,CHI,29,276,20,44,16,4,9,3,4,1,3,2009
364,Mario West,ATL,53,269,19,47,10,9,6,2,2,2,7,2009
365,Cartier Martin,CHA,33,266,13,26,13,0,7,5,1,0,0,2009
366,Lindsey Hunter,CHI,28,265,37,82,29,8,15,5,9,4,4,2009
367,Kris Humphries,TOR,29,265,10,22,8,2,3,1,4,0,2,2009
368,Dee Brown,PHX,19,261,36,84,24,12,13,3,8,2,10,2009
369,Patrick O'Bryant,TOR,39,255,11,24,9,2,6,1,2,0,2,2009
370,Morris Almond,UTA,25,255,7,17,4,3,3,0,1,1,2,2009
371,Jake Voskuhl,TOR,38,240,8,17,7,1,2,0,5,0,1,2009
372,Shaun Livingston,OKC,12,231,20,40,20,0,9,2,9,0,0,2009
373,Ryan Bowen,NOH,21,219,9,24,3,6,1,0,2,0,6,2009
374,Maceo Baston,IND,27,217,7,17,4,3,1,0,3,0,3,2009
375,Henry Walker,BOS,29,216,13,31,8,5,5,0,3,2,3,2009
376,Ike Diogu,SAC,29,215,3,7,2,1,0,0,2,0,1,2009
377,Anthony Tolliver,SAS,19,208,17,37,14,3,10,0,4,3,0,2009
378,Mark Blount,MIA,20,207,4,11,1,3,1,0,0,3,0,2009
379,Marcus Banks,TOR,22,206,28,63,21,7,4,3,14,3,4,2009
380,Jarron Collins,UTA,26,201,7,14,7,0,2,0,5,0,0,2009
381,Alex Acker,LAC,25,199,12,29,7,5,3,0,4,1,4,2009
382,Kareem Rush,PHI,25,199,15,39,6,9,1,3,2,4,5,2009
383,Donyell Marshall,PHI,25,189,15,34,11,4,7,1,3,2,2,2009
384,Stromile Swift,PHX,19,184,3,8,1,2,0,0,1,1,1,2009
385,Alexis Ajinca,CHA,31,182,3,7,2,1,1,1,0,0,1,2009
386,DJ Mbenga,LAL,23,181,9,21,6,3,2,2,2,1,2,2009
387,Brendan Haywood,WAS,6,175,8,17,7,1,5,1,1,1,0,2009
388,DeMarcus Nelson,GSW,13,171,13,32,7,6,6,1,0,3,3,2009
389,Brian Cook,HOU,30,171,5,11,4,1,2,1,1,0,1,2009
390,Shawne Williams,DAL,15,170,2,5,1,1,0,0,1,0,1,2009
391,Jerry Stackhouse,DAL,10,162,12,28,8,4,4,0,4,0,4,2009
392,Kyrylo Fesenko,UTA,21,156,4,9,3,1,2,0,1,0,1,2009
393,Malik Hairston,SAS,15,155,13,28,11,2,3,2,6,1,1,2009
394,DJ White,OKC,7,129,6,13,5,1,2,1,2,0,1,2009
395,Lorenzen Wright,CLE,17,125,3,6,3,0,2,0,1,0,0,2009
396,Hamed Haddadi,MEM,19,120,8,20,4,4,3,1,0,1,3,2009
397,Mark Madsen,MIN,19,116,4,8,4,0,1,2,1,0,0,2009
398,Jermareo Davidson,GSW,14,111,1,2,1,0,0,1,0,0,0,2009
399,Damon Jones,MIL,18,108,7,15,6,1,2,1,3,0,1,2009
400,Chris Mihm,LAL,18,105,10,22,8,2,2,1,5,0,2,2009
401,Austin Croshere,SAS,14,100,9,23,4,5,3,1,0,2,3,2009
402,Thomas Gardner,ATL,16,98,2,4,2,0,2,0,0,0,0,2009
403,Maurice Ager,NJN,20,97,3,7,2,1,1,0,1,0,1,2009
404,Dikembe Mutombo,HOU,9,96,0,0,0,0,0,0,0,0,0,2009
405,Jeremy Richardson,ORL,12,93,3,9,0,3,0,0,0,1,2,2009
406,Othello Hunter,ATL,16,92,1,2,1,0,0,0,1,0,0,2009
407,Randolph Morris,ATL,23,88,2,6,0,2,0,0,0,1,1,2009
408,Cedric Simmons,SAC,18,84,2,4,2,0,2,0,0,0,0,2009
409,Dontell Jefferson,CHA,6,84,9,19,8,1,4,1,3,0,1,2009
410,Cheikh Samb,NYK,18,83,1,2,1,0,1,0,0,0,0,2009
411,Dorell Wright,MIA,6,73,2,5,1,1,1,0,0,1,0,2009
412,Gilbert Arenas,WAS,2,63,20,42,18,2,14,3,1,1,1,2009
413,Adonal Foyle,ORL,10,62,1,2,1,0,0,1,0,0,0,2009
414,Kenny Thomas,SAC,8,62,1,2,1,0,1,0,0,0,0,2009
415,Calvin Booth,SAC,8,55,0,0,0,0,0,0,0,0,0,2009
416,Linton Johnson,CHI,10,55,2,5,1,1,0,0,1,0,1,2009
417,Sonny Weems,DEN,12,55,3,9,0,3,0,0,0,0,3,2009
418,Desmon Farmer,SAS,3,54,2,5,1,1,1,0,0,1,0,2009
419,Marcus Williams,GSW,9,54,13,27,12,1,8,0,4,1,0,2009
420,Dwayne Jones,CHA,6,52,0,0,0,0,0,0,0,0,0,2009
421,Hassan Adams,TOR,12,52,1,2,1,0,1,0,0,0,0,2009
422,Eddie Gill,MIL,6,43,11,25,8,3,2,1,5,3,0,2009
423,Andre Brown,CHA,4,41,1,2,1,0,0,0,1,0,0,2009
424,Shavlik Randolph,POR,10,37,0,0,0,0,0,0,0,0,0,2009
425,Michael Ruffin,POR,11,35,0,0,0,0,0,0,0,0,0,2009
426,Sun Sun,LAL,10,28,2,4,2,0,1,1,0,0,0,2009
427,Mouhamed Sene,NYK,6,28,0,0,0,0,0,0,0,0,0,2009
428,Joe Crawford,NYK,2,23,1,3,0,1,0,0,0,0,1,2009
429,Jawad Williams,CLE,10,20,0,0,0,0,0,0,0,0,0,2009
430,Walter Sharpe,DET,8,20,0,0,0,0,0,0,0,0,0,2009
431,Nathan Jawai,TOR,6,19,0,0,0,0,0,0,0,0,0,2009
432,Blake Ahearn,SAS,3,19,2,5,1,1,1,0,0,0,1,2009
433,Speedy Claxton,ATL,2,15,3,6,3,0,0,0,3,0,0,2009
434,Demetris Nichols,NYK,4,14,1,2,1,0,0,0,1,0,0,2009
435,Trey Johnson,CLE,4,14,0,0,0,0,0,0,0,0,0,2009
436,Courtney Sims,NYK,2,13,0,0,0,0,0,0,0,0,0,2009
437,Eddy Curry,NYK,3,12,0,0,0,0,0,0,0,0,0,2009
438,James White,HOU,4,11,1,3,0,1,0,0,0,0,1,2009
439,Jerome James,NYK,2,10,0,0,0,0,0,0,0,0,0,2009
440,J.R. Giddens,BOS,6,8,0,0,0,0,0,0,0,0,0,2009
441,Joey Dorsey,HOU,3,6,1,2,1,0,0,0,1,0,0,2009
442,Martell Webster,POR,1,5,0,0,0,0,0,0,0,0,0,2009
443,Marcus Williams,SAS,2,3,0,0,0,0,0,0,0,0,0,2009
444,Steven Hill,OKC,1,2,0,0,0,0,0,0,0,0,0,2009
0,Allen Iverson,DEN,82,3424,586,1373,385,201,236,40,109,67,134,2008
1,Joe Johnson,ATL,82,3343,474,1054,368,106,157,51,160,24,82,2008
2,Andre Iguodala,PHI,82,3242,391,827,346,45,207,49,90,16,29,2008
3,Richard Jefferson,NJN,82,3200,252,597,159,93,88,16,55,27,66,2008
4,Baron Davis,GSW,82,3196,623,1441,428,195,316,51,61,65,130,2008
5,Kobe Bryant,LAL,82,3192,441,1017,306,135,215,29,62,65,70,2008
6,Jamal Crawford,NYK,80,3190,398,882,312,86,191,39,82,25,61,2008
7,Jason Richardson,CHA,82,3149,258,572,202,56,97,44,61,25,31,2008
8,Dwight Howard,ORL,82,3088,110,258,72,38,51,7,14,14,24,2008
9,Rashard Lewis,ORL,81,3076,196,466,122,74,83,23,16,32,42,2008
10,Monta Ellis,GSW,81,3071,315,769,176,139,131,8,37,44,95,2008
11,Antawn Jamison,WAS,79,3061,120,283,77,43,44,14,19,6,37,2008
12,Deron Williams,UTA,82,3059,862,1881,705,157,377,68,260,32,125,2008
13,LeBron James,CLE,75,3027,539,1259,358,181,183,34,141,93,88,2008
14,Hedo Turkoglu,ORL,82,3026,409,976,251,158,186,30,35,92,66,2008
15,Andre Miller,PHI,82,3016,565,1199,496,69,325,52,119,22,47,2008
16,Chris Paul,NOH,80,3006,925,2123,652,273,352,77,223,103,170,2008
17,Rudy Gay,MEM,81,3000,158,364,110,48,55,26,29,13,35,2008
18,Raymond Felton,CHA,79,2972,583,1344,405,178,204,63,138,71,107,2008
19,Ricky Davis,MIA,82,2963,276,631,197,79,95,12,90,16,63,2008
20,Vince Carter,NJN,76,2959,389,876,291,98,162,27,102,41,57,2008
21,Mike Dunleavy,IND,82,2953,288,660,204,84,119,25,60,28,56,2008
22,Lamar Odom,LAL,77,2921,273,630,189,84,101,22,66,21,63,2008
23,Al Jefferson,MIN,82,2919,117,270,81,36,50,13,18,6,30,2008
24,Shane Battier,HOU,80,2907,155,344,121,34,54,29,38,10,24,2008
25,Jason Kidd,DAL,80,2906,806,1752,666,140,367,87,212,47,93,2008
26,Danny Granger,IND,80,2876,166,395,103,63,35,18,50,15,48,2008
27,Paul Pierce,BOS,80,2874,363,809,280,83,161,27,92,28,55,2008
28,Josh Smith,ATL,81,2873,272,608,208,64,144,18,46,31,33,2008
29,David West,NOH,76,2870,177,437,94,83,53,13,28,33,50,2008
30,Stephen Jackson,GSW,73,2855,300,683,217,83,151,18,48,28,55,2008
31,Carlos Boozer,UTA,81,2827,233,489,210,23,123,19,68,4,19,2008
32,Carmelo Anthony,DEN,77,2807,259,567,210,49,130,26,54,18,31,2008
33,Brandon Roy,POR,74,2792,430,985,305,125,88,44,173,55,70,2008
34,Tyson Chandler,NOH,79,2783,81,189,54,27,26,7,21,4,23,2008
35,Steve Nash,PHX,81,2780,898,1959,735,163,478,88,169,76,87,2008
36,Dirk Nowitzki,DAL,77,2769,266,610,188,78,95,22,71,24,54,2008
37,Kevin Durant,SEA,80,2768,192,407,169,23,77,30,62,4,19,2008
38,Marvin Williams,ATL,80,2765,137,297,114,23,62,15,37,9,14,2008
39,Marcus Camby,DEN,79,2758,259,547,230,29,148,24,58,6,23,2008
40,Josh Howard,DAL,76,2757,164,378,114,50,47,15,52,19,31,2008
41,Samuel Dalembert,PHI,82,2724,45,95,40,5,32,2,6,0,5,2008
42,Andrew Bogut,MIL,78,2720,199,436,161,38,80,24,57,9,29,2008
43,Emeka Okafor,CHA,82,2718,70,161,49,21,22,6,21,5,16,2008
44,Peja Stojakovic,NOH,77,2711,96,227,61,35,29,8,24,19,16,2008
45,Michael Redd,MIL,72,2702,247,547,194,53,101,26,67,21,32,2008
46,Cuttino Mobley,LAC,77,2702,202,440,166,36,64,34,68,7,29,2008
47,Tayshaun Prince,DET,82,2694,268,602,202,66,71,30,101,17,49,2008
48,Amar'e Stoudemire,PHX,79,2677,118,266,88,30,47,3,38,12,18,2008
49,Tim Duncan,SAS,78,2651,218,506,148,70,77,14,57,28,42,2008
50,LaMarcus Aldridge,POR,76,2649,122,294,72,50,31,7,34,10,40,2008
51,Raja Bell,PHX,75,2646,168,374,130,38,58,20,52,14,24,2008
52,Anthony Parker,TOR,82,2634,183,401,148,35,70,23,55,8,27,2008
53,Ray Allen,BOS,73,2624,225,501,174,51,78,31,65,15,36,2008
54,Jason Terry,DAL,82,2579,264,596,196,68,63,31,102,15,53,2008
55,DeShawn Stevenson,WAS,82,2564,252,571,185,67,98,34,53,15,52,2008
56,Al Horford,ATL,81,2540,124,273,99,25,56,11,32,7,18,2008
57,Rafer Alston,HOU,74,2526,392,866,310,82,133,69,108,21,61,2008
58,Chauncey Billups,DET,78,2522,529,1179,408,121,151,44,213,36,85,2008
59,John Salmons,SAC,81,2517,208,486,138,70,64,15,59,25,45,2008
60,Brad Miller,SAC,72,2513,264,582,210,54,143,20,47,24,30,2008
61,Corey Maggette,LAC,70,2502,189,412,155,34,35,32,88,9,25,2008
62,Jose Calderon,TOR,82,2484,678,1554,480,198,194,62,224,67,131,2008
63,Mike Miller,MEM,70,2474,240,548,172,68,93,34,45,23,45,2008
64,Bruce Bowen,SAS,81,2448,91,213,60,31,12,11,37,16,15,2008
65,Tracy McGrady,HOU,66,2440,387,892,269,118,185,43,41,43,75,2008
66,Ryan Gomes,MIN,82,2434,145,330,105,40,45,27,33,14,26,2008
67,Chris Bosh,TOR,67,2425,171,408,105,66,46,17,42,17,49,2008
68,Richard Hamilton,DET,72,2424,299,671,226,73,118,22,86,23,50,2008
69,Steve Blake,POR,81,2424,413,930,309,104,109,61,139,44,60,2008
70,Leandro Barbosa,PHX,82,2421,216,507,141,75,75,20,46,30,45,2008
71,Mo Williams,MIL,66,2410,419,922,335,84,170,66,99,27,57,2008
72,Mehmet Okur,UTA,72,2390,145,315,120,25,64,15,41,6,19,2008
73,Mikki Moore,SAC,82,2385,84,195,57,27,21,4,32,7,20,2008
74,Kirk Hinrich,CHI,75,2380,452,984,372,80,129,40,203,33,47,2008
75,Gerald Wallace,CHA,62,2376,216,491,157,59,106,19,32,31,28,2008
76,David Lee,NYK,81,2356,95,227,58,37,42,8,8,12,25,2008
77,Pau Gasol,LAL,66,2351,211,497,136,75,82,16,38,23,52,2008
78,Rasheed Wallace,DET,77,2346,137,299,112,25,41,21,50,7,18,2008
79,Kevin Garnett,BOS,71,2328,244,560,172,72,122,15,35,21,51,2008
80,Shawn Marion,MIA,63,2315,138,334,80,58,42,7,31,23,35,2008
81,Caron Butler,WAS,58,2314,284,633,219,65,140,31,48,18,47,2008
82,Tony Parker,SAS,69,2312,411,980,253,158,104,44,105,84,74,2008
83,Boris Diaw,PHX,82,2308,317,750,201,116,98,31,72,48,68,2008
84,Rajon Rondo,BOS,77,2306,393,925,254,139,118,26,110,44,95,2008
85,Manu Ginobili,SAS,74,2299,332,742,254,78,130,45,79,52,26,2008
86,Ben Gordon,CHI,72,2291,213,480,159,54,83,17,59,17,37,2008
87,Antonio McDyess,DET,78,2285,89,200,67,22,26,11,30,9,13,2008
88,Josh Childress,ATL,76,2274,117,257,94,23,47,15,32,9,14,2008
89,Earl Watson,SEA,78,2269,531,1120,473,58,203,60,210,21,37,2008
90,Jeff Green,SEA,80,2253,119,253,104,15,42,11,51,8,7,2008
91,Derek Fisher,LAL,82,2249,239,532,185,54,119,26,40,15,39,2008
92,Zach Randolph,NYK,69,2244,140,315,105,35,82,12,11,5,30,2008
93,Jarrett Jack,POR,82,2229,313,696,243,70,97,31,115,33,37,2008
94,Brendan Haywood,WAS,80,2228,71,168,45,26,17,7,21,5,21,2008
95,Nick Collison,SEA,78,2223,113,253,86,27,52,9,25,6,21,2008
96,Zydrunas Ilgauskas,CLE,73,2222,104,238,74,30,48,10,16,6,24,2008
97,Grant Hill,PHX,70,2222,203,460,149,54,82,27,40,16,38,2008
98,Andrei Kirilenko,UTA,72,2217,285,605,250,35,158,26,66,11,24,2008
99,Kevin Martin,SAC,61,2216,129,297,90,39,44,11,35,10,29,2008
100,Ben Wallace,CLE,72,2205,105,239,76,29,38,7,31,7,22,2008
101,Michael Finley,SAS,82,2204,114,252,90,24,34,33,23,9,15,2008
102,Keith Bogans,ORL,82,2198,104,241,71,33,38,24,9,14,19,2008
103,Al Harrington,GSW,81,2190,132,306,90,42,61,4,25,9,33,2008
104,Marko Jaric,MIN,75,2188,311,682,251,60,113,70,68,14,46,2008
105,Travis Outlaw,POR,82,2186,106,261,57,49,20,12,25,24,25,2008
106,Metta World Peace,SAC,57,2172,199,460,137,62,83,13,41,15,47,2008
107,Jamario Moon,TOR,78,2166,90,211,59,31,31,12,16,16,15,2008
108,Antonio Daniels,WAS,71,2161,340,792,228,112,108,38,82,32,80,2008
109,Kenyon Martin,DEN,71,2159,90,196,74,16,50,9,15,6,10,2008
110,Al Thornton,LAC,79,2158,98,210,84,14,27,14,43,8,6,2008
111,Martell Webster,POR,75,2132,90,199,71,19,27,12,32,10,9,2008
112,Luol Deng,CHI,63,2128,155,348,117,38,58,19,40,9,29,2008
113,Drew Gooden,CHI,69,2122,81,180,63,18,38,3,22,5,13,2008
114,Juan Carlos Navarro,MEM,82,2117,177,401,130,47,88,14,28,14,33,2008
115,Troy Murphy,IND,75,2106,165,406,89,76,38,9,42,18,58,2008
116,Francisco Garcia,SAC,79,2096,128,285,99,29,43,14,42,8,21,2008
117,Kyle Lowry,MEM,82,2089,296,724,164,132,85,22,57,26,106,2008
118,Ronnie Brewer,UTA,76,2088,134,286,116,18,64,13,39,4,14,2008
119,Chris Kaman,LAC,56,2083,107,240,81,26,27,10,44,2,24,2008
120,Beno Udrih,SAC,65,2080,282,645,201,81,105,7,89,31,50,2008
121,Andris Biedrins,GSW,76,2079,75,169,56,19,29,7,20,4,15,2008
122,Yao Ming,HOU,55,2044,129,309,78,51,52,10,16,10,41,2008
123,Luis Scola,HOU,82,2024,106,262,56,50,30,10,16,16,34,2008
124,Devin Harris,NJN,64,2022,369,810,297,72,156,39,102,26,46,2008
125,Andres Nocioni,CHI,82,2020,95,222,63,32,33,7,23,8,24,2008
126,Larry Hughes,CHI,68,2020,181,400,143,38,86,19,38,15,23,2008
127,Rashad McCants,MIN,75,2020,162,350,136,26,70,28,38,5,21,2008
128,Matt Carroll,CHA,80,2016,73,162,57,16,18,11,28,9,7,2008
129,Willie Green,PHI,74,1970,151,326,127,24,78,15,34,10,14,2008
130,Jameer Nelson,ORL,69,1961,383,947,202,181,141,29,32,71,110,2008
131,Anthony Carter,DEN,70,1960,388,842,322,66,185,36,101,19,47,2008
132,Dwyane Wade,MIA,51,1954,354,782,280,74,139,43,98,34,40,2008
133,Tim Thomas,LAC,63,1940,171,375,138,33,52,29,57,8,25,2008
134,Sebastian Telfair,MIN,60,1933,355,811,254,101,112,57,85,23,78,2008
135,Carlos Delfino,TOR,82,1928,145,326,109,36,45,19,45,21,15,2008
136,Kendrick Perkins,BOS,78,1912,84,186,66,18,42,8,16,4,14,2008
137,Linas Kleiza,DEN,79,1889,95,223,62,33,36,6,20,9,24,2008
138,Jason Williams,MIA,67,1886,307,659,262,45,95,24,143,12,33,2008
139,Jeff Foster,IND,77,1884,129,298,89,40,23,11,55,5,35,2008
140,Nate Robinson,NYK,72,1883,212,469,167,45,86,26,55,16,29,2008
141,Reggie Evans,PHI,81,1879,65,140,55,10,26,7,22,5,5,2008
142,Lou Williams,PHI,80,1862,253,562,197,56,118,24,55,24,32,2008
143,Andrea Bargnani,TOR,78,1861,89,207,60,29,23,10,27,12,17,2008
144,Damien Wilkins,SEA,76,1843,150,326,124,26,47,21,56,5,21,2008
145,Quentin Richardson,NYK,65,1841,116,264,84,32,41,17,26,14,18,2008
146,Charlie Villanueva,MIL,76,1829,78,172,62,16,39,11,12,13,3,2008
147,James Posey,BOS,74,1821,114,266,76,38,36,7,33,12,26,2008
148,Joel Przybilla,POR,77,1820,27,64,17,10,6,4,7,4,6,2008
149,Udonis Haslem,MIA,49,1806,68,153,51,17,26,7,18,3,14,2008
150,Corey Brewer,MIN,79,1802,111,242,91,20,52,24,15,6,14,2008
151,Morris Peterson,NOH,76,1796,67,156,45,22,27,9,9,11,11,2008
152,Josh Boone,NJN,70,1773,55,123,42,13,19,4,19,5,8,2008
153,Jason Maxiell,DET,82,1768,46,106,32,14,8,6,18,4,10,2008
154,Daniel Gibson,CLE,58,1765,145,332,103,42,52,16,35,25,17,2008
155,Devin Brown,CLE,78,1762,175,392,133,42,69,18,46,15,27,2008
156,Fred Jones,NYK,70,1756,166,368,130,36,68,24,38,20,16,2008
157,Erick Dampier,DAL,72,1755,63,140,49,14,20,6,23,4,10,2008
158,Hakim Warrick,MEM,75,1754,53,125,34,19,21,6,7,3,16,2008
159,Shaquille O'Neal,PHX,61,1748,93,207,72,21,41,6,25,0,21,2008
160,Chris Wilcox,SEA,62,1739,74,164,58,16,35,5,18,4,12,2008
161,Wally Szczerbiak,CLE,75,1736,104,227,85,19,37,15,33,4,15,2008
162,Kyle Korver,UTA,75,1733,101,219,84,17,42,13,29,3,14,2008
163,Kelenna Azubuike,GSW,81,1732,75,182,43,32,28,5,10,14,18,2008
164,Luke Walton,LAL,74,1729,218,480,174,44,108,25,41,13,31,2008
165,Joe Smith,CLE,77,1726,66,153,45,21,19,5,21,6,15,2008
166,Maurice Evans,ORL,75,1721,81,183,60,21,35,17,8,4,17,2008
167,Roger Mason Jr.,WAS,80,1707,134,305,97,37,35,21,41,6,31,2008
168,Desmond Mason,MIL,59,1702,121,257,106,15,46,14,46,6,9,2008
169,Paul Millsap,UTA,82,1702,81,185,58,23,25,6,27,6,17,2008
170,Jordan Farmar,LAL,82,1690,225,524,151,74,78,21,52,29,45,2008
171,Andray Blatche,WAS,82,1674,92,212,64,28,40,10,14,7,21,2008
172,Brevin Knight,LAC,74,1674,328,719,265,63,125,46,94,10,53,2008
173,Eduardo Najera,DEN,78,1664,95,223,62,33,29,5,28,9,24,2008
174,Darko Milicic,MEM,70,1663,58,137,37,21,21,2,14,5,16,2008
175,Bostjan Nachbar,NJN,75,1659,88,195,69,19,39,5,25,4,15,2008
176,Nazr Mohammed,CHA,82,1650,72,157,59,13,42,2,15,4,9,2008
177,Yi Jianlian,MIL,66,1647,55,133,32,23,12,7,13,12,11,2008
178,Fabricio Oberto,SAS,82,1644,95,225,60,35,36,6,18,15,20,2008
179,Charlie Bell,MIL,68,1628,210,476,154,56,76,24,54,16,40,2008
180,Kurt Thomas,SAS,70,1584,67,152,49,18,27,9,13,6,12,2008
181,Chuck Hayes,HOU,79,1575,91,211,62,29,32,7,23,3,26,2008
182,Mike Bibby,ATL,48,1574,290,635,235,55,136,39,60,20,35,2008
183,Bonzi Wells,NOH,73,1561,97,213,78,19,50,12,16,1,18,2008
184,Brandon Bass,DAL,79,1556,58,127,47,11,14,7,26,5,6,2008
185,Thaddeus Young,PHI,74,1554,58,130,44,14,36,4,4,4,10,2008
186,Darius Songaila,WAS,80,1554,135,308,97,38,55,12,30,7,31,2008
187,Craig Smith,MIN,77,1546,60,134,46,14,17,12,17,4,10,2008
188,Marquis Daniels,IND,74,1546,137,335,76,61,40,12,24,18,43,2008
189,Mark Blount,MIA,69,1542,41,97,26,15,17,3,6,5,10,2008
190,Joakim Noah,CHI,74,1534,84,185,67,17,35,9,23,2,15,2008
191,Delonte West,CLE,61,1534,229,492,195,34,93,32,70,13,21,2008
192,Eddy Curry,NYK,59,1530,32,83,13,19,8,0,5,3,16,2008
193,Anthony Johnson,SAC,69,1530,262,550,236,26,131,31,74,7,19,2008
194,Jason Kapono,TOR,81,1530,65,153,42,23,20,8,14,11,12,2008
195,Bobby Simmons,MIL,70,1521,80,175,65,15,34,20,11,2,13,2008
196,Quinton Ross,LAC,76,1505,88,188,76,12,16,13,47,0,12,2008
197,Kareem Rush,IND,71,1504,89,214,53,36,26,9,18,9,27,2008
198,Jannero Pargo,NOH,80,1497,192,442,134,58,81,15,38,22,36,2008
199,Chris Duhon,CHI,66,1490,263,574,215,48,83,31,101,15,33,2008
200,Rasho Nesterovic,TOR,71,1486,82,184,62,20,24,3,35,4,16,2008
201,Vladimir Radmanovic,LAL,65,1483,123,278,91,32,45,20,26,9,23,2008
202,Eddie House,BOS,78,1480,152,334,122,30,67,19,36,14,16,2008
203,Ronny Turiaf,LAL,78,1458,128,305,79,49,45,8,26,15,34,2008
204,Daequan Cook,MIA,59,1441,75,181,44,31,18,6,20,6,25,2008
205,Royal Ivey,MIL,75,1437,160,367,113,47,48,18,47,19,28,2008
206,Thabo Sefolosha,CHI,69,1436,129,306,81,48,34,7,40,13,35,2008
207,JR Smith,DEN,74,1421,128,299,85,43,56,13,16,16,27,2008
208,Matt Barnes,GSW,73,1414,139,326,91,48,60,8,23,16,32,2008
209,Jerry Stackhouse,DAL,58,1412,145,329,106,39,32,14,60,12,27,2008
210,Jeff McInnis,CHA,54,1410,220,500,160,60,83,25,52,21,39,2008
211,Bobby Jackson,HOU,72,1389,139,314,103,36,59,11,33,8,28,2008
212,Jared Dudley,CHA,73,1384,81,190,53,28,36,4,13,11,17,2008
213,Mike Conley,MEM,53,1381,222,529,137,85,80,13,44,21,64,2008
214,Luther Head,HOU,73,1379,138,308,106,32,52,25,29,9,23,2008
215,Matt Harpring,UTA,76,1374,82,178,68,14,45,9,14,6,8,2008
216,Tony Allen,BOS,75,1373,114,266,76,38,55,6,15,13,25,2008
217,Travis Diener,IND,66,1356,251,621,132,119,66,13,53,35,84,2008
218,Channing Frye,POR,78,1342,57,135,36,21,13,9,14,7,14,2008
219,Chris Quinn,MIA,60,1340,178,414,120,58,25,14,81,19,39,2008
220,Damon Jones,CLE,67,1336,126,291,87,39,34,13,40,20,19,2008
221,Keyon Dooling,ORL,72,1334,133,333,66,67,44,11,11,21,46,2008
222,Tyrus Thomas,CHI,74,1330,90,194,76,14,46,7,23,2,12,2008
223,Jared Jeffries,NYK,73,1325,66,149,49,17,26,4,19,3,14,2008
224,Anderson Varejao,CLE,48,1320,53,115,44,9,26,6,12,2,7,2008
225,Ime Udoka,SAS,73,1316,63,141,48,15,19,8,21,8,7,2008
226,Mickael Pietrus,GSW,66,1316,49,110,37,12,30,1,6,3,9,2008
227,Johan Petro,SEA,72,1310,32,67,29,3,14,3,12,1,2,2008
228,DeSagana Diop,NJN,79,1296,40,86,34,6,18,5,11,0,6,2008
229,Jamaal Tinsley,IND,39,1293,326,760,218,108,132,31,55,15,93,2008
230,Jarvis Hayes,DET,82,1287,62,132,54,8,16,12,26,3,5,2008
231,Sasha Vujacic,LAL,72,1279,72,171,45,27,27,5,13,9,18,2008
232,Sean Williams,NJN,73,1278,28,62,22,6,9,2,11,1,5,2008
233,James Jones,POR,58,1276,34,78,24,10,9,6,9,3,7,2008
234,Sam Cassell,BOS,55,1273,214,480,162,52,64,28,70,8,44,2008
235,Carlos Arroyo,ORL,62,1269,219,541,116,103,86,14,16,28,75,2008
236,Randy Foye,MIN,39,1259,164,355,137,27,64,21,52,8,19,2008
237,Antoine Wright,DAL,56,1231,80,173,67,13,28,9,30,7,6,2008
238,Josh Powell,LAC,64,1227,47,99,42,5,20,5,17,2,3,2008
239,Luke Ridnour,SEA,61,1223,241,522,201,40,94,34,73,16,24,2008
240,Jermaine O'Neal,IND,42,1206,93,218,61,32,40,9,12,6,26,2008
241,T.J. Ford,TOR,51,1199,313,691,248,65,111,26,111,22,43,2008
242,Sasha Pavlovic,CLE,51,1188,82,184,62,20,33,8,21,14,6,2008
243,Jason Collins,MEM,74,1172,25,55,20,5,9,2,9,1,4,2008
244,Nick Young,WAS,75,1158,63,142,47,16,20,10,17,3,13,2008
245,Jacque Vaughn,SAS,74,1139,159,379,98,61,38,15,45,29,32,2008
246,Jason Smith,PHI,76,1106,20,48,12,8,7,1,4,5,3,2008
247,Dorell Wright,MIA,44,1104,60,131,49,11,25,5,19,4,7,2008
248,Malik Allen,DAL,73,1096,44,105,27,17,10,6,11,8,9,2008
249,Rodney Stuckey,DET,57,1081,160,360,120,40,61,15,44,15,25,2008
250,Dan Dickau,LAC,67,1040,172,378,138,34,46,34,58,8,26,2008
251,Rodney Carney,PHI,70,1038,32,68,28,4,10,4,14,3,1,2008
252,Damon Stoudamire,SAS,60,1037,165,380,115,50,61,23,31,14,36,2008
253,Andrew Bynum,LAL,35,1008,61,134,49,12,29,6,14,4,8,2008
254,Arron Afflalo,DET,75,970,52,113,43,9,27,3,13,3,6,2008
255,Shawne Williams,IND,65,967,59,138,39,20,18,9,12,2,18,2008
256,Renaldo Balkman,NYK,65,952,40,95,25,15,16,1,8,2,13,2008
257,Zaza Pachulia,ATL,62,944,36,79,29,7,17,3,9,2,5,2008
258,Glen Davis,BOS,69,940,28,66,18,10,11,1,6,2,8,2008
259,Spencer Hawes,SAC,71,931,44,99,33,11,26,1,6,1,10,2008
260,Kris Humphries,TOR,70,925,28,67,17,11,4,0,13,6,5,2008
261,Eddie Jones,DAL,47,922,69,157,50,19,17,9,24,10,9,2008
262,Antoine Walker,MIN,46,892,45,98,37,8,21,9,7,1,7,2008
263,Earl Barron,MIA,46,889,29,66,21,8,12,1,8,5,3,2008
264,Quincy Douby,SAC,74,876,53,115,44,9,22,2,20,2,7,2008
265,Rasual Butler,NOH,51,875,36,82,26,10,16,2,8,5,5,2008
266,Flip Murray,IND,42,873,144,325,107,37,61,9,37,8,29,2008
267,Acie Law,ATL,56,865,113,239,100,13,60,11,29,3,10,2008
268,Marcus Williams,NJN,53,854,140,312,108,32,48,15,45,16,16,2008
269,Matt Bonner,SAS,68,852,32,71,25,7,7,2,16,3,4,2008
270,Stromile Swift,NJN,56,845,26,57,21,5,17,0,4,2,3,2008
271,Brian Skinner,PHX,66,844,15,39,6,9,3,2,1,4,5,2008
272,Gordan Giricek,PHX,56,831,62,136,50,12,19,14,17,5,7,2008
273,Devean George,DAL,53,821,35,83,22,13,9,5,8,2,11,2008
274,Francisco Elson,SEA,63,813,24,56,16,8,8,6,2,2,6,2008
275,Nenad Krstic,NJN,45,812,27,65,16,11,10,1,5,3,8,2008
276,Leon Powe,BOS,56,809,15,37,8,7,5,0,3,1,6,2008
277,Stephon Marbury,NYK,24,805,113,253,86,27,45,18,23,12,15,2008
278,Shelden Williams,SAC,64,776,19,40,17,2,8,2,7,0,2,2008
279,Adonal Foyle,ORL,82,774,18,40,14,4,10,1,3,1,3,2008
280,Trenton Hassell,NJN,63,773,41,100,23,18,12,0,11,7,11,2008
281,Amir Johnson,DET,62,764,29,62,25,4,12,5,8,1,3,2008
282,Kirk Snyder,MIN,36,761,64,145,47,17,26,10,11,3,14,2008
283,Tyronn Lue,DAL,50,736,74,160,62,12,31,6,25,3,9,2008
284,Hilton Armstrong,NOH,65,732,23,50,19,4,9,2,8,0,4,2008
285,Mike James,NOH,54,720,60,130,50,10,24,10,16,0,10,2008
286,Kwame Brown,MEM,38,713,45,96,39,6,23,5,11,0,6,2008
287,Carl Landry,HOU,42,711,21,50,13,8,4,1,8,2,6,2008
288,David Harrison,IND,55,702,14,33,9,5,5,0,4,1,4,2008
289,Jarron Collins,UTA,70,702,37,79,32,5,13,3,16,2,3,2008
290,Ira Newble,LAL,49,698,18,38,16,2,7,1,8,1,1,2008
291,Dominic McGuire,WAS,70,695,40,94,26,14,17,5,4,5,9,2008
292,CJ Miles,UTA,60,689,53,116,43,10,30,7,6,2,8,2008
293,Wilson Chandler,NYK,35,685,33,75,24,9,6,10,8,5,4,2008
294,Javaris Crittenton,MEM,50,678,51,121,32,19,25,5,2,6,13,2008
295,Juan Dixon,DET,53,668,97,211,80,17,39,7,34,1,16,2008
296,Ryan Bowen,NOH,53,660,25,58,17,8,7,1,9,1,7,2008
297,Julian Wright,NOH,57,640,40,89,31,9,23,1,7,3,6,2008
298,Mardy Collins,NYK,46,634,89,202,65,24,29,8,28,6,18,2008
299,Michael Ruffin,MIL,46,632,24,53,19,5,8,3,8,1,4,2008
300,Brian Cook,ORL,51,629,27,62,19,8,13,3,3,2,6,2008
301,Sergio Rodriguez,POR,72,628,123,279,90,33,33,6,51,24,9,2008
302,Melvin Ely,NOH,52,621,22,49,17,5,7,4,6,2,3,2008
303,Dikembe Mutombo,HOU,39,619,5,13,2,3,0,0,2,0,3,2008
304,Aaron Gray,CHI,61,613,41,92,31,10,23,4,4,3,7,2008
305,Aaron Brooks,HOU,51,608,87,206,55,32,21,14,20,11,21,2008
306,Jason Hart,UTA,57,606,86,189,69,17,20,7,42,2,15,2008
307,Smush Parker,LAC,28,592,84,174,78,6,35,20,23,2,4,2008
308,Ronnie Price,UTA,61,588,78,173,61,17,24,9,28,5,12,2008
309,Robert Horry,SAS,45,583,47,109,32,15,15,5,12,9,6,2008
310,Earl Boykins,CHA,36,577,96,217,71,25,32,14,25,10,15,2008
311,Marcus Banks,MIA,36,569,61,141,42,19,16,7,19,4,15,2008
312,Chris Richard,MIN,52,556,18,40,14,4,7,3,4,0,4,2008
313,Brent Barry,SAS,31,554,54,125,37,17,21,6,10,3,14,2008
314,Alexander Johnson,MIA,43,549,13,28,11,2,5,2,4,0,2,2008
315,Darrell Armstrong,NJN,50,548,73,163,56,17,33,4,19,5,12,2008
316,Casey Jacobsen,MEM,53,547,20,49,11,9,8,0,3,4,5,2008
317,Trevor Ariza,LAL,35,546,44,103,29,15,16,2,11,4,11,2008
318,Yakhouba Diawara,DEN,54,542,37,93,18,19,11,0,7,3,16,2008
319,Dan Gadzuric,MIL,51,534,11,24,9,2,8,0,1,0,2,2008
320,Ryan Hollins,CHA,60,531,14,30,12,2,7,1,4,0,2,2008
321,Bobby Jones,DEN,46,530,28,70,14,14,7,1,6,5,9,2008
322,Greg Buckner,MIN,31,519,39,86,31,8,14,8,9,1,7,2008
323,Brian Scalabrine,BOS,48,512,40,97,23,17,12,3,8,3,14,2008
324,Joel Anthony,MIA,24,498,3,9,0,3,0,0,0,3,0,2008
325,Malik Rose,NYK,49,494,28,62,22,6,14,0,8,3,3,2008
326,Primoz Brezec,TOR,50,475,11,26,7,4,3,1,3,0,4,2008
327,Dwayne Jones,CLE,56,472,10,24,6,4,6,0,0,0,4,2008
328,Mickael Gelabale,SEA,39,465,33,75,24,9,7,8,9,3,6,2008
329,J.J. Barea,DAL,44,460,58,135,39,19,11,13,15,8,11,2008
330,Austin Croshere,GSW,44,457,30,74,16,14,9,1,6,8,6,2008
331,Ramon Sessions,MIL,17,450,127,281,100,27,45,18,37,8,19,2008
332,Brian Cardinal,MEM,37,440,22,55,11,11,9,1,1,5,6,2008
333,Theo Ratliff,DET,26,437,14,32,10,4,5,2,3,0,4,2008
334,Gilbert Arenas,WAS,13,425,66,147,51,15,31,5,15,4,11,2008
335,Salim Stoudamire,ATL,35,401,28,58,26,2,12,4,10,2,0,2008
336,Derek Anderson,CHA,28,396,44,94,38,6,20,6,12,3,3,2008
337,Andre Owens,IND,31,392,47,114,27,20,11,4,12,4,16,2008
338,Alonzo Mourning,MIA,25,389,7,17,4,3,3,0,1,1,2,2008
339,Jake Voskuhl,MIL,44,386,13,27,12,1,6,2,4,1,0,2008
340,Brandan Wright,GSW,38,376,9,24,3,6,1,0,2,2,4,2008
341,Walter Herrmann,DET,45,373,18,42,12,6,5,2,5,2,4,2008
342,C.J. Watson,GSW,32,368,35,86,19,16,10,4,5,3,13,2008
343,Gerald Green,HOU,30,361,29,71,16,13,6,4,6,2,11,2008
344,Juwan Howard,DAL,50,352,17,38,13,4,5,2,6,0,4,2008
345,Chucky Atkins,DEN,24,352,47,104,37,10,30,2,5,3,7,2008
346,Donyell Marshall,SEA,26,340,10,21,9,1,6,1,2,0,1,2008
347,Joey Graham,TOR,38,331,15,33,12,3,8,0,4,1,2,2008
348,Ruben Patterson,LAC,20,327,17,36,15,2,8,2,5,1,1,2008
349,DJ Mbenga,LAL,42,326,10,22,8,2,3,2,3,0,2,2008
350,Anfernee Hardaway,MIA,16,325,35,72,33,2,19,8,6,0,2,2008
351,Jermareo Davidson,CHA,38,322,13,30,9,4,5,2,2,1,3,2008
352,Oleksiy Pecherov,WAS,35,320,7,15,6,1,3,1,2,1,0,2008
353,Adrian Griffin,SEA,35,307,27,62,19,8,10,3,6,1,7,2008
354,Eric Snow,CLE,22,305,42,95,31,11,15,3,13,5,6,2008
355,Ike Diogu,IND,30,305,10,25,5,5,2,0,3,3,2,2008
356,Kasib Powell,MIA,11,304,18,45,9,9,3,0,6,1,8,2008
357,Stephane Lasme,MIA,16,303,3,8,1,2,0,0,1,1,1,2008
358,Kevin Ollie,PHI,40,300,38,82,32,6,13,9,10,2,4,2008
359,Aaron Williams,LAC,30,297,9,19,8,1,4,1,3,0,1,2008
360,Raef LaFrentz,POR,39,291,6,14,4,2,2,0,2,0,2,2008
361,Andre Brown,MEM,33,286,8,18,6,2,2,2,2,0,2,2008
362,Jamaal Magloire,DAL,31,286,7,15,6,1,2,0,4,0,1,2008
363,Pat Garrity,ORL,31,284,13,32,7,6,2,2,3,2,4,2008
364,Kenny Thomas,SAC,23,281,13,29,10,3,5,2,3,2,1,2008
365,Chris Mihm,LAL,23,278,13,30,9,4,2,2,5,2,2,2008
366,JJ Redick,ORL,34,276,16,37,11,5,6,0,5,2,3,2008
367,Elton Brand,LAC,8,274,16,38,10,6,3,0,7,1,5,2008
368,DJ Strawberry,PHX,33,270,30,66,24,6,8,3,13,1,5,2008
369,Nick Fazekas,LAC,26,269,11,27,6,5,1,0,5,0,5,2008
370,Mario West,ATL,64,268,13,27,12,1,7,2,3,0,1,2008
371,Nene,DEN,16,266,15,35,10,5,8,1,1,0,5,2008
372,Steve Novak,HOU,35,264,6,15,3,3,1,1,1,0,3,2008
373,Awvee Storey,MIL,26,258,16,33,15,1,8,2,5,1,0,2008
374,Michael Doleac,MIN,24,257,7,15,6,1,3,2,1,0,1,2008
375,Marco Belinelli,GSW,33,241,15,35,10,5,6,1,3,2,3,2008
376,Shannon Brown,CHI,21,240,17,41,10,7,5,0,5,3,4,2008
377,Luke Jackson,MIA,14,228,17,39,12,5,5,2,5,1,4,2008
378,Lindsey Hunter,DET,24,215,33,72,27,6,13,3,11,0,6,2008
379,P.J. Brown,BOS,18,209,10,22,8,2,3,2,3,0,2,2008
380,Dahntay Jones,SAC,25,206,12,26,10,2,5,1,4,1,1,2008
381,Calvin Booth,PHI,31,204,8,18,6,2,4,0,2,1,1,2008
382,Steve Francis,HOU,10,199,30,68,22,8,10,4,8,4,4,2008
383,Paul Davis,LAC,22,194,10,21,9,1,6,1,2,0,1,2008
384,Mike Wilks,SEA,15,188,14,34,8,6,2,1,5,1,5,2008
385,Randolph Morris,NYK,18,181,2,4,2,0,1,0,1,0,0,2008
386,Blake Ahearn,MIA,12,177,19,43,14,5,5,1,8,2,3,2008
387,Scot Pollard,BOS,22,173,3,8,1,2,0,0,1,1,1,2008
388,Othella Harrington,CHA,22,166,4,9,3,1,1,0,2,0,1,2008
389,Maurice Ager,NJN,26,165,8,17,7,1,4,1,2,1,0,2008
390,Richie Frahm,LAC,10,163,8,16,8,0,3,2,3,0,0,2008
391,Lorenzen Wright,SAC,18,161,4,10,2,2,1,0,1,1,1,2008
392,Mike Harris,HOU,17,159,3,8,1,2,1,0,0,0,2,2008
393,Von Wafer,POR,28,154,7,17,4,3,3,0,1,1,2,2008
394,Eddie Gill,SEA,14,153,22,48,18,4,4,3,11,1,3,2008
395,Mark Madsen,MIN,20,151,4,9,3,1,1,1,1,0,1,2008
396,James Augustine,ORL,25,149,2,5,1,1,1,0,0,0,1,2008
397,Darius Washington,SAS,18,146,15,41,4,11,2,0,2,3,8,2008
398,Solomon Jones,ATL,35,145,0,0,0,0,0,0,0,0,0,2008
399,Darrick Martin,TOR,17,141,21,52,11,10,3,1,7,2,8,2008
400,Jeremy Richardson,ATL,27,132,2,5,1,1,0,0,1,0,1,2008
401,Sean Marks,PHX,19,130,4,9,3,1,1,0,2,0,1,2008
402,Stephen Graham,IND,22,128,9,20,7,2,2,1,4,0,2,2008
403,Chris Webber,GSW,9,126,18,39,15,3,11,2,2,0,3,2008
404,Justin Williams,HOU,23,123,0,0,0,0,0,0,0,0,0,2008
405,Steven Hunter,DEN,19,120,0,0,0,0,0,0,0,0,0,2008
406,Eric Piatkowski,PHX,16,113,10,23,7,3,4,0,3,1,2,2008
407,Viktor Khryapa,CHI,9,105,8,17,7,1,4,2,1,0,1,2008
408,Maceo Baston,TOR,15,103,3,6,3,0,2,0,1,0,0,2008
409,Patrick O'Bryant,GSW,24,99,4,8,4,0,3,0,1,0,0,2008
410,Robert Swift,SEA,8,98,1,2,1,0,1,0,0,0,0,2008
411,Tarence Kinsey,MEM,11,96,2,4,2,0,1,1,0,0,0,2008
412,Gabe Pruitt,BOS,15,94,13,29,10,3,3,1,6,3,0,2008
413,Troy Hudson,GSW,9,93,9,22,5,4,4,0,1,3,1,2008
414,Cedric Simmons,CHI,14,87,0,0,0,0,0,0,0,0,0,2008
415,Jorge Garbajosa,TOR,7,74,3,7,2,1,0,1,1,0,1,2008
416,Taurean Green,DEN,17,74,11,26,7,4,4,0,3,2,2,2008
417,Darryl Watkins,SAC,9,71,0,0,0,0,0,0,0,0,0,2008
418,Coby Karl,LAL,17,71,9,19,8,1,5,1,2,1,0,2008
419,Kyrylo Fesenko,UTA,9,70,2,4,2,0,2,0,0,0,0,2008
420,Marcus Vinicius,NOH,13,69,2,5,1,1,0,0,1,0,1,2008
421,Lou Amundson,PHI,16,64,0,0,0,0,0,0,0,0,0,2008
422,Linton Johnson,TOR,8,63,4,8,4,0,1,1,2,0,0,2008
423,Mouhamed Sene,SEA,13,62,1,2,1,0,1,0,0,0,0,2008
424,Orien Greene,SAC,7,61,3,7,2,1,0,1,1,0,1,2008
425,Shareef Abdur-Rahim,SAC,6,51,4,9,3,1,3,0,0,1,0,2008
426,Alando Tucker,PHX,6,48,0,0,0,0,0,0,0,0,0,2008
427,Thomas Gardner,CHI,4,45,1,2,1,0,0,0,1,0,0,2008
428,Demetris Nichols,CHI,14,44,1,2,1,0,0,0,1,0,0,2008
429,Billy Thomas,CLE,11,42,0,0,0,0,0,0,0,0,0,2008
430,Marcin Gortat,ORL,6,41,2,4,2,0,1,0,1,0,0,2008
431,Morris Almond,UTA,9,39,3,7,2,1,1,0,1,1,0,2008
432,Kosta Perovic,GSW,7,38,1,3,0,1,0,0,0,0,1,2008
433,Marcus Williams,LAC,11,36,3,7,2,1,1,0,1,0,1,2008
434,Chris Andersen,NOH,5,34,0,0,0,0,0,0,0,0,0,2008
435,Jelani McCoy,DEN,6,33,0,0,0,0,0,0,0,0,0,2008
436,Cheikh Samb,DET,4,31,0,0,0,0,0,0,0,0,0,2008
437,Josh McRoberts,POR,8,28,2,4,2,0,1,1,0,0,0,2008
438,DerMarr Johnson,SAS,5,28,1,2,1,0,1,0,0,0,0,2008
439,Shavlik Randolph,PHI,9,27,3,7,2,1,1,0,1,0,1,2008
440,Andre Barrett,LAC,4,25,7,17,4,3,2,0,2,1,2,2008
441,Ian Mahinmi,SAS,6,23,1,2,1,0,1,0,0,0,0,2008
442,Ronald Dupree,SEA,5,21,1,2,1,0,0,1,0,0,0,2008
443,Guillermo Diaz,LAC,6,18,1,2,1,0,1,0,0,0,0,2008
444,Loren Woods,HOU,7,17,2,4,2,0,2,0,0,0,0,2008
445,Kaniel Dickens,CLE,5,12,1,2,1,0,1,0,0,0,0,2008
446,Courtney Sims,IND,3,11,1,2,1,0,1,0,0,0,0,2008
447,Lance Allred,CLE,3,10,0,0,0,0,0,0,0,0,0,2008
448,Keith Langford,SAS,2,10,0,0,0,0,0,0,0,0,0,2008
449,Bo Outlaw,ORL,2,7,0,0,0,0,0,0,0,0,0,2008
450,Jerome James,NYK,2,5,0,0,0,0,0,0,0,0,0,2008
0,LeBron James,CLE,78,3190,470,1065,345,125,194,43,108,61,64,2007
1,Kobe Bryant,LAL,77,3140,413,964,275,138,186,35,54,46,92,2007
2,Vince Carter,NJN,82,3126,393,906,273,120,153,26,94,50,70,2007
3,Elton Brand,LAC,80,3078,235,523,182,53,72,23,87,6,47,2007
4,Luol Deng,CHI,82,3072,204,483,129,75,56,19,54,20,55,2007
5,Andre Iguodala,PHI,76,3062,432,927,369,63,214,57,98,21,42,2007
6,Rafer Alston,HOU,82,3040,444,1001,331,113,118,72,141,40,73,2007
7,Dwight Howard,ORL,82,3024,158,353,121,37,75,11,35,11,26,2007
8,Ricky Davis,MIN,81,3021,385,837,318,67,108,64,146,16,51,2007
9,Shawn Marion,PHX,80,3010,134,329,73,61,40,3,30,28,33,2007
10,Tayshaun Prince,DET,82,3001,227,509,172,55,58,48,66,16,39,2007
11,Kevin Garnett,MIN,76,2995,313,696,243,70,136,28,79,18,52,2007
12,Shane Battier,HOU,82,2988,175,406,119,56,56,39,24,9,47,2007
13,Andre Miller,PHI,80,2966,625,1351,524,101,318,39,167,16,85,2007
14,Deron Williams,UTA,80,2950,745,1623,612,133,311,87,214,17,116,2007
15,Gilbert Arenas,WAS,74,2942,443,982,347,96,181,37,129,32,64,2007
16,Jason Kidd,NJN,80,2933,736,1652,556,180,286,62,208,45,135,2007
17,Raja Bell,PHX,78,2917,196,475,113,83,68,16,29,25,58,2007
18,Eddy Curry,NYK,81,2849,68,168,36,32,20,2,14,6,26,2007
19,Charlie Bell,MIL,82,2848,247,557,184,63,108,26,50,24,39,2007
20,Jason Terry,DAL,81,2846,422,942,324,98,154,35,135,18,80,2007
21,Cuttino Mobley,LAC,78,2841,198,415,179,19,53,56,70,3,16,2007
22,Kirk Hinrich,CHI,80,2839,500,1088,412,88,163,58,191,23,65,2007
23,Raymond Felton,CHA,78,2832,545,1208,427,118,203,57,167,60,58,2007
24,Dirk Nowitzki,DAL,78,2821,263,604,185,78,102,26,57,39,39,2007
25,Kevin Martin,SAC,80,2818,173,406,113,60,52,15,46,10,50,2007
26,Danny Granger,IND,82,2785,114,262,80,34,35,14,31,5,29,2007
27,Mike Bibby,SAC,82,2784,388,867,297,91,156,35,106,27,64,2007
28,Richard Hamilton,DET,75,2763,285,624,231,54,117,34,80,24,30,2007
29,Allen Iverson,DEN,65,2761,468,1050,354,114,210,36,108,44,70,2007
30,Stephon Marbury,NYK,74,2748,403,890,319,84,183,33,103,30,54,2007
31,Mike Miller,MEM,70,2740,298,656,238,60,115,42,81,22,38,2007
32,Tim Duncan,SAS,80,2726,273,621,198,75,125,19,54,25,50,2007
33,Ben Gordon,CHI,82,2704,296,647,241,55,93,23,125,16,39,2007
34,Ben Wallace,CHI,77,2697,186,407,151,35,77,21,53,13,22,2007
35,Amar'e Stoudemire,PHX,82,2689,84,193,59,25,42,5,12,11,14,2007
36,Steve Nash,PHX,76,2682,884,1965,687,197,459,95,133,84,113,2007
37,Mehmet Okur,UTA,80,2665,156,352,116,40,54,10,52,9,31,2007
38,Antawn Jamison,WAS,70,2662,136,313,95,41,48,10,37,6,35,2007
39,Chris Bosh,TOR,69,2658,175,390,135,40,72,16,47,16,24,2007
40,Jarrett Jack,POR,79,2651,417,920,331,86,156,54,121,50,36,2007
41,Josh Smith,ATL,72,2647,236,529,179,57,110,13,56,21,36,2007
42,Metta World Peace,SAC,70,2641,235,548,157,78,64,22,71,15,63,2007
43,Gerald Wallace,CHA,72,2641,185,410,145,40,76,24,45,12,28,2007
44,Monta Ellis,GSW,77,2638,319,769,188,131,125,13,50,55,76,2007
45,Leandro Barbosa,PHX,80,2613,317,756,195,122,103,30,62,56,66,2007
46,Larry Hughes,CLE,70,2596,256,564,204,52,103,35,66,23,29,2007
47,Chris Wilcox,SEA,82,2586,82,180,66,16,39,9,18,5,11,2007
48,Mike Dunleavy,IND,82,2581,228,504,180,48,100,35,45,27,21,2007
49,Desmond Mason,NOK,75,2575,115,264,81,34,34,12,35,9,25,2007
50,Al Harrington,GSW,78,2563,149,345,102,47,66,9,27,13,34,2007
51,Carlos Boozer,UTA,74,2557,221,468,195,26,110,19,66,7,19,2007
52,Mark Blount,MIN,82,2545,67,152,49,18,23,6,20,7,11,2007
53,Tracy McGrady,HOU,71,2539,458,1068,306,152,174,69,63,75,77,2007
54,Samuel Dalembert,PHI,82,2535,64,135,57,7,40,6,11,5,2,2007
55,Chauncey Billups,DET,70,2534,502,1100,406,96,160,71,175,35,61,2007
56,Tyson Chandler,NOK,73,2525,66,147,51,15,23,10,18,1,14,2007
57,Ruben Patterson,MIL,81,2508,232,520,176,56,109,28,39,13,43,2007
58,Tony Parker,SAS,77,2499,420,997,263,157,130,37,96,67,90,2007
59,Carmelo Anthony,DEN,65,2486,249,544,203,46,147,19,37,15,31,2007
60,Udonis Haslem,MIA,79,2483,97,217,74,23,49,9,16,7,16,2007
61,Stephen Jackson,GSW,75,2479,287,661,200,87,149,20,31,36,51,2007
62,Caron Butler,WAS,63,2474,233,526,173,60,95,20,58,15,45,2007
63,Mo Williams,MIL,68,2472,416,932,316,100,201,46,69,35,65,2007
64,Bruce Bowen,SAS,82,2464,117,271,80,37,33,12,35,15,22,2007
65,Jermaine O'Neal,IND,69,2459,167,381,120,47,72,12,36,17,30,2007
66,Smush Parker,LAL,82,2458,228,500,184,44,107,25,52,13,31,2007
67,Josh Howard,DAL,70,2456,127,286,95,32,37,11,47,13,19,2007
68,Anthony Parker,TOR,73,2437,153,344,115,38,46,20,49,17,21,2007
69,Zach Randolph,POR,68,2425,147,348,93,54,51,13,29,13,41,2007
70,DeShawn Stevenson,WAS,82,2419,218,500,154,64,86,9,59,13,51,2007
71,Rasheed Wallace,DET,75,2419,127,281,100,27,57,13,30,11,16,2007
72,Andris Biedrins,GSW,82,2382,88,199,65,23,33,5,27,7,16,2007
73,Nick Collison,SEA,82,2378,82,178,68,14,37,16,15,4,10,2007
74,Marcus Camby,DEN,70,2369,223,481,188,35,127,20,41,8,27,2007
75,Joe Johnson,ATL,57,2360,249,541,206,43,84,12,110,15,28,2007
76,Chris Paul,NOK,64,2353,569,1280,427,142,207,45,175,35,107,2007
77,Rashard Lewis,SEA,60,2348,145,327,108,37,55,23,30,11,26,2007
78,Jameer Nelson,ORL,77,2331,330,719,271,59,171,37,63,20,39,2007
79,Emeka Okafor,CHA,67,2329,80,187,53,27,18,8,27,8,19,2007
80,Adam Morrison,CHA,78,2326,163,355,134,29,75,19,40,13,16,2007
81,Al Jefferson,BOS,69,2319,88,197,67,21,33,4,30,3,18,2007
82,Corey Maggette,LAC,75,2291,208,451,173,35,48,56,69,18,17,2007
83,Kyle Korver,PHI,74,2288,105,223,92,13,48,18,26,4,9,2007
84,Derek Fisher,UTA,82,2287,274,580,242,32,144,23,75,6,26,2007
85,Ryan Gomes,BOS,73,2275,119,280,77,42,38,7,32,18,24,2007
86,Hedo Turkoglu,ORL,73,2268,233,489,210,23,140,43,27,11,12,2007
87,Boris Diaw,PHX,73,2267,352,829,227,125,122,29,76,45,80,2007
88,Andrew Bogut,MIL,66,2258,198,433,161,37,99,20,42,6,31,2007
89,T.J. Ford,TOR,75,2243,595,1336,449,146,195,64,190,68,78,2007
90,Jamaal Tinsley,IND,72,2243,494,1084,398,96,197,57,144,30,66,2007
91,Drew Gooden,CLE,80,2238,88,201,63,25,38,10,15,12,13,2007
92,Steve Blake,DEN,82,2224,408,906,318,90,197,28,93,26,64,2007
93,Rasual Butler,NOK,81,2223,63,143,46,17,24,10,12,12,5,2007
94,Trenton Hassell,MIN,76,2223,203,446,163,40,68,28,67,17,23,2007
95,Baron Davis,GSW,63,2221,509,1167,360,149,272,33,55,59,90,2007
96,Ray Allen,SEA,55,2219,228,506,178,50,107,31,40,14,36,2007
97,Delonte West,BOS,69,2219,304,664,248,56,107,53,88,18,38,2007
98,Luther Head,HOU,80,2210,194,443,139,55,67,32,40,17,38,2007
99,Lamar Odom,LAL,56,2202,270,622,188,82,97,36,55,24,58,2007
100,Jamal Crawford,NYK,59,2198,259,566,211,48,159,20,32,16,32,2007
101,Marvin Williams,ATL,64,2179,121,263,100,21,52,5,43,13,8,2007
102,Chris Kaman,LAC,75,2176,79,170,67,12,37,5,25,4,8,2007
103,Hakim Warrick,MEM,82,2152,75,177,48,27,28,8,12,4,23,2007
104,Earl Watson,SEA,77,2152,437,990,321,116,165,68,88,32,84,2007
105,Ime Udoka,POR,75,2144,112,250,86,26,46,15,25,11,15,2007
106,John Salmons,SAC,79,2134,254,578,184,70,91,29,64,21,49,2007
107,Pau Gasol,MEM,59,2133,201,478,125,76,74,18,33,14,62,2007
108,Zydrunas Ilgauskas,CLE,78,2130,123,290,79,44,48,9,22,9,35,2007
109,Juwan Howard,HOU,80,2123,131,321,72,59,43,8,21,19,40,2007
110,Rudy Gay,MEM,78,2103,100,221,79,21,52,7,20,3,18,2007
111,Luke Ridnour,SEA,71,2091,368,840,264,104,133,71,60,24,80,2007
112,Mikki Moore,NJN,79,2082,74,173,49,25,26,3,20,9,16,2007
113,Devin Harris,DAL,80,2081,296,674,214,82,93,22,99,36,46,2007
114,Mike James,MIN,82,2069,297,630,261,36,73,36,152,15,21,2007
115,Chucky Atkins,MEM,75,2064,346,762,276,70,148,34,94,16,54,2007
116,Manu Ginobili,SAS,75,2061,263,588,201,62,106,32,63,35,27,2007
117,Tim Thomas,LAC,76,2054,171,348,165,6,54,55,56,3,3,2007
118,Andrei Kirilenko,UTA,70,2049,202,427,179,23,116,18,45,3,20,2007
119,Damien Wilkins,SEA,82,2037,156,344,124,32,55,41,28,10,22,2007
120,Michael Redd,MIL,53,2036,124,279,93,31,53,9,31,11,20,2007
121,Earl Boykins,MIL,66,2031,291,672,201,90,100,34,67,21,69,2007
122,Zaza Pachulia,ATL,72,2026,106,230,88,18,50,7,31,6,12,2007
123,Josh Childress,ATL,55,2024,127,277,104,23,37,9,58,8,15,2007
124,Shareef Abdur-Rahim,SAC,80,2015,109,261,66,43,28,9,29,9,34,2007
125,Brandon Roy,POR,57,2015,230,530,160,70,66,25,69,33,37,2007
126,Grant Hill,ORL,65,2009,138,303,111,27,69,17,25,8,19,2007
127,Luke Walton,LAL,60,1982,257,567,204,53,128,36,40,16,37,2007
128,Matt Harpring,UTA,77,1965,99,215,82,17,42,14,26,2,15,2007
129,Richard Jefferson,NJN,55,1956,148,356,88,60,40,4,44,20,40,2007
130,Mickael Pietrus,GSW,72,1937,62,143,43,19,27,3,13,8,11,2007
131,Anderson Varejao,CLE,81,1932,75,166,59,16,45,4,10,7,9,2007
132,Dwyane Wade,MIA,51,1931,384,882,270,114,157,24,89,52,62,2007
133,Eric Snow,CLE,82,1929,330,726,264,66,121,53,90,29,37,2007
134,Juan Dixon,TOR,81,1926,123,275,94,29,46,23,25,12,17,2007
135,James Posey,MIA,71,1919,94,216,66,28,30,14,22,10,18,2007
136,Erick Dampier,DAL,76,1915,44,100,32,12,8,5,19,2,10,2007
137,Darko Milicic,ORL,80,1913,90,202,68,22,38,6,24,3,19,2007
138,Jorge Garbajosa,TOR,67,1909,125,276,99,26,51,14,34,14,12,2007
139,Chris Duhon,CHI,78,1905,310,673,257,53,104,23,130,16,37,2007
140,David West,NOK,52,1900,114,270,72,42,47,13,12,13,29,2007
141,Channing Frye,NYK,72,1896,67,161,40,27,30,2,8,6,21,2007
142,Randy Foye,MIN,82,1879,232,509,187,45,57,31,99,14,31,2007
143,Matt Carroll,CHA,72,1878,91,203,70,21,25,14,31,10,11,2007
144,Jason Williams,MIA,61,1865,322,710,256,66,128,34,94,18,48,2007
145,Troy Murphy,IND,68,1852,126,294,84,42,42,14,28,18,24,2007
146,Jason Collins,NJN,80,1844,46,96,42,4,22,4,16,2,2,2007
147,Willie Green,PHI,74,1842,112,240,96,16,51,12,33,6,10,2007
148,Rajon Rondo,BOS,78,1831,297,701,190,107,76,22,92,36,71,2007
149,Michael Finley,SAS,82,1823,108,256,68,40,23,22,23,19,21,2007
150,Chris Webber,DET,61,1821,188,404,160,28,95,21,44,11,17,2007
151,Antoine Walker,MIA,78,1818,130,285,105,25,68,20,17,9,16,2007
152,Matt Barnes,GSW,76,1812,156,365,103,53,69,2,32,21,32,2007
153,Andrew Bynum,LAL,82,1794,94,210,72,22,24,13,35,7,15,2007
154,Brad Miller,SAC,63,1783,224,490,182,42,112,19,51,9,33,2007
155,Gerald Green,BOS,81,1779,83,185,64,19,31,18,15,6,13,2007
156,Jason Kapono,MIA,67,1767,81,191,52,29,25,13,14,6,23,2007
157,Antonio Daniels,WAS,80,1761,290,667,203,87,94,28,81,25,62,2007
158,Martell Webster,POR,82,1759,52,118,38,14,20,6,12,8,6,2007
159,Brendan Haywood,WAS,77,1740,47,101,40,7,18,2,20,1,6,2007
160,Paul Pierce,BOS,47,1740,194,426,156,38,89,22,45,12,26,2007
161,Jeff Foster,IND,75,1740,57,122,49,8,14,3,32,2,6,2007
162,Maurice Evans,LAL,76,1732,74,177,45,29,21,6,18,8,21,2007
163,David Lee,NYK,58,1731,104,231,81,23,55,10,16,10,13,2007
164,Antonio McDyess,DET,82,1729,72,172,44,28,17,7,20,6,22,2007
165,Nene,DEN,64,1715,77,180,51,26,31,3,17,6,20,2007
166,Chuck Hayes,HOU,78,1714,47,119,22,25,11,4,7,7,18,2007
167,Jannero Pargo,NOK,82,1710,203,451,158,45,82,17,59,15,30,2007
168,Jamaal Magloire,POR,81,1703,30,71,19,11,8,3,8,6,5,2007
169,Quinton Ross,LAC,81,1700,86,189,69,17,20,20,29,6,11,2007
170,Rasho Nesterovic,TOR,80,1676,74,161,61,13,32,2,27,5,8,2007
171,Jason Richardson,GSW,51,1675,172,401,115,57,82,10,23,19,38,2007
172,Dahntay Jones,MEM,78,1671,68,152,52,16,27,8,17,3,13,2007
173,Devin Brown,NOK,58,1662,149,326,121,28,67,13,41,5,23,2007
174,Eduardo Najera,DEN,75,1658,64,143,49,15,21,5,23,3,12,2007
175,Brent Barry,SAS,75,1631,138,305,109,29,51,18,40,18,11,2007
176,Andrea Bargnani,TOR,65,1629,50,113,37,13,21,3,13,9,4,2007
177,Jarvis Hayes,WAS,81,1626,80,184,56,24,23,11,22,9,15,2007
178,Yao Ming,HOU,48,1624,94,227,55,39,51,2,2,7,32,2007
179,Quentin Richardson,NYK,49,1621,108,241,83,25,54,12,17,10,15,2007
180,Jerry Stackhouse,DAL,67,1615,187,438,123,64,52,16,55,28,36,2007
181,Jose Calderon,TOR,77,1613,387,893,268,119,112,22,134,43,76,2007
182,Shaun Livingston,LAC,54,1611,274,593,229,45,96,45,88,9,36,2007
183,Steven Hunter,PHI,70,1605,26,54,24,2,12,1,11,1,1,2007
184,Eddie Jones,MIA,64,1594,109,242,85,24,44,24,17,7,17,2007
185,Sebastian Telfair,BOS,78,1578,218,508,146,72,61,20,65,23,49,2007
186,Kendrick Perkins,BOS,72,1577,94,202,80,14,52,7,21,5,9,2007
187,Tony Battie,ORL,66,1575,35,76,29,6,21,2,6,2,4,2007
188,Alonzo Mourning,MIA,77,1572,18,43,11,7,8,1,2,2,5,2007
189,Marko Jaric,MIN,70,1555,145,310,125,20,54,34,37,8,12,2007
190,Craig Smith,MIN,82,1537,49,110,37,12,12,7,18,4,8,2007
191,Sasha Pavlovic,CLE,67,1534,105,227,88,17,43,16,29,7,10,2007
192,Travis Outlaw,POR,67,1532,52,118,38,14,23,5,10,11,3,2007
193,Bostjan Nachbar,NJN,76,1531,61,149,34,27,15,1,18,9,18,2007
194,Brian Skinner,MIL,67,1523,58,125,49,9,18,8,23,1,8,2007
195,Morris Peterson,TOR,71,1515,47,106,35,12,12,7,16,5,7,2007
196,Shelden Williams,ATL,81,1513,44,94,38,6,18,2,18,1,5,2007
197,Johan Petro,SEA,81,1510,45,101,34,11,19,5,10,5,6,2007
198,Joe Smith,PHI,65,1503,49,107,40,9,16,7,17,1,8,2007
199,Gary Payton,MIA,68,1503,201,458,145,56,54,22,69,20,36,2007
200,Damon Stoudamire,MEM,62,1501,299,675,222,77,120,23,79,13,64,2007
201,Tyronn Lue,ATL,56,1488,201,440,163,38,84,17,62,11,27,2007
202,Linas Kleiza,DEN,79,1488,45,105,30,15,19,2,9,5,10,2007
203,DeSagana Diop,DAL,81,1480,30,69,21,9,11,1,9,3,6,2007
204,Flip Murray,DET,69,1477,187,417,144,43,59,24,61,23,20,2007
205,Paul Millsap,UTA,82,1472,62,128,58,4,27,4,27,1,3,2007
206,JR Smith,DEN,63,1471,91,195,78,13,53,7,18,3,10,2007
207,P.J. Brown,CHI,72,1456,48,105,39,9,17,6,16,3,6,2007
208,Keyon Dooling,ORL,66,1435,112,256,80,32,50,9,21,12,20,2007
209,Kenny Thomas,SAC,62,1412,76,173,55,21,28,2,25,3,18,2007
210,Francisco Garcia,SAC,79,1409,87,197,64,23,34,11,19,5,18,2007
211,Sam Cassell,LAC,58,1408,270,577,233,37,86,60,87,4,33,2007
212,Andres Nocioni,CHI,53,1406,57,127,44,13,23,6,15,3,10,2007
213,LaMarcus Aldridge,POR,63,1392,24,59,13,11,5,2,6,5,6,2007
214,James Jones,PHX,76,1376,45,112,23,22,5,3,15,10,12,2007
215,Carlos Delfino,DET,82,1372,88,197,67,21,37,7,23,9,12,2007
216,Greg Buckner,DAL,76,1372,70,173,37,33,13,5,19,14,19,2007
217,Fabricio Oberto,SAS,79,1365,68,153,51,17,33,7,11,2,15,2007
218,Donyell Marshall,CLE,81,1360,46,102,36,10,23,3,10,3,7,2007
219,Nate Robinson,NYK,64,1356,90,194,76,14,53,7,16,4,10,2007
220,Corliss Williamson,SAC,68,1337,39,88,29,10,14,4,11,4,6,2007
221,Francisco Elson,SAS,70,1333,55,130,35,20,15,6,14,6,14,2007
222,Bobby Jackson,NOK,56,1330,141,312,111,30,60,9,42,9,21,2007
223,Fred Jones,POR,63,1319,108,240,84,24,33,9,42,8,16,2007
224,Joey Graham,TOR,79,1319,44,114,18,26,7,2,9,15,11,2007
225,Marcus Williams,NJN,79,1314,260,587,193,67,135,16,42,23,44,2007
226,Jared Jeffries,NYK,55,1307,67,154,47,20,30,5,12,8,12,2007
227,Carlos Arroyo,ORL,72,1304,202,453,153,49,93,18,42,18,31,2007
228,Anthony Johnson,ATL,67,1300,201,449,154,47,62,11,81,15,32,2007
229,Dorell Wright,MIA,66,1292,95,209,76,19,50,8,18,4,15,2007
230,Dikembe Mutombo,HOU,75,1289,13,37,2,11,2,0,0,2,9,2007
231,Devean George,DAL,60,1283,33,75,24,9,13,3,8,0,9,2007
232,Trevor Ariza,ORL,57,1278,65,141,54,11,36,9,9,3,8,2007
233,Darrell Armstrong,IND,81,1275,191,442,131,60,45,21,65,24,36,2007
234,Brevin Knight,CHA,45,1273,296,664,224,72,102,35,87,30,42,2007
235,Etan Thomas,WAS,65,1246,29,64,23,6,10,3,10,0,6,2007
236,Mickael Gelabale,SEA,70,1239,56,125,43,13,21,6,16,5,8,2007
237,Steve Francis,NYK,44,1237,170,391,119,51,81,10,28,14,37,2007
238,Kurt Thomas,PHX,67,1208,24,60,12,12,9,1,2,6,6,2007
239,Derek Anderson,CHA,50,1190,133,299,100,33,53,14,33,15,18,2007
240,Gordan Giricek,UTA,61,1188,63,136,53,10,28,4,21,1,9,2007
241,Yakhouba Diawara,DEN,64,1176,55,136,29,26,18,0,11,7,19,2007
242,Damon Jones,CLE,60,1173,94,209,73,21,36,10,27,9,12,2007
243,Rodney Carney,PHI,67,1169,26,57,21,5,12,2,7,1,4,2007
244,Antoine Wright,NJN,63,1137,55,125,40,15,24,5,11,4,11,2007
245,Shaquille O'Neal,MIA,40,1135,79,188,49,30,40,4,5,3,27,2007
246,Kwame Brown,LAL,41,1132,75,163,62,13,34,9,19,1,12,2007
247,Reggie Evans,DEN,66,1127,45,105,30,15,20,3,7,6,9,2007
248,Robert Horry,SAS,68,1124,77,180,51,26,34,7,10,12,14,2007
249,Jordan Farmar,LAL,72,1090,137,323,88,49,42,15,31,13,36,2007
250,Ronny Turiaf,LAL,72,1087,63,149,40,23,23,3,14,6,17,2007
251,Renaldo Balkman,NYK,67,1064,44,106,26,18,20,2,4,3,15,2007
252,Speedy Claxton,ATL,42,1054,185,399,156,29,82,11,63,8,21,2007
253,Jake Voskuhl,CHA,73,1043,44,98,34,10,21,3,10,5,5,2007
254,Lorenzen Wright,ATL,67,1035,40,90,30,10,16,1,13,2,8,2007
255,Salim Stoudamire,ATL,61,1034,61,132,51,10,30,4,17,2,8,2007
256,Stromile Swift,MEM,54,1029,17,39,12,5,7,2,3,1,4,2007
257,Brian Scalabrine,BOS,54,1027,59,134,43,16,21,8,14,4,12,2007
258,Marc Jackson,NOK,56,1025,58,134,40,18,20,7,13,3,15,2007
259,Brian Cook,LAL,65,1018,65,148,47,18,28,10,9,4,14,2007
260,Keith Bogans,ORL,59,990,59,124,53,6,28,14,11,3,3,2007
261,Daniel Gibson,CLE,60,987,69,163,44,25,23,6,15,9,16,2007
262,Vladimir Radmanovic,LAL,55,986,66,142,56,10,37,10,9,2,8,2007
263,Charlie Villanueva,MIL,39,984,36,80,28,8,20,3,5,0,8,2007
264,Ersan Ilyasova,MIL,66,973,49,109,38,11,24,4,10,3,8,2007
265,Sarunas Jasikevicius,GSW,63,972,172,393,123,49,74,19,30,18,31,2007
266,Lawrence Roberts,MEM,54,969,30,70,20,10,14,2,4,2,8,2007
267,Tarence Kinsey,MEM,48,967,41,92,31,10,14,5,12,3,7,2007
268,Tyrus Thomas,CHI,72,966,40,87,33,7,17,7,9,4,3,2007
269,Clifford Robinson,NJN,50,955,51,122,31,20,13,5,13,7,13,2007
270,Beno Udrih,SAS,73,948,122,286,80,42,34,17,29,19,23,2007
271,Eddie House,NJN,56,945,67,149,52,15,34,6,12,5,10,2007
272,Jason Maxiell,DET,67,943,14,30,12,2,5,2,5,0,2,2007
273,Walter Herrmann,CHA,48,935,26,57,21,5,6,5,10,1,4,2007
274,Sasha Vujacic,LAL,73,934,64,147,45,19,23,7,15,7,12,2007
275,Kevin Ollie,PHI,53,919,130,285,105,25,37,16,52,9,16,2007
276,Jarron Collins,UTA,82,913,60,128,52,8,19,5,28,1,7,2007
277,Wally Szczerbiak,BOS,32,900,55,126,39,16,17,4,18,6,10,2007
278,Thabo Sefolosha,CHI,71,868,60,133,47,13,18,4,25,2,11,2007
279,Sergio Rodriguez,POR,67,862,218,485,169,49,71,18,80,24,25,2007
280,Nenad Krstic,NJN,26,849,46,110,28,18,12,3,13,5,13,2007
281,Jason Hart,LAC,36,845,103,232,77,26,29,16,32,5,21,2007
282,Dan Gadzuric,MIL,54,840,29,61,26,3,13,5,8,1,2,2007
283,Primoz Brezec,CHA,58,838,23,54,15,8,9,0,6,2,6,2007
284,Sean May,CHA,35,838,66,154,44,22,18,5,21,3,19,2007
285,Malik Rose,NYK,65,810,65,140,55,10,44,6,5,7,3,2007
286,Tony Allen,BOS,33,805,56,132,36,20,20,6,10,7,13,2007
287,Marquis Daniels,IND,45,800,57,134,37,20,15,4,18,6,14,2007
288,David Noel,MIL,68,791,65,149,46,19,26,3,17,7,12,2007
289,Mardy Collins,NYK,52,777,83,192,57,26,23,9,25,9,17,2007
290,Nazr Mohammed,DET,51,773,9,20,7,2,6,0,1,1,1,2007
291,Jacque Vaughn,SAS,64,760,131,302,91,40,45,10,36,14,26,2007
292,Ike Diogu,IND,59,760,25,58,17,8,6,2,9,3,5,2007
293,Alexander Johnson,MEM,59,753,17,37,14,3,10,3,1,2,1,2007
294,Lindsey Hunter,DET,52,744,93,196,83,10,30,8,45,7,3,2007
295,Austin Croshere,DAL,61,727,44,99,33,11,15,3,15,3,8,2007
296,Linton Johnson,NOK,54,720,18,44,10,8,8,1,1,2,6,2007
297,Leon Powe,BOS,62,720,10,23,7,3,1,0,6,1,2,2007
298,Keith McLeod,IND,48,718,90,204,66,24,36,9,21,12,12,2007
299,Daniel Ewing,LAC,61,712,90,208,62,28,19,15,28,3,25,2007
300,Allan Ray,BOS,47,709,43,99,30,13,20,3,7,6,7,2007
301,Jeff McInnis,CHA,38,702,124,273,99,25,49,9,41,11,14,2007
302,Joel Przybilla,POR,43,701,12,26,10,2,5,2,3,0,2,2007
303,Darius Songaila,WAS,37,700,38,86,28,10,19,3,6,2,8,2007
304,Michael Doleac,MIA,56,698,22,53,13,9,7,2,4,2,7,2007
305,Lou Williams,PHI,61,688,110,234,96,14,50,11,35,3,11,2007
306,Andray Blatche,WAS,56,682,39,92,25,14,11,4,10,5,9,2007
307,Ronnie Brewer,UTA,56,675,24,51,21,3,7,2,12,0,3,2007
308,Kris Humphries,TOR,60,670,18,39,15,3,5,1,9,1,2,2007
309,Kelenna Azubuike,GSW,41,669,28,63,21,7,12,3,6,3,4,2007
310,Josh Boone,NJN,61,669,10,22,8,2,2,0,6,1,1,2007
311,Solomon Jones,ATL,58,666,11,24,9,2,5,0,4,1,1,2007
312,Matt Bonner,SAS,56,653,22,52,14,8,6,1,7,4,4,2007
313,Malik Allen,CHI,60,638,16,41,7,9,4,0,3,2,7,2007
314,Hilton Armstrong,NOK,56,634,10,23,7,3,3,0,4,2,1,2007
315,JJ Redick,ORL,42,622,36,78,30,6,19,5,6,1,5,2007
316,Bonzi Wells,HOU,28,590,31,73,20,11,15,3,2,2,9,2007
317,Adrian Griffin,CHI,54,585,59,138,39,20,21,3,15,8,12,2007
318,Ronnie Price,SAC,58,563,48,106,38,10,26,2,10,2,8,2007
319,Kirk Snyder,HOU,39,562,39,86,31,8,13,12,6,4,4,2007
320,Shawne Williams,IND,46,556,22,49,17,5,5,3,9,1,4,2007
321,Rashad McCants,MIN,37,554,38,87,27,11,18,3,6,5,6,2007
322,Troy Hudson,MIN,34,554,73,158,61,12,21,13,27,3,9,2007
323,Junior Harrington,MEM,29,543,89,193,74,15,38,10,26,3,12,2007
324,Royal Ivey,ATL,53,538,45,95,40,5,17,8,15,2,3,2007
325,Cedric Simmons,NOK,43,534,12,26,10,2,8,0,2,0,2,2007
326,Mike Wilks,SEA,47,534,79,189,48,31,18,12,18,8,23,2007
327,Marcus Banks,PHX,45,503,60,135,45,15,16,7,22,4,11,2007
328,Hassan Adams,NJN,60,495,13,31,8,5,6,0,2,0,5,2007
329,Roger Mason Jr.,WAS,62,492,35,81,24,11,12,3,9,3,8,2007
330,Adonal Foyle,GSW,48,475,19,41,16,3,11,1,4,1,2,2007
331,Mark Madsen,MIN,56,473,10,24,6,4,1,1,4,1,3,2007
332,Dale Davis,DET,46,464,12,27,9,3,3,1,5,1,2,2007
333,Bo Outlaw,ORL,41,460,16,37,11,5,6,0,5,0,5,2007
334,Dee Brown,UTA,49,449,83,175,74,9,33,7,34,1,8,2007
335,Dan Dickau,POR,50,444,70,150,60,10,25,8,27,6,4,2007
336,Lynn Greer,MIL,41,432,53,128,31,22,17,3,11,8,14,2007
337,Peja Stojakovic,NOK,13,425,11,23,10,1,7,1,2,0,1,2007
338,DerMarr Johnson,DEN,39,419,17,42,9,8,6,1,2,2,6,2007
339,Alan Henderson,PHI,38,418,10,23,7,3,2,0,5,0,3,2007
340,Chris Quinn,MIA,42,408,65,151,44,21,15,6,23,10,11,2007
341,Maceo Baston,IND,47,404,16,34,14,2,8,2,4,1,1,2007
342,Jake Tsakalidis,HOU,36,389,5,12,3,2,2,0,1,0,2,2007
343,Michael Sweetney,CHI,48,385,28,61,23,5,12,3,8,1,4,2007
344,John Lucas III,HOU,47,383,33,82,17,16,4,3,10,8,8,2007
345,Calvin Booth,WAS,44,380,18,38,16,2,12,1,3,0,2,2007
346,James Singleton,LAC,53,376,17,42,9,8,4,3,2,2,6,2007
347,Aaron Williams,LAC,38,374,7,15,6,1,3,0,3,0,1,2007
348,CJ Miles,UTA,37,372,25,51,24,1,13,3,8,1,0,2007
349,Donell Taylor,WAS,47,369,45,105,30,15,16,3,11,7,8,2007
350,Rawle Marshall,IND,40,361,13,32,7,6,3,1,3,2,4,2007
351,Quincy Douby,SAC,42,359,15,33,12,3,11,0,1,1,2,2007
352,Josh Powell,GSW,37,353,21,48,15,6,7,2,6,4,2,2007
353,David Wesley,CLE,35,352,37,87,24,13,13,1,10,4,9,2007
354,Raef LaFrentz,POR,27,352,8,19,5,3,1,1,3,1,2,2007
355,Shammond Williams,LAL,30,345,31,67,26,5,12,8,6,1,4,2007
356,Bobby Jones,PHI,44,335,16,41,7,9,4,1,2,3,6,2007
357,Justin Williams,SAC,26,333,2,5,1,1,0,0,1,0,1,2007
358,Justin Reed,MIN,41,318,17,39,12,5,2,2,8,1,4,2007
359,Brian Cardinal,MEM,28,313,31,67,26,5,19,2,5,3,2,2007
360,Melvin Ely,SAS,30,309,18,40,14,4,4,4,6,3,1,2007
361,Travis Diener,ORL,26,288,35,83,22,13,5,3,14,5,8,2007
362,Bernard Robinson,NJN,31,278,19,40,17,2,8,4,5,1,1,2007
363,Pat Garrity,ORL,33,277,14,33,9,5,6,2,1,2,3,2007
364,Jerome James,NYK,41,273,3,6,3,0,3,0,0,0,0,2007
365,Vassilis Spanoulis,HOU,31,272,28,66,18,10,10,7,1,3,7,2007
366,Andre Brown,SEA,38,271,2,4,2,0,0,2,0,0,0,2007
367,Michael Ruffin,WAS,30,270,6,13,5,1,3,1,1,0,1,2007
368,Alan Anderson,CHA,17,256,21,47,16,5,5,4,7,1,4,2007
369,Orien Greene,IND,41,254,22,47,19,3,8,3,8,0,3,2007
370,Rafael Araujo,UTA,28,247,10,21,9,1,5,1,3,0,1,2007
371,Jalen Rose,PHX,29,246,16,36,12,4,8,2,2,2,2,2007
372,Jared Reiner,MIL,27,243,13,30,9,4,3,2,4,3,1,2007
373,Michael Olowokandi,BOS,24,234,5,11,4,1,1,0,3,0,1,2007
374,Viktor Khryapa,CHI,33,231,21,49,14,7,9,2,3,3,4,2007
375,Scott Padgett,MEM,31,231,8,20,4,4,3,0,1,2,2,2007
376,Anthony Roberson,GSW,20,227,10,22,8,2,5,0,3,0,2,2007
377,Othella Harrington,CHA,26,220,6,12,6,0,4,1,1,0,0,2007
378,Darrick Martin,TOR,31,220,43,99,30,13,11,4,15,4,9,2007
379,Maurice Ager,DAL,32,214,7,15,6,1,2,2,2,0,1,2007
380,Earl Barron,MIA,28,203,5,13,2,3,1,1,0,2,1,2007
381,Shannon Brown,CLE,23,201,10,24,6,4,4,0,2,0,4,2007
382,Cedric Bozeman,ATL,23,199,9,18,9,0,6,2,1,0,0,2007
383,J.J. Barea,DAL,33,191,24,57,15,9,8,3,4,4,5,2007
384,Steve Novak,HOU,35,191,6,16,2,4,1,1,0,2,2,2007
385,Bracey Wright,MIN,19,190,15,34,11,4,8,2,1,1,3,2007
386,David Harrison,IND,24,190,6,14,4,2,2,1,1,0,2,2007
387,Ryan Hollins,CHA,27,185,1,2,1,0,0,0,1,0,0,2007
388,Paul Davis,LAC,31,180,7,17,4,3,1,1,2,1,2,2007
389,Shavlik Randolph,PHI,13,179,4,9,3,1,1,1,1,0,1,2007
390,Kyle Lowry,MEM,10,175,32,77,19,13,11,2,6,3,10,2007
391,Damir Markota,MIL,30,170,6,14,4,2,4,0,0,1,1,2007
392,Mouhamed Sene,SEA,28,169,0,0,0,0,0,0,0,0,0,2007
393,Will Blalock,DET,14,166,17,37,14,3,6,4,4,0,3,2007
394,Stephen Graham,POR,14,165,5,11,4,1,1,1,2,1,0,2007
395,Pat Burke,PHX,23,164,5,13,2,3,2,0,0,1,2,2007
396,Brandon Bass,NOK,21,162,3,8,1,2,1,0,0,0,2,2007
397,Danny Fortson,SEA,14,158,1,3,0,1,0,0,0,0,1,2007
398,Matt Freije,ATL,19,147,7,19,2,5,1,0,1,3,2,2007
399,Jumaine Jones,PHX,18,138,1,3,0,1,0,0,0,1,0,2007
400,Luke Jackson,TOR,13,138,13,28,11,2,6,0,5,1,1,2007
401,James White,SAS,6,137,5,12,3,2,1,1,1,0,2,2007
402,Robert Hite,MIA,12,136,8,20,4,4,2,0,2,0,4,2007
403,Aaron McKie,LAL,10,131,13,30,9,4,6,0,3,0,4,2007
404,Ira Newble,CLE,15,129,2,4,2,0,0,2,0,0,0,2007
405,Jamal Sampson,DEN,22,124,5,10,5,0,2,1,2,0,0,2007
406,Amir Johnson,DET,8,124,3,8,1,2,0,0,1,0,2,2007
407,Eric Williams,CHA,21,121,7,15,6,1,5,1,0,1,0,2007
408,Patrick O'Bryant,GSW,16,119,9,18,9,0,3,2,4,0,0,2007
409,Luke Schenscher,POR,11,118,1,2,1,0,0,1,0,0,0,2007
410,Scot Pollard,CLE,24,109,3,6,3,0,0,0,3,0,0,2007
411,Marcus Vinicius,NOK,13,103,5,12,3,2,1,1,1,0,2,2007
412,Maurice Taylor,SAC,12,103,5,11,4,1,4,0,0,0,1,2007
413,Jackie Butler,SAS,11,103,5,10,5,0,3,0,2,0,0,2007
414,Kevinn Pinkney,BOS,6,100,5,10,5,0,4,0,1,0,0,2007
415,Kelvin Cato,NYK,18,95,0,0,0,0,0,0,0,0,0,2007
416,Ronald Dupree,DET,19,94,5,10,5,0,4,0,1,0,0,2007
417,Wayne Simien,MIA,8,93,4,10,2,2,0,0,2,0,2,2007
418,Eddie Griffin,MIN,13,92,4,8,4,0,1,2,1,0,0,2007
419,Lou Amundson,PHI,11,89,1,2,1,0,1,0,0,0,0,2007
420,PJ Tucker,TOR,17,83,3,9,0,3,0,0,0,1,2,2007
421,Doug Christie,LAC,7,82,8,19,5,3,3,1,1,0,3,2007
422,Esteban Batista,ATL,13,81,4,8,4,0,2,0,2,0,0,2007
423,Slava Medvedenko,ATL,14,81,2,4,2,0,0,0,2,0,0,2007
424,Andreas Glyniadakis,SEA,13,81,1,2,1,0,1,0,0,0,0,2007
425,DJ Mbenga,DAL,21,79,6,14,4,2,1,0,3,0,2,2007
426,Eric Piatkowski,PHX,11,73,4,10,2,2,1,1,0,2,0,2007
427,Uros Slokar,TOR,20,72,1,2,1,0,1,0,0,0,0,2007
428,Pops Mensah-Bonsu,DAL,12,71,0,0,0,0,0,0,0,0,0,2007
429,Julius Hodge,MIL,9,64,12,26,10,2,7,1,2,0,2,2007
430,Kenyon Martin,DEN,2,63,1,2,1,0,0,0,1,0,0,2007
431,James Lang,WAS,11,55,2,4,2,0,2,0,0,0,0,2007
432,Will Conroy,LAC,7,51,9,20,7,2,3,3,1,1,1,2007
433,Dijon Thompson,ATL,6,50,2,5,1,1,0,0,1,1,0,2007
434,Theo Ratliff,BOS,2,44,0,0,0,0,0,0,0,0,0,2007
435,Randolph Morris,NYK,5,44,1,2,1,0,0,1,0,0,0,2007
436,Kevin Willis,DAL,5,43,1,2,1,0,0,0,1,0,0,2007
437,Ivan McFarlin,PHI,11,41,1,3,0,1,0,0,0,0,1,2007
438,Yaroslav Korolev,LAC,10,41,4,9,3,1,0,0,3,0,1,2007
439,Anthony Carter,DEN,2,37,11,29,4,7,4,0,0,0,7,2007
440,Pape Sow,TOR,7,34,2,4,2,0,0,0,2,0,0,2007
441,Desmon Farmer,SEA,8,32,9,19,8,1,6,1,1,1,0,2007
442,Andre Barrett,CHI,6,29,7,14,7,0,2,0,5,0,0,2007
443,Steven Smith,PHI,8,28,0,0,0,0,0,0,0,0,0,2007
444,Renaldo Major,GSW,1,27,0,0,0,0,0,0,0,0,0,2007
445,Randy Livingston,SEA,4,26,4,8,4,0,1,2,1,0,0,2007
446,Jeremy Richardson,POR,6,20,0,0,0,0,0,0,0,0,0,2007
447,Dwayne Jones,CLE,4,18,0,0,0,0,0,0,0,0,0,2007
448,Sean Marks,PHX,3,17,0,0,0,0,0,0,0,0,0,2007
449,Roger Powell,UTA,3,13,0,0,0,0,0,0,0,0,0,2007
450,Vitaly Potapenko,SAC,3,13,0,0,0,0,0,0,0,0,0,2007
451,Mike Hall,WAS,2,13,1,2,1,0,0,0,1,0,0,2007
452,Chris McCray,MIL,5,12,0,0,0,0,0,0,0,0,0,2007
453,Alvin Williams,LAC,2,10,3,6,3,0,2,0,1,0,0,2007
454,James Augustine,ORL,2,7,2,5,1,1,1,0,0,0,1,2007
455,Dajuan Wagner,GSW,1,7,1,2,1,0,1,0,0,0,0,2007
456,Mile Ilic,NJN,5,6,0,0,0,0,0,0,0,0,0,2007
457,Von Wafer,LAC,1,1,0,0,0,0,0,0,0,0,0,2007
0,Gilbert Arenas,WAS,80,3384,484,1071,381,103,192,67,122,26,77,2006
1,LeBron James,CLE,79,3361,521,1190,373,148,220,41,112,87,61,2006
2,Joe Johnson,ATL,82,3340,536,1181,427,109,202,42,183,36,73,2006
3,Antawn Jamison,WAS,82,3289,158,360,114,44,58,19,37,9,35,2006
4,Kobe Bryant,LAL,80,3277,360,834,246,114,144,42,60,32,82,2006
5,Shawn Marion,PHX,81,3263,143,348,81,62,37,7,37,24,38,2006
6,Lamar Odom,LAL,80,3221,443,1003,326,117,148,55,123,27,90,2006
7,Ricky Davis,MIN,78,3207,394,860,322,72,131,50,141,27,45,2006
8,Mike Bibby,SAC,82,3167,444,956,376,68,204,27,145,22,46,2006
9,Morris Peterson,TOR,82,3140,190,419,151,39,63,18,70,19,20,2006
10,Pau Gasol,MEM,80,3135,371,916,197,174,126,19,52,47,127,2006
11,Michael Redd,MIL,80,3130,229,507,180,49,103,17,60,14,35,2006
12,Allen Iverson,PHI,72,3103,532,1169,427,105,214,52,161,38,67,2006
13,Elton Brand,LAC,79,3099,208,459,165,43,56,48,61,8,35,2006
14,Dirk Nowitzki,DAL,81,3089,226,502,176,50,91,37,48,12,38,2006
15,Andre Iguodala,PHI,82,3086,255,554,211,44,125,28,58,14,30,2006
16,Paul Pierce,BOS,79,3085,375,846,279,96,159,31,89,33,63,2006
17,Richard Jefferson,NJN,78,3059,297,666,225,72,76,26,123,29,43,2006
18,Ray Allen,SEA,78,3022,286,635,223,63,122,50,51,22,41,2006
19,Dwight Howard,ORL,82,3021,125,275,100,25,57,10,33,6,19,2006
20,Cuttino Mobley,LAC,79,2979,238,503,211,27,69,71,71,10,17,2006
21,Jason Kidd,NJN,80,2976,672,1444,572,100,282,77,213,30,70,2006
22,Raja Bell,PHX,79,2959,207,490,131,76,44,15,72,17,59,2006
23,Kevin Garnett,MIN,76,2958,308,653,271,37,143,29,99,10,27,2006
24,Kirk Hinrich,CHI,81,2955,514,1150,392,122,151,62,179,50,72,2006
25,Mehmet Okur,UTA,82,2945,194,416,166,28,76,11,79,4,24,2006
26,Carmelo Anthony,DEN,80,2941,216,475,173,43,97,19,57,16,27,2006
27,Andre Miller,DEN,82,2937,674,1448,574,100,379,32,163,37,63,2006
28,Chauncey Billups,DET,81,2925,699,1552,545,154,213,92,240,51,103,2006
29,Mike James,TOR,79,2925,460,1060,320,140,120,48,152,60,80,2006
30,Brad Miller,SAC,79,2923,374,854,268,106,140,32,96,28,78,2006
31,Stephen Jackson,IND,81,2910,225,506,169,56,103,25,41,25,31,2006
32,Vince Carter,NJN,79,2906,338,757,257,81,111,37,109,26,55,2006
33,Tayshaun Prince,DET,82,2898,186,432,126,60,55,18,53,16,44,2006
34,Chris Webber,PHI,75,2893,256,556,212,44,124,36,52,10,34,2006
35,Dwyane Wade,MIA,75,2893,503,1167,342,161,207,39,96,76,85,2006
36,Ben Wallace,DET,82,2890,158,349,125,33,65,19,41,17,16,2006
37,Jason Richardson,GSW,75,2877,232,539,157,75,79,22,56,28,47,2006
38,Rashard Lewis,SEA,78,2876,182,420,126,56,46,26,54,17,39,2006
39,Boris Diaw,PHX,81,2874,503,1172,337,166,162,30,145,58,108,2006
40,Shane Battier,MEM,81,2839,136,318,90,46,52,12,26,17,29,2006
41,Richard Hamilton,DET,80,2825,275,602,223,52,121,23,79,18,34,2006
42,Chris Paul,NOK,78,2809,611,1323,510,101,209,50,251,30,71,2006
43,Jason Terry,DAL,80,2798,306,667,251,55,84,44,123,11,44,2006
44,Steve Nash,PHX,79,2796,826,1874,604,222,286,88,230,91,131,2006
45,Tim Duncan,SAS,80,2784,253,571,188,65,107,28,53,21,44,2006
46,Al Harrington,ATL,76,2782,238,531,183,55,95,17,71,22,33,2006
47,Rasheed Wallace,DET,80,2780,182,403,143,39,73,29,41,20,19,2006
48,Smush Parker,LAL,82,2774,302,685,221,81,114,30,77,18,63,2006
49,Bruce Bowen,SAS,82,2755,126,285,93,33,35,30,28,13,20,2006
50,Chris Bosh,TOR,70,2751,181,428,115,66,62,19,34,23,43,2006
51,Wally Szczerbiak,BOS,72,2729,213,482,157,56,68,30,59,22,34,2006
52,Tony Parker,SAS,80,2715,460,1065,315,145,145,56,114,91,54,2006
53,Caron Butler,WAS,75,2708,186,413,145,41,88,19,38,9,32,2006
54,Sam Cassell,LAC,78,2653,491,1045,428,63,145,103,180,15,48,2006
55,DeShawn Stevenson,ORL,82,2648,160,349,131,29,67,18,46,10,19,2006
56,Luke Ridnour,SEA,79,2625,550,1276,374,176,185,73,116,46,130,2006
57,Hedo Turkoglu,ORL,78,2615,216,456,192,24,84,28,80,8,16,2006
58,Andrei Kirilenko,UTA,69,2604,299,628,269,30,154,29,86,3,27,2006
59,Luol Deng,CHI,78,2604,147,355,86,61,33,9,44,25,36,2006
60,Peja Stojakovic,IND,71,2601,136,308,100,36,48,11,41,14,22,2006
61,Derek Fisher,GSW,82,2589,352,790,266,86,170,24,72,37,49,2006
62,Mike Dunleavy,GSW,81,2577,237,553,158,79,76,29,53,24,55,2006
63,Kyle Korver,PHI,82,2563,163,350,139,24,69,29,41,8,16,2006
64,Chris Kaman,LAC,78,2561,79,172,65,14,32,11,22,4,10,2006
65,Josh Smith,ATL,80,2559,191,428,145,46,108,11,26,26,20,2006
66,T.J. Ford,MIL,72,2557,473,1091,328,145,174,40,114,49,96,2006
67,Jamal Crawford,NYK,79,2555,301,643,260,41,151,29,80,17,24,2006
68,Zach Randolph,POR,74,2545,144,341,91,53,50,10,31,3,50,2006
69,Bobby Simmons,MIL,75,2538,172,381,135,37,77,20,38,14,23,2006
70,Juwan Howard,HOU,80,2537,112,263,73,39,40,18,15,10,29,2006
71,David West,NOK,74,2526,92,205,71,21,29,7,35,8,13,2006
72,Troy Murphy,GSW,74,2516,101,243,60,41,39,2,19,14,27,2006
73,Trenton Hassell,MIN,77,2514,203,440,169,34,76,25,68,9,25,2006
74,Udonis Haslem,MIA,81,2491,95,215,70,25,49,12,9,8,17,2006
75,Ben Gordon,CHI,80,2482,240,532,188,52,84,31,73,14,38,2006
76,Nenad Krstic,NJN,80,2470,88,208,56,32,22,6,28,9,23,2006
77,Jamaal Magloire,MIL,82,2465,56,125,43,13,23,7,13,4,9,2006
78,Zaza Pachulia,ATL,78,2452,129,279,108,21,70,8,30,6,15,2006
79,Eddie Jones,MEM,75,2437,177,395,136,41,63,32,41,14,27,2006
80,Rafer Alston,HOU,63,2431,425,932,343,82,123,66,154,34,48,2006
81,Delonte West,BOS,71,2418,329,726,261,68,129,35,97,23,45,2006
82,Raymond Felton,CHA,80,2406,446,980,358,88,133,52,173,49,39,2006
83,Steve Francis,NYK,70,2394,345,754,281,64,159,42,80,19,45,2006
84,P.J. Brown,NOK,75,2380,90,190,80,10,29,15,36,2,8,2006
85,David Wesley,HOU,71,2372,204,460,152,52,58,45,49,18,34,2006
86,Charlie Villanueva,TOR,81,2361,88,202,62,26,31,3,28,14,12,2006
87,Eric Snow,CLE,82,2351,346,768,270,76,153,38,79,32,44,2006
88,Brevin Knight,CHA,69,2351,610,1344,486,124,220,63,203,34,90,2006
89,Andrew Bogut,MIL,82,2348,192,433,143,49,69,24,50,21,28,2006
90,Luther Head,HOU,80,2310,215,485,160,55,71,39,50,16,39,2006
91,Deron Williams,UTA,80,2307,359,777,300,59,142,22,136,7,52,2006
92,Gary Payton,MIA,81,2305,257,588,183,74,88,32,63,24,50,2006
93,Kenny Thomas,SAC,82,2293,168,377,127,41,65,10,52,9,32,2006
94,Zydrunas Ilgauskas,CLE,78,2283,91,206,67,24,44,4,19,6,18,2006
95,Antonio Daniels,WAS,79,2283,284,653,199,85,95,26,78,24,61,2006
96,Mike Miller,MEM,74,2268,200,454,146,54,88,22,36,22,32,2006
97,Josh Childress,ATL,74,2249,131,299,94,37,39,10,45,13,24,2006
98,Mark Blount,MIN,81,2240,99,209,88,11,48,5,35,1,10,2006
99,Andres Nocioni,CHI,82,2239,117,274,77,40,31,14,32,13,27,2006
100,Tony Battie,ORL,82,2215,49,109,38,11,20,2,16,0,11,2006
101,Metta World Peace,SAC,56,2207,203,478,131,72,60,23,48,21,51,2006
102,Antoine Walker,MIA,82,2199,166,361,137,29,99,17,21,14,15,2006
103,Stephon Marbury,NYK,60,2194,382,832,314,68,146,40,128,36,32,2006
104,Drew Gooden,CLE,79,2174,56,121,47,9,26,4,17,2,7,2006
105,Primoz Brezec,CHA,79,2166,45,104,31,14,9,6,16,7,7,2006
106,Chris Duhon,CHI,74,2154,373,821,298,75,112,50,136,32,43,2006
107,Tyson Chandler,CHI,79,2121,81,178,65,16,37,8,20,1,15,2006
108,Flip Murray,CLE,76,2112,197,447,144,53,72,30,42,17,36,2006
109,Desmond Mason,NOK,70,2102,66,137,61,5,29,6,26,2,3,2006
110,Marko Jaric,MIN,75,2102,293,624,255,38,73,57,125,14,24,2006
111,Damon Jones,CLE,82,2088,169,388,119,50,73,20,26,22,28,2006
112,Jumaine Jones,CHA,76,2088,63,140,49,14,21,8,20,8,6,2006
113,Donyell Marshall,CLE,81,2077,60,140,40,20,28,3,9,7,13,2006
114,John Salmons,PHI,82,2059,223,500,169,54,79,32,58,22,32,2006
115,Michael Finley,SAS,77,2038,116,262,86,30,38,19,29,17,13,2006
116,Raef LaFrentz,BOS,82,2033,115,263,82,33,34,19,29,9,24,2006
117,Speedy Claxton,NOK,71,2019,339,749,268,71,116,23,129,18,53,2006
118,Jalen Rose,NYK,72,1982,181,421,122,59,73,14,35,29,30,2006
119,Anthony Johnson,IND,75,1981,324,727,245,79,123,33,89,21,58,2006
120,Kwame Brown,LAL,72,1978,72,161,55,17,20,10,25,2,15,2006
121,Vladimir Radmanovic,LAC,77,1974,136,307,101,35,42,31,28,16,19,2006
122,Baron Davis,GSW,54,1971,480,1102,338,142,207,41,90,44,98,2006
123,Shareef Abdur-Rahim,SAC,72,1961,149,347,100,49,43,9,48,13,36,2006
124,Marvin Williams,ATL,79,1952,63,135,54,9,27,5,22,4,5,2006
125,Jared Jeffries,WAS,77,1951,148,332,112,36,55,16,41,4,32,2006
126,Yao Ming,HOU,57,1949,85,200,55,30,40,0,15,6,24,2006
127,Matt Harpring,UTA,71,1944,98,214,80,18,44,12,24,1,17,2006
128,Erick Dampier,DAL,82,1934,51,122,31,20,16,3,12,5,15,2006
129,Juan Dixon,POR,76,1920,149,316,131,18,69,23,39,5,13,2006
130,Josh Howard,DAL,59,1915,111,251,82,29,25,11,46,9,20,2006
131,James Posey,MIA,67,1914,89,208,59,30,27,12,20,9,21,2006
132,Kevin Martin,SAC,72,1913,97,220,71,26,20,3,48,9,17,2006
133,Keith Bogans,HOU,72,1912,128,274,110,18,48,39,23,10,8,2006
134,Jason Collins,NJN,71,1895,70,158,52,18,21,5,26,4,14,2006
135,Gerald Wallace,CHA,55,1895,96,218,70,26,38,6,26,7,19,2006
136,Brendan Haywood,WAS,79,1879,46,108,30,16,12,3,15,4,12,2006
137,Rasual Butler,NOK,79,1874,40,86,34,6,15,1,18,2,4,2006
138,Jason Williams,MIA,59,1874,287,630,231,56,134,30,67,19,37,2006
139,Eddy Curry,NYK,72,1866,19,45,12,7,9,1,2,2,5,2006
140,Clifford Robinson,NJN,80,1862,89,206,61,28,30,8,23,8,20,2006
141,Marcus Camby,DEN,56,1857,115,240,105,10,56,7,42,3,7,2006
142,Fred Jones,IND,68,1836,154,350,112,42,45,20,47,10,32,2006
143,Adonal Foyle,GSW,77,1824,33,75,24,9,15,1,8,1,8,2006
144,Manu Ginobili,SAS,65,1813,235,536,169,66,78,32,59,45,21,2006
145,Shaquille O'Neal,MIA,59,1806,113,271,68,45,57,3,8,5,40,2006
146,Jermaine O'Neal,IND,51,1803,133,306,93,40,65,10,18,12,28,2006
147,Ruben Patterson,DEN,71,1793,127,276,105,22,69,1,35,4,18,2006
148,Jameer Nelson,ORL,62,1784,302,665,241,61,117,21,103,23,38,2006
149,Steve Blake,POR,68,1781,306,657,261,45,124,28,109,18,27,2006
150,Bobby Jackson,MEM,71,1775,195,443,142,53,74,16,52,15,38,2006
151,James Jones,PHX,75,1772,57,145,26,31,9,4,13,11,20,2006
152,Marquis Daniels,DAL,62,1766,172,387,129,43,48,21,60,11,32,2006
153,Danny Granger,IND,78,1765,90,217,53,37,23,7,23,13,24,2006
154,Samuel Dalembert,PHI,66,1761,25,58,17,8,6,2,9,2,6,2006
155,Greg Buckner,DEN,73,1758,127,272,109,18,47,9,53,6,12,2006
156,Tracy McGrady,HOU,47,1745,225,510,165,60,75,37,53,25,35,2006
157,Antonio McDyess,DET,82,1733,90,204,66,24,25,14,27,8,16,2006
158,Jarron Collins,UTA,79,1729,97,202,89,8,46,12,31,1,7,2006
159,Chucky Atkins,MEM,71,1713,198,450,144,54,62,27,55,25,29,2006
160,Devin Brown,UTA,81,1711,104,217,95,9,39,15,41,0,9,2006
161,Matt Bonner,TOR,78,1709,56,136,32,24,12,3,17,16,8,2006
162,Lorenzen Wright,MEM,78,1689,48,114,30,18,23,3,4,10,8,2006
163,Bonzi Wells,SAC,52,1684,144,313,119,25,54,13,52,4,21,2006
164,Sebastian Telfair,POR,68,1641,247,549,192,55,85,22,85,21,34,2006
165,Jarrett Jack,POR,79,1599,219,482,175,44,76,25,74,19,25,2006
166,Leandro Barbosa,PHX,57,1592,158,382,92,66,34,15,43,25,41,2006
167,Jeff Foster,IND,63,1581,50,113,37,13,17,5,15,6,7,2006
168,Joey Graham,TOR,80,1581,60,142,38,22,20,9,9,13,9,2006
169,Francisco Elson,DEN,72,1579,47,104,37,10,17,6,14,4,6,2006
170,Earl Watson,SEA,70,1578,289,640,227,62,142,24,61,17,45,2006
171,Channing Frye,NYK,65,1572,53,121,38,15,21,11,6,7,8,2006
172,Sarunas Jasikevicius,IND,75,1557,227,488,193,34,131,17,45,9,25,2006
173,Kenyon Martin,DEN,56,1546,79,173,64,15,38,6,20,4,11,2006
174,Nate Robinson,NYK,72,1543,147,313,128,19,81,15,32,10,9,2006
175,Earl Boykins,DEN,60,1542,230,502,188,42,87,22,79,16,26,2006
176,Devean George,LAL,71,1542,68,155,49,19,23,3,23,5,14,2006
177,Chris Mihm,LAL,59,1542,61,136,47,14,19,10,18,0,14,2006
178,Brian Cook,LAL,81,1535,74,171,51,23,17,15,19,7,16,2006
179,Mo Williams,MIL,58,1531,230,514,176,54,91,30,55,18,36,2006
180,Chris Wilcox,SEA,77,1530,52,111,45,7,23,7,15,2,5,2006
181,Shaun Livingston,LAC,61,1525,273,597,222,51,90,49,83,16,35,2006
182,Jerry Stackhouse,DAL,55,1525,160,367,113,47,57,15,41,15,32,2006
183,Damien Wilkins,SEA,82,1525,107,261,60,47,29,14,17,13,34,2006
184,Quinton Ross,LAC,67,1515,79,171,66,13,22,16,28,5,8,2006
185,Rasho Nesterovic,SAS,80,1515,33,76,23,10,8,3,12,1,9,2006
186,DeSagana Diop,DAL,81,1510,23,53,16,7,5,0,11,1,6,2006
187,Marcus Banks,MIN,58,1496,220,465,195,25,80,24,91,8,17,2006
188,Viktor Khryapa,POR,69,1492,88,190,74,14,43,11,20,8,6,2006
189,Jose Calderon,TOR,64,1487,288,679,185,103,80,33,72,35,68,2006
190,Eduardo Najera,DEN,64,1449,52,111,45,7,17,4,24,1,6,2006
191,Sasha Vujacic,LAL,82,1448,139,322,95,44,32,13,50,11,33,2006
192,Nick Collison,SEA,66,1448,74,159,63,11,38,10,15,2,9,2006
193,Quentin Richardson,NYK,55,1442,88,191,73,15,41,14,18,6,9,2006
194,Eddie House,PHX,81,1421,148,328,116,32,56,16,44,15,17,2006
195,Kurt Thomas,PHX,53,1411,57,137,34,23,13,3,18,4,19,2006
196,Joel Przybilla,POR,56,1395,43,92,37,6,15,8,14,3,3,2006
197,Reggie Evans,DEN,67,1393,38,86,28,10,17,1,10,1,9,2006
198,Nazr Mohammed,SAS,80,1389,40,87,33,7,22,2,9,3,4,2006
199,Ryan Gomes,BOS,61,1376,58,140,34,24,21,4,9,6,18,2006
200,Milt Palacio,UTA,71,1376,190,434,136,54,56,20,60,19,35,2006
201,Rashad McCants,MIN,79,1362,63,134,55,8,26,9,20,1,7,2006
202,Eddie Griffin,MIN,70,1359,40,85,35,5,22,2,11,0,5,2006
203,Melvin Ely,CHA,57,1348,76,176,52,24,26,3,23,12,12,2006
204,Stromile Swift,HOU,66,1344,25,53,22,3,18,2,2,2,1,2006
205,Luke Walton,LAL,69,1332,156,339,129,27,71,25,33,6,21,2006
206,Kendrick Perkins,BOS,68,1332,69,161,46,23,25,2,19,5,18,2006
207,Darius Songaila,CHI,62,1329,88,206,58,30,28,7,23,15,15,2006
208,Steven Hunter,PHI,69,1312,17,42,9,8,3,2,4,1,7,2006
209,Kirk Snyder,NOK,68,1310,102,219,87,15,41,7,39,1,14,2006
210,Bernard Robinson,CHA,66,1303,77,176,55,22,26,5,24,10,12,2006
211,Alonzo Mourning,MIA,65,1302,11,25,8,3,4,2,2,1,2,2006
212,Theo Ratliff,POR,55,1301,28,66,18,10,8,3,7,2,8,2006
213,Francisco Garcia,SAC,67,1301,94,205,77,17,41,11,25,4,13,2006
214,Darius Miles,POR,40,1286,73,168,51,22,24,9,18,9,13,2006
215,Johan Petro,SEA,68,1282,15,34,11,4,4,2,5,1,3,2006
216,Charlie Bell,MIL,59,1282,130,298,92,38,38,16,38,13,25,2006
217,Larry Hughes,CLE,36,1281,131,295,98,33,59,18,21,22,11,2006
218,Matt Carroll,CHA,78,1275,35,76,29,6,8,9,12,2,4,2006
219,Devin Harris,DAL,56,1274,177,403,128,49,47,18,63,19,30,2006
220,Brent Barry,SAS,74,1258,123,278,91,32,47,16,28,15,17,2006
221,Adrian Griffin,DAL,52,1245,89,204,63,26,21,14,28,6,20,2006
222,Salim Stoudamire,ATL,61,1236,75,165,60,15,33,4,23,6,9,2006
223,Orien Greene,BOS,80,1234,129,284,103,26,63,11,29,11,15,2006
224,Jacque Vaughn,NJN,80,1234,123,280,89,34,36,5,48,14,20,2006
225,Tyronn Lue,ATL,51,1234,157,355,116,41,58,8,50,12,29,2006
226,Keith McLeod,UTA,66,1232,151,324,129,22,48,15,66,6,16,2006
227,Michael Sweetney,CHI,66,1222,59,137,40,19,15,7,18,6,13,2006
228,Maurice Taylor,NYK,67,1210,53,116,43,10,24,12,7,3,7,2006
229,Carlos Arroyo,ORL,77,1194,232,502,194,38,88,16,90,18,20,2006
230,Robert Horry,SAS,63,1182,79,175,62,17,36,14,12,8,9,2006
231,Mickael Pietrus,GSW,52,1179,44,105,27,17,13,3,11,7,10,2006
232,Travis Outlaw,POR,69,1153,34,75,27,7,12,4,11,4,3,2006
233,Austin Croshere,IND,50,1148,62,149,37,25,17,12,8,8,17,2006
234,Maurice Evans,DET,80,1139,60,141,39,21,10,7,22,7,14,2006
235,Keyon Dooling,ORL,50,1137,109,235,92,17,44,12,36,1,16,2006
236,David Lee,NYK,67,1128,43,96,33,10,22,6,5,6,4,2006
237,Jamaal Tinsley,IND,42,1122,211,475,158,53,78,16,64,16,37,2006
238,Etan Thomas,WAS,71,1121,14,30,12,2,7,1,4,1,1,2006
239,Malik Rose,NYK,72,1118,67,146,55,12,31,14,10,3,9,2006
240,Kareem Rush,CHA,47,1111,50,114,36,14,13,4,19,5,9,2006
241,Keith Van Horn,DAL,53,1089,37,85,26,11,7,7,12,4,7,2006
242,Martell Webster,POR,61,1070,34,77,25,9,6,7,12,6,3,2006
243,Kevin Ollie,PHI,70,1069,101,223,80,21,40,9,31,8,13,2006
244,Al Jefferson,BOS,59,1063,30,68,22,8,15,2,5,0,8,2006
245,Derek Anderson,MIA,43,1047,101,224,79,22,43,11,25,13,9,2006
246,David Harrison,IND,67,1034,14,34,8,6,5,2,1,1,5,2006
247,Ike Diogu,GSW,69,1031,29,64,23,6,14,5,4,3,3,2006
248,Marc Jackson,NOK,64,1027,44,100,32,12,22,1,9,5,7,2006
249,Carlos Boozer,UTA,33,1025,88,187,77,11,38,9,30,0,11,2006
250,Toni Kukoc,MIL,65,1018,139,302,115,24,82,18,15,11,13,2006
251,Qyntel Woods,NYK,49,1012,47,108,33,14,17,6,10,9,5,2006
252,Michael Ruffin,WAS,76,1010,27,60,21,6,11,3,7,0,6,2006
253,Andris Biedrins,GSW,68,1000,24,56,16,8,8,1,7,3,5,2006
254,Trevor Ariza,ORL,57,999,61,129,54,7,28,10,16,4,3,2006
255,Justin Reed,MIN,72,996,41,90,33,8,9,1,23,2,6,2006
256,JR Smith,NOK,55,989,58,121,53,5,25,8,20,1,4,2006
257,Robert Swift,SEA,47,987,8,21,3,5,0,1,2,1,4,2006
258,Nick Van Exel,SAS,65,986,123,280,89,34,51,17,21,12,22,2006
259,Tony Allen,BOS,51,978,67,149,52,15,25,7,20,7,8,2006
260,Royal Ivey,ATL,73,977,74,164,58,16,27,8,23,4,12,2006
261,Daniel Ewing,LAC,66,971,84,180,72,12,28,19,25,2,10,2006
262,Dahntay Jones,MEM,71,967,39,92,25,14,16,4,5,8,6,2006
263,Gordan Giricek,UTA,37,956,63,135,54,9,23,6,25,3,6,2006
264,Dikembe Mutombo,HOU,64,955,4,9,3,1,2,0,1,0,1,2006
265,Brian Skinner,POR,65,944,30,70,20,10,12,0,8,2,8,2006
266,Corey Maggette,LAC,32,943,66,140,58,8,21,22,15,2,6,2006
267,Antonio Davis,TOR,44,940,21,53,10,11,3,5,2,4,7,2006
268,Brian Scalabrine,BOS,71,938,51,117,36,15,23,5,8,3,12,2006
269,Pat Garrity,ORL,57,937,38,87,27,11,18,2,7,2,9,2006
270,DerMarr Johnson,DEN,58,924,55,120,45,10,23,3,19,4,6,2006
271,Michael Olowokandi,BOS,48,918,23,53,16,7,6,1,9,3,4,2006
272,Joe Smith,MIL,44,887,31,71,22,9,16,2,4,4,5,2006
273,Monta Ellis,GSW,49,886,78,174,60,18,31,8,21,7,11,2006
274,Dan Gadzuric,MIL,74,885,24,56,16,8,10,2,4,2,6,2006
275,Emeka Okafor,CHA,26,874,31,71,22,9,9,2,11,3,6,2006
276,Jiri Welsch,MIL,58,866,62,135,51,11,31,8,12,4,7,2006
277,Damon Stoudamire,MEM,27,862,128,290,94,34,49,15,30,11,23,2006
278,Othella Harrington,CHI,72,824,39,88,29,10,11,5,13,2,8,2006
279,Jake Voskuhl,CHA,51,818,39,84,33,6,20,4,9,4,2,2006
280,Jason Hart,SAC,66,818,70,156,54,16,18,3,33,5,11,2006
281,Sasha Pavlovic,CLE,53,813,25,53,22,3,12,3,7,0,3,2006
282,Greg Ostertag,UTA,60,807,58,126,48,10,16,2,30,0,10,2006
283,Troy Hudson,MIN,36,800,106,231,87,19,36,18,33,7,12,2006
284,Aaron Williams,NOK,47,791,17,37,14,3,4,1,9,2,1,2006
285,Scot Pollard,IND,45,771,24,60,12,12,5,1,6,0,12,2006
286,Darko Milicic,ORL,55,767,41,88,35,6,22,6,7,3,3,2006
287,Anderson Varejao,CLE,48,760,19,42,15,4,12,0,3,1,3,2006
288,James Singleton,LAC,59,753,29,63,24,5,9,7,8,1,4,2006
289,Jackie Butler,NYK,55,740,25,56,19,6,12,2,5,3,3,2006
290,Jake Tsakalidis,MEM,51,732,13,30,9,4,3,3,3,3,1,2006
291,Carlos Delfino,DET,68,726,44,97,35,9,15,4,16,0,9,2006
292,Hakim Warrick,MEM,68,724,30,70,20,10,11,2,7,3,7,2006
293,Scott Padgett,NJN,62,718,41,95,28,13,12,3,13,6,7,2006
294,Malik Allen,CHI,54,701,20,44,16,4,3,3,10,1,3,2006
295,Mark Madsen,MIN,62,676,11,24,9,2,3,1,5,0,2,2006
296,Tim Thomas,PHX,29,665,20,44,16,4,9,3,4,3,1,2006
297,Jason Kapono,MIA,51,665,37,85,26,11,7,10,9,2,9,2006
298,Ryan Bowen,HOU,68,652,24,53,19,5,9,4,6,2,3,2006
299,Jannero Pargo,CHI,57,646,94,209,73,21,29,8,36,9,12,2006
300,Shandon Anderson,MIA,48,638,30,69,21,9,17,2,2,5,4,2006
301,Matt Barnes,PHI,56,631,28,61,23,5,15,1,7,2,3,2006
302,Darrell Armstrong,DAL,62,622,86,198,60,26,20,15,25,9,17,2006
303,Kris Humphries,UTA,62,619,30,62,28,2,15,3,10,0,2,2006
304,Grant Hill,ORL,21,613,48,101,43,5,29,5,9,2,3,2006
305,Rafael Araujo,TOR,52,601,15,33,12,3,5,5,2,1,2,2006
306,Zoran Planinic,NJN,56,595,53,120,39,14,15,2,22,3,11,2006
307,Pape Sow,TOR,42,590,8,16,8,0,4,0,4,0,0,2006
308,Anthony Carter,MIN,45,589,101,216,87,14,32,9,46,5,9,2006
309,Beno Udrih,SAS,54,586,92,208,68,24,29,11,28,11,13,2006
310,Mikki Moore,SEA,47,583,27,62,19,8,8,2,9,0,8,2006
311,Lamond Murray,NJN,57,575,13,31,8,5,5,1,2,2,3,2006
312,Antonio Burks,MEM,57,570,76,181,47,29,20,8,19,10,19,2006
313,Chris Andersen,NOK,32,570,6,14,4,2,3,1,0,2,0,2006
314,Alan Anderson,CHA,36,564,32,72,24,8,13,4,7,6,2,2006
315,Chuck Hayes,HOU,40,535,14,33,9,5,5,0,4,2,3,2006
316,Alan Henderson,CLE,51,531,10,23,7,3,3,2,2,1,2,2006
317,Linton Johnson,NOK,36,524,14,31,11,3,2,3,6,1,2,2006
318,Linas Kleiza,DEN,61,519,15,34,11,4,8,1,2,1,3,2006
319,Jarvis Hayes,WAS,21,516,27,62,19,8,12,1,6,1,7,2006
320,Jim Jackson,LAL,40,512,35,80,25,10,12,4,9,5,5,2006
321,Zarko Cabarkapa,GSW,61,505,20,44,16,4,11,1,4,3,1,2006
322,Bostjan Nachbar,NJN,36,502,27,63,18,9,4,3,11,3,6,2006
323,Esteban Batista,ATL,57,495,7,16,5,2,0,1,4,1,1,2006
324,Fabricio Oberto,SAS,59,490,27,62,19,8,7,4,8,1,7,2006
325,Shavlik Randolph,PHI,57,487,19,44,13,6,7,2,4,1,5,2006
326,Jeff McInnis,NJN,28,486,52,118,38,14,12,7,19,7,7,2006
327,Donell Taylor,WAS,51,465,45,105,30,15,19,3,8,4,11,2006
328,Voshon Lenard,POR,26,458,41,88,35,6,21,2,12,2,4,2006
329,Calbert Cheaney,GSW,42,448,19,42,15,4,6,4,5,1,3,2006
330,Josh Powell,DAL,37,429,9,20,7,2,1,1,5,0,2,2006
331,Moochie Norris,NOK,45,424,50,112,38,12,12,5,21,4,8,2006
332,Wayne Simien,MIA,43,414,7,15,6,1,2,2,2,0,1,2006
333,Zeljko Rebraca,LAC,29,412,9,19,8,1,1,3,4,0,1,2006
334,Jerome James,NYK,44,406,12,27,9,3,5,1,3,1,2,2006
335,Jackson Vroman,NOK,41,406,11,22,11,0,6,2,3,0,0,2006
336,Brian Cardinal,MEM,36,402,33,68,31,2,17,6,8,0,2,2006
337,Lonny Baxter,CHA,41,400,4,9,3,1,0,0,3,0,1,2006
338,Sean May,CHA,23,398,22,51,15,7,10,3,2,3,4,2006
339,Howard Eisley,DEN,32,394,69,148,59,10,22,4,33,5,5,2006
340,Stacey Augmon,ORL,36,385,23,52,17,6,3,3,11,0,6,2006
341,Tony Delk,DET,24,385,33,74,25,8,12,2,11,3,5,2006
342,Gerald Green,BOS,32,373,18,38,16,2,9,3,4,1,1,2006
343,Michael Doleac,MIA,31,371,8,16,8,0,3,1,4,0,0,2006
344,Antoine Wright,NJN,39,370,12,26,10,2,6,2,2,1,1,2006
345,Michael Bradley,PHI,46,367,17,43,8,9,3,0,5,3,6,2006
346,Corliss Williamson,SAC,37,362,14,32,10,4,3,3,4,3,1,2006
347,Bo Outlaw,ORL,32,355,14,30,12,2,7,2,3,0,2,2006
348,Ira Newble,CLE,36,353,9,19,8,1,4,0,4,0,1,2006
349,Lindsey Hunter,DET,30,353,62,130,56,6,17,4,35,5,1,2006
350,Walter McCarty,LAC,36,353,23,49,20,3,10,7,3,0,3,2006
351,Vitaly Potapenko,SAC,33,353,9,21,6,3,1,0,5,0,3,2006
352,Eric Williams,TOR,28,352,15,33,12,3,5,2,5,2,1,2006
353,Mike Wilks,SEA,47,347,32,78,18,14,5,5,8,3,11,2006
354,Pat Burke,PHX,42,346,16,39,9,7,0,1,8,3,4,2006
355,Sergei Monia,SAC,26,343,19,43,14,5,6,1,7,2,3,2006
356,Richie Frahm,HOU,33,342,21,49,14,7,4,3,7,3,4,2006
357,Jon Barry,HOU,20,342,26,63,15,11,5,7,3,3,8,2006
358,Kevin Burleson,CHA,39,340,48,109,35,13,9,6,20,8,5,2006
359,Darrick Martin,TOR,40,339,57,134,37,20,21,7,9,9,11,2006
360,Andrew Bynum,LAL,46,338,9,21,6,3,4,1,1,0,3,2006
361,Kelvin Cato,DET,27,333,4,9,3,1,2,0,1,1,0,2006
362,Loren Woods,TOR,27,324,4,10,2,2,0,0,2,1,1,2006
363,Luke Jackson,CLE,36,315,25,55,20,5,16,0,4,0,5,2006
364,John Edwards,ATL,40,296,5,12,3,2,0,0,3,0,2,2006
365,Andre Barrett,TOR,19,282,52,125,31,21,13,5,13,3,18,2006
366,Laron Profit,LAL,25,279,15,35,10,5,5,1,4,2,3,2006
367,Danny Fortson,SEA,23,276,2,5,1,1,1,0,0,0,1,2006
368,Brandon Bass,NOK,29,268,3,6,3,0,0,0,3,0,0,2006
369,Ronald Dupree,MIN,36,265,14,33,9,5,5,1,3,2,3,2006
370,Calvin Booth,WAS,33,250,12,26,10,2,4,0,6,0,2,2006
371,Brian Grant,PHX,21,248,7,18,3,4,1,1,1,0,4,2006
372,Rick Brunson,HOU,27,247,35,76,29,6,15,6,8,5,1,2006
373,Travis Diener,ORL,23,246,16,36,12,4,8,0,4,0,4,2006
374,Rawle Marshall,DAL,23,241,10,25,5,5,0,2,3,3,2,2006
375,Gerald Fitch,MIA,18,239,33,74,25,8,11,2,12,0,8,2006
376,Lee Nailon,PHI,22,237,7,16,5,2,5,0,0,2,0,2006
377,DJ Mbenga,DAL,43,237,2,5,1,1,0,0,1,1,0,2006
378,Dan Dickau,BOS,19,234,40,87,33,7,15,7,11,2,5,2006
379,Mateen Cleaves,SEA,27,230,42,102,24,18,12,4,8,5,13,2006
380,Eric Piatkowski,CHI,29,228,13,28,11,2,4,1,6,0,2,2006
381,Mario Kasun,ORL,28,213,3,6,3,0,1,0,2,0,0,2006
382,Robert Whaley,UTA,23,212,17,34,17,0,10,0,7,0,0,2006
383,Ha Ha,POR,27,212,1,3,0,1,0,0,0,0,1,2006
384,Andre Owens,UTA,23,210,8,19,5,3,3,0,2,2,1,2006
385,Charles Smith,DEN,22,210,9,20,7,2,4,1,2,0,2,2006
386,CJ Miles,UTA,23,203,16,32,16,0,11,1,4,0,0,2006
387,Jermaine Jackson,MIL,30,202,25,58,17,8,8,2,7,1,7,2006
388,Terence Morris,ORL,22,192,4,8,4,0,1,1,2,0,0,2006
389,Doug Christie,DAL,7,185,14,29,13,1,9,0,4,1,0,2006
390,Lawrence Roberts,MEM,33,181,5,12,3,2,3,0,0,0,2,2006
391,Sean Marks,SAS,25,181,7,15,6,1,2,3,1,1,0,2006
392,Dale Davis,DET,28,178,6,14,4,2,2,1,1,1,1,2006
393,Andray Blatche,WAS,29,175,10,21,9,1,8,0,1,0,1,2006
394,Stephen Graham,CLE,22,175,7,17,4,3,2,0,2,1,2,2006
395,Will Bynum,GSW,15,162,19,41,16,3,12,3,1,2,1,2006
396,Ronny Turiaf,LAL,23,161,8,21,3,5,1,1,1,2,3,2006
397,Jason Maxiell,DET,26,159,3,6,3,0,2,0,1,0,0,2006
398,Willie Green,PHI,10,153,5,13,2,3,2,0,0,1,2,2006
399,Boniface Ndong,LAC,23,151,7,16,5,2,3,1,1,1,1,2006
400,James Thomas,CHI,22,150,1,2,1,0,1,0,0,0,0,2006
401,Ronnie Price,SAC,29,150,11,23,10,1,4,1,5,1,0,2006
402,Luke Schenscher,CHI,20,149,7,14,7,0,3,2,2,0,0,2006
403,Lou Williams,PHI,30,145,10,22,8,2,5,1,2,0,2,2006
404,Chris Taft,GSW,17,144,2,4,2,0,1,0,1,0,0,2006
405,Eddie Basden,CHI,19,141,8,19,5,3,2,1,2,1,2,2006
406,Bracey Wright,MIN,7,135,5,10,5,0,4,0,1,0,0,2006
407,Devin Green,LAL,27,135,7,18,3,4,1,1,1,0,4,2006
408,Arvydas Macijauskas,NOK,19,134,5,12,3,2,2,1,0,1,1,2006
409,Dorell Wright,MIA,20,132,8,18,6,2,2,1,3,1,1,2006
410,Billy Thomas,WAS,17,131,9,20,7,2,3,2,2,0,2,2006
411,John Thomas,NJN,16,127,2,5,1,1,1,0,0,0,1,2006
412,Donta Smith,ATL,23,127,9,19,8,1,6,0,2,0,1,2006
413,Yaroslav Korolev,LAC,24,127,9,19,8,1,3,3,2,1,0,2006
414,Eddie Gill,IND,41,122,12,26,10,2,3,3,4,0,2,2006
415,Aaron McKie,LAL,14,121,11,25,8,3,6,0,2,0,3,2006
416,Aaron Miles,GSW,19,118,24,49,23,1,12,2,9,0,1,2006
417,Awvee Storey,WAS,25,116,4,9,3,1,0,1,2,1,0,2006
418,Ime Udoka,NYK,8,114,6,13,5,1,2,2,1,0,1,2006
419,Melvin Sanders,SAS,16,113,3,6,3,0,0,1,2,0,0,2006
420,Anthony Grundy,ATL,12,108,9,18,9,0,6,1,2,0,0,2006
421,John Lucas III,HOU,13,107,12,26,10,2,3,2,5,1,1,2006
422,Nikoloz Tskitishvili,PHX,17,99,3,6,3,0,1,2,0,0,0,2006
423,Anthony Roberson,MEM,16,88,5,11,4,1,0,1,3,0,1,2006
424,Dwayne Jones,BOS,14,86,2,5,1,1,1,0,0,0,1,2006
425,Vin Baker,LAC,8,85,4,8,4,0,3,0,1,0,0,2006
426,Noel Felix,SEA,12,82,2,4,2,0,1,0,1,0,0,2006
427,Ervin Johnson,MIL,18,81,2,4,2,0,2,0,0,0,0,2006
428,Von Wafer,LAL,16,73,4,9,3,1,2,0,1,1,0,2006
429,Anfernee Hardaway,NYK,4,72,8,19,5,3,1,1,3,1,2,2006
430,Reece Gaines,MIL,12,54,3,6,3,0,1,1,1,0,0,2006
431,Amar'e Stoudemire,PHX,3,50,2,4,2,0,1,1,0,0,0,2006
432,Zendon Hamilton,PHI,12,48,0,0,0,0,0,0,0,0,0,2006
433,Earl Barron,MIA,8,45,0,0,0,0,0,0,0,0,0,2006
434,Dijon Thompson,PHX,10,43,1,2,1,0,0,0,1,0,0,2006
435,Marcus Fizer,NOK,3,39,1,2,1,0,1,0,0,0,0,2006
436,Amir Johnson,DET,3,39,3,6,3,0,1,1,1,0,0,2006
437,Jamal Sampson,SAC,12,39,5,11,4,1,1,0,3,1,0,2006
438,Alex Acker,DET,5,35,4,9,3,1,1,0,2,1,0,2006
439,Julius Hodge,DEN,14,33,6,13,5,1,4,0,1,0,1,2006
440,Derrick Zimmerman,NJN,2,32,7,18,3,4,3,0,0,2,2,2006
441,Maciej Lampe,HOU,6,28,2,5,1,1,1,0,0,1,0,2006
442,Randy Livingston,CHI,5,22,1,2,1,0,1,0,0,0,0,2006
443,Anthony Goldwire,LAC,3,22,2,4,2,0,1,0,1,0,0,2006
444,Samaki Walker,IND,7,22,0,0,0,0,0,0,0,0,0,2006
445,Jonathan Bender,IND,2,21,2,5,1,1,1,0,0,0,1,2006
446,Pavel Podkolzin,DAL,1,18,0,0,0,0,0,0,0,0,0,2006
447,Josh Davis,PHX,6,17,1,2,1,0,1,0,0,0,0,2006
448,Sharrod Ford,PHX,3,13,0,0,0,0,0,0,0,0,0,2006
449,Randy Holcomb,CHI,4,11,0,0,0,0,0,0,0,0,0,2006
450,Alvin Williams,TOR,1,10,0,0,0,0,0,0,0,0,0,2006
451,Martynas Andriuskevicius,CLE,6,9,0,0,0,0,0,0,0,0,0,2006
452,Slava Medvedenko,LAL,2,6,1,2,1,0,0,0,1,0,0,2006
453,Deng Gai,PHI,2,5,0,0,0,0,0,0,0,0,0,2006
454,Matt Walsh,MIA,2,3,0,0,0,0,0,0,0,0,0,2006
455,Bryon Russell,DEN,1,3,1,2,1,0,1,0,0,0,0,2006
456,Nene,DEN,1,3,0,0,0,0,0,0,0,0,0,2006
457,Alex Scales,SAS,1,0,0,0,0,0,0,0,0,0,0,2006
0,LeBron James,CLE,80,3384,577,1234,497,80,223,88,186,32,48,2005
1,Stephon Marbury,NYK,82,3295,668,1478,526,142,182,78,266,50,92,2005
2,Gilbert Arenas,WAS,80,3279,411,903,330,81,157,65,108,23,58,2005
3,Joe Johnson,PHX,82,3238,291,709,164,127,92,19,53,32,95,2005
4,Tracy McGrady,HOU,78,3191,448,1026,318,130,138,70,110,57,73,2005
5,Allen Iverson,PHI,75,3176,596,1336,452,144,262,46,144,53,91,2005
6,Shawn Marion,PHX,81,3144,154,373,89,65,58,10,21,24,41,2005
7,Kevin Garnett,MIN,82,3121,466,1039,359,107,124,63,172,39,68,2005
8,Mike Bibby,SAC,80,3091,541,1184,439,102,171,41,227,32,70,2005
9,Ray Allen,SEA,78,3069,289,678,189,100,113,31,45,40,60,2005
10,Tayshaun Prince,DET,82,3044,247,543,198,49,86,35,77,16,33,2005
11,Dirk Nowitzki,DAL,78,3028,240,532,188,52,111,31,46,20,32,2005
12,Chris Bosh,TOR,81,3014,153,373,86,67,49,9,28,22,45,2005
13,Elton Brand,LAC,81,3005,208,441,183,25,61,26,96,11,14,2005
14,Dwyane Wade,MIA,77,2978,520,1197,363,157,205,31,127,61,96,2005
15,Steve Francis,ORL,78,2975,547,1196,445,102,251,54,140,24,78,2005
16,Antoine Walker,BOS,77,2966,265,574,221,44,143,12,66,15,29,2005
17,Paul Pierce,BOS,82,2964,348,782,262,86,152,37,73,28,58,2005
18,Richard Hamilton,DET,76,2937,372,804,312,60,174,41,97,26,34,2005
19,Chucky Atkins,LAL,82,2912,358,804,270,88,161,41,68,21,67,2005
20,Desmond Mason,MIL,80,2885,217,473,178,39,72,38,68,16,23,2005
21,Amar'e Stoudemire,PHX,80,2885,131,319,74,57,42,13,19,16,41,2005
22,Chauncey Billups,DET,80,2874,464,1010,382,82,164,81,137,26,56,2005
23,Kurt Thomas,NYK,80,2860,160,375,105,55,47,16,42,21,34,2005
24,Michael Redd,MIL,75,2852,172,369,147,25,70,26,51,6,19,2005
25,Andre Miller,DEN,82,2849,569,1209,498,71,327,29,142,25,46,2005
26,Quentin Richardson,PHX,79,2845,158,368,106,52,68,18,20,28,24,2005
27,Vince Carter,NJN,77,2838,327,741,240,87,93,27,120,36,51,2005
28,Eddie Jones,MIA,80,2837,212,465,171,41,88,27,56,13,28,2005
29,P.J. Brown,NOH,82,2826,178,390,144,34,51,16,77,8,26,2005
30,Bobby Simmons,LAC,75,2811,205,432,183,22,71,63,49,5,17,2005
31,Kirk Hinrich,CHI,77,2798,494,1103,379,115,176,82,121,38,77,2005
32,David Wesley,HOU,80,2777,265,589,206,59,79,46,81,16,43,2005
33,Damon Stoudamire,POR,81,2769,458,991,383,75,211,58,114,24,51,2005
34,Caron Butler,LAL,77,2742,146,345,93,53,48,17,28,14,39,2005
35,Tony Parker,SAS,80,2736,490,1131,339,151,146,65,128,83,68,2005
36,Rafer Alston,TOR,80,2723,514,1172,370,144,139,59,172,76,68,2005
37,Jason Richardson,GSW,72,2720,281,635,208,73,105,27,76,27,46,2005
38,Jalen Rose,TOR,81,2714,209,489,138,71,74,18,46,30,41,2005
39,Rashard Lewis,SEA,71,2702,94,221,61,33,26,10,25,5,28,2005
40,Rasheed Wallace,DET,79,2696,142,307,119,23,69,20,30,9,14,2005
41,Ricky Davis,BOS,82,2692,246,556,182,64,100,26,56,25,39,2005
42,Kobe Bryant,LAL,66,2690,398,950,244,154,143,30,71,51,103,2005
43,Jamal Crawford,NYK,70,2685,302,659,247,55,95,27,125,21,34,2005
44,Andre Iguodala,PHI,82,2681,246,554,184,62,86,35,63,20,42,2005
45,Dwight Howard,ORL,82,2679,75,160,65,10,31,9,25,1,9,2005
46,Udonis Haslem,MIA,80,2678,108,234,90,18,62,14,14,5,13,2005
47,Ben Wallace,DET,74,2674,123,277,92,31,50,20,22,9,22,2005
48,Kyle Korver,PHI,82,2667,182,387,159,23,84,32,43,8,15,2005
49,Jeff McInnis,CLE,76,2651,391,812,361,30,164,61,136,12,18,2005
50,Bruce Bowen,SAS,82,2623,126,296,82,44,40,18,24,14,30,2005
51,Zydrunas Ilgauskas,CLE,78,2616,100,223,77,23,31,18,28,1,22,2005
52,Carmelo Anthony,DEN,75,2610,194,402,180,14,119,17,44,8,6,2005
53,Antawn Jamison,WAS,68,2609,154,349,113,41,65,11,37,8,33,2005
54,Emeka Okafor,CHA,73,2600,64,144,48,16,19,7,22,5,11,2005
55,Matt Harpring,UTA,78,2585,142,302,124,18,51,11,62,4,14,2005
56,Damon Jones,MIA,82,2578,351,749,304,47,148,50,106,10,37,2005
57,Luke Ridnour,SEA,82,2574,483,1171,278,205,139,56,83,49,156,2005
58,Mike Dunleavy,GSW,79,2569,203,461,148,55,80,12,56,21,34,2005
59,Steve Nash,PHX,75,2569,861,2006,577,284,399,75,103,113,171,2005
60,Wally Szczerbiak,MIN,81,2567,191,424,149,42,56,35,58,12,30,2005
61,Gary Payton,BOS,77,2551,469,1039,368,101,183,45,140,38,63,2005
62,Al Harrington,ATL,66,2547,208,463,161,47,91,16,54,11,36,2005
63,Jason Collins,NJN,80,2546,105,229,86,19,25,10,51,6,13,2005
64,Peja Stojakovic,SAC,66,2539,138,303,111,27,32,15,64,10,17,2005
65,Drew Gooden,CLE,82,2525,130,277,113,17,73,13,27,2,15,2005
66,Morris Peterson,TOR,82,2520,169,396,111,58,47,22,42,37,21,2005
67,Shane Battier,MEM,80,2519,126,293,85,41,41,14,30,17,24,2005
68,Shaquille O'Neal,MIA,73,2498,200,469,131,69,102,3,26,6,63,2005
69,Yao Ming,HOU,80,2460,61,142,41,20,18,7,16,6,14,2005
70,Jason Kidd,NJN,66,2450,545,1178,457,88,186,79,192,21,67,2005
71,Latrell Sprewell,MIN,80,2448,179,377,160,19,55,48,57,3,16,2005
72,Corey Maggette,LAC,66,2447,225,483,192,33,73,49,70,16,17,2005
73,Josh Howard,DAL,76,2444,109,243,84,25,27,14,43,5,20,2005
74,Jason Terry,DAL,80,2398,429,949,338,91,150,45,143,21,70,2005
75,Cuttino Mobley,SAC,66,2394,188,408,156,32,69,18,69,12,20,2005
76,Troy Murphy,GSW,70,2382,97,226,65,32,32,7,26,6,26,2005
77,Chris Webber,PHI,67,2373,318,720,234,84,114,28,92,28,56,2005
78,Josh Childress,ATL,80,2372,151,329,124,27,62,11,51,10,17,2005
79,Michael Finley,DAL,64,2366,169,375,132,37,55,17,60,13,24,2005
80,Larry Hughes,WAS,61,2357,285,637,218,67,133,42,43,10,57,2005
81,Grant Hill,ORL,67,2343,220,470,190,30,95,28,67,7,23,2005
82,Lamar Odom,LAL,64,2316,238,558,156,82,85,21,50,21,61,2005
83,Mehmet Okur,UTA,82,2304,166,356,142,24,84,11,47,7,17,2005
84,Lorenzen Wright,MEM,80,2286,87,205,56,31,34,11,11,12,19,2005
85,Primoz Brezec,CHA,72,2283,86,186,72,14,24,13,35,6,8,2005
86,Mike Miller,MEM,76,2281,220,508,152,68,71,21,60,24,44,2005
87,Kenyon Martin,DEN,70,2279,170,359,151,19,100,11,40,6,13,2005
88,Joe Smith,MIL,74,2271,67,147,54,13,29,12,13,4,9,2005
89,Fred Jones,IND,77,2270,196,462,126,70,54,24,48,26,44,2005
90,Mo Williams,MIL,80,2262,484,1025,427,57,217,60,150,17,40,2005
91,Derek Fisher,GSW,74,2222,301,672,231,70,120,27,84,18,52,2005
92,Tim Duncan,SAS,66,2206,179,404,133,46,72,25,36,18,28,2005
93,Raef LaFrentz,BOS,80,2201,98,226,68,30,32,10,26,8,22,2005
94,Manu Ginobili,SAS,74,2201,288,637,227,61,130,37,60,37,24,2005
95,Tyson Chandler,CHI,80,2188,65,148,47,18,28,6,13,6,12,2005
96,Chris Duhon,CHI,82,2172,398,872,322,76,148,50,124,23,53,2005
97,Kenny Thomas,SAC,73,2171,152,366,90,62,50,10,30,21,41,2005
98,Earl Boykins,DEN,82,2167,372,824,292,80,140,29,123,35,45,2005
99,Gerald Wallace,CHA,70,2149,137,297,114,23,57,21,36,15,8,2005
100,Mark Blount,BOS,82,2144,129,277,110,19,76,6,28,3,16,2005
101,Reggie Miller,IND,66,2112,146,330,108,38,50,29,29,14,24,2005
102,Brad Miller,SAC,56,2093,220,485,175,45,80,16,79,10,35,2005
103,Dan Dickau,NOH,71,2080,347,756,285,62,121,41,123,17,45,2005
104,Trenton Hassell,MIN,82,2072,128,280,104,24,37,26,41,5,19,2005
105,Josh Smith,ATL,74,2050,127,262,119,8,79,12,28,3,5,2005
106,Antonio Daniels,SEA,75,2026,309,755,172,137,95,28,49,44,93,2005
107,Marcus Camby,DEN,66,2019,152,324,132,20,88,16,28,9,11,2005
108,Lee Nailon,NOH,68,2014,109,234,93,16,50,12,31,6,10,2005
109,Ben Gordon,CHI,82,2013,164,372,120,44,64,26,30,8,36,2005
110,Tyronn Lue,ATL,70,2009,322,698,268,54,111,33,124,20,34,2005
111,Jared Jeffries,WAS,77,2006,151,348,105,46,54,15,36,17,29,2005
112,Jim Jackson,PHX,64,1996,183,411,138,45,70,37,31,17,28,2005
113,Marc Jackson,PHI,81,1970,81,187,56,25,33,9,14,8,17,2005
114,Nenad Krstic,NJN,75,1968,77,180,51,26,13,4,34,6,20,2005
115,Ruben Patterson,POR,70,1964,138,313,101,37,66,14,21,11,26,2005
116,Jason Williams,MEM,71,1950,399,887,310,89,171,51,88,29,60,2005
117,Brevin Knight,CHA,66,1947,591,1248,525,66,211,71,243,24,42,2005
118,Tim Thomas,NYK,71,1941,110,255,75,35,19,13,43,14,21,2005
119,Nazr Mohammed,SAS,77,1939,34,73,29,5,17,5,7,1,4,2005
120,Rick Brunson,LAC,80,1936,410,850,380,30,130,60,190,12,18,2005
121,Bob Sura,HOU,61,1925,317,701,250,67,89,41,120,26,41,2005
122,Tony Battie,ORL,81,1910,42,90,36,6,19,2,15,2,4,2005
123,Andres Nocioni,CHI,81,1895,122,274,92,30,44,22,26,13,17,2005
124,Jason Hart,CHA,74,1888,367,809,292,75,75,51,166,36,39,2005
125,Reggie Evans,SEA,79,1879,58,139,35,23,12,4,19,6,17,2005
126,Shareef Abdur-Rahim,POR,54,1874,111,247,86,25,42,10,34,8,17,2005
127,Speedy Claxton,NOH,62,1874,374,867,255,119,103,21,131,33,86,2005
128,Chris Mihm,LAL,75,1873,50,114,36,14,13,8,15,3,11,2005
129,Brendan Haywood,WAS,68,1869,57,131,40,17,16,7,17,2,15,2005
130,Vladimir Radmanovic,SEA,63,1861,86,203,55,31,36,9,10,14,17,2005
131,Joel Przybilla,POR,76,1858,74,162,60,14,39,10,11,5,9,2005
132,Mike James,HOU,74,1858,263,579,210,53,88,37,85,18,35,2005
133,JR Smith,NOH,76,1857,142,318,108,34,44,10,54,10,24,2005
134,Antonio Davis,CHI,72,1843,80,182,58,22,36,7,15,7,15,2005
135,Eric Snow,CLE,81,1841,317,685,266,51,122,39,105,19,32,2005
136,Jumaine Jones,LAL,76,1835,65,154,41,24,20,7,14,6,18,2005
137,Austin Croshere,IND,73,1826,98,242,52,46,25,9,18,16,30,2005
138,Ira Newble,CLE,74,1826,91,189,84,7,31,26,27,3,4,2005
139,Earl Watson,MEM,80,1814,359,793,284,75,154,43,87,28,47,2005
140,Eddy Curry,CHI,63,1812,37,83,28,9,14,2,12,1,8,2005
141,Antonio McDyess,DET,77,1805,71,159,54,17,26,9,19,5,12,2005
142,Casey Jacobsen,NOH,84,1805,113,254,85,28,31,12,42,8,20,2005
143,Raja Bell,UTA,63,1797,91,189,84,7,31,11,42,2,5,2005
144,Keith Bogans,CHA,74,1795,135,282,123,12,60,26,37,6,6,2005
145,Stephen Jackson,IND,51,1795,119,271,86,33,45,13,28,9,24,2005
146,Samuel Dalembert,PHI,72,1791,35,82,23,12,6,4,13,3,9,2005
147,Pau Gasol,MEM,56,1783,135,327,78,57,60,6,12,16,41,2005
148,Rasho Nesterovic,SAS,70,1783,71,157,56,15,40,5,11,5,10,2005
149,Carlos Boozer,UTA,51,1781,144,309,123,21,54,18,51,3,18,2005
150,Dan Gadzuric,MIL,81,1778,30,68,22,8,6,2,14,2,6,2005
151,Hedo Turkoglu,ORL,67,1766,153,327,132,21,60,18,54,11,10,2005
152,Anthony Johnson,IND,63,1756,302,693,213,89,95,27,91,35,54,2005
153,Troy Hudson,MIN,79,1745,283,621,228,55,74,51,103,11,44,2005
154,Brent Barry,SAS,81,1736,178,398,136,42,69,23,44,18,24,2005
155,Theo Ratliff,POR,63,1724,34,76,26,8,14,7,5,1,7,2005
156,Adonal Foyle,GSW,78,1701,56,130,38,18,18,3,17,1,17,2005
157,Clifford Robinson,NJN,71,1696,104,233,79,25,38,10,31,10,15,2005
158,Darius Miles,POR,63,1694,129,290,97,32,68,9,20,8,24,2005
159,Marko Jaric,LAC,50,1662,303,637,272,31,104,62,106,18,13,2005
160,Luol Deng,CHI,61,1661,135,303,102,33,47,15,40,11,22,2005
161,Darius Songaila,SAC,81,1658,114,263,79,35,38,7,34,8,27,2005
162,Donyell Marshall,TOR,65,1657,81,181,62,19,33,9,20,9,10,2005
163,Melvin Ely,CHA,79,1655,76,175,53,23,29,2,22,8,15,2005
164,Gordan Giricek,UTA,81,1653,137,285,126,11,65,17,44,3,8,2005
165,Quinton Ross,LAC,78,1638,109,228,99,10,41,12,46,6,4,2005
166,Chris Kaman,LAC,63,1635,73,156,63,10,28,11,24,5,5,2005
167,Juwan Howard,HOU,61,1622,94,213,69,25,26,18,25,7,18,2005
168,Jerry Stackhouse,DAL,56,1620,127,296,85,42,44,9,32,15,27,2005
169,Nick Van Exel,POR,53,1618,227,491,190,37,128,16,46,6,31,2005
170,Jameer Nelson,ORL,79,1615,237,522,189,48,85,28,76,12,36,2005
171,Zach Randolph,POR,46,1607,86,197,61,25,44,7,10,7,18,2005
172,Erick Dampier,DAL,59,1606,51,118,35,16,12,5,18,6,10,2005
173,Jeff Foster,IND,61,1603,43,105,24,19,11,4,9,4,15,2005
174,Baron Davis,GSW,46,1582,362,829,257,105,163,24,70,31,74,2005
175,Jarvis Hayes,WAS,54,1563,90,207,63,27,34,7,22,10,17,2005
176,Matt Bonner,TOR,82,1545,48,118,26,22,12,3,11,18,4,2005
177,Jermaine O'Neal,IND,44,1540,82,191,55,27,33,5,17,11,16,2005
178,Corliss Williamson,SAC,72,1535,78,175,59,19,35,6,18,9,10,2005
179,Milt Palacio,TOR,80,1528,279,673,164,115,44,16,104,50,65,2005
180,Sam Cassell,MIN,59,1524,301,643,260,41,93,61,106,11,30,2005
181,Kelvin Cato,ORL,62,1522,40,83,37,3,24,3,10,0,3,2005
182,Doug Christie,ORL,52,1520,199,434,163,36,77,19,67,10,26,2005
183,Greg Buckner,DEN,70,1519,133,279,120,13,54,13,53,4,9,2005
184,Keith Van Horn,DAL,62,1503,75,174,51,24,22,11,18,8,16,2005
185,Michael Sweetney,NYK,77,1502,44,97,35,9,13,9,13,2,7,2005
186,Jon Barry,HOU,69,1501,167,362,139,28,72,28,39,4,24,2005
187,Eddie Griffin,MIN,70,1493,53,115,44,9,19,6,19,4,5,2005
188,Jason Kapono,CHA,81,1489,61,132,51,10,19,11,21,5,5,2005
189,Bonzi Wells,MEM,69,1489,80,183,57,23,40,6,11,5,18,2005
190,Malik Rose,NYK,76,1482,59,131,46,13,26,9,11,6,7,2005
191,Travis Best,NJN,76,1457,143,322,107,36,40,15,52,16,20,2005
192,Carlos Arroyo,DET,70,1443,280,592,248,32,115,35,98,6,26,2005
193,Predrag Drobnjak,ATL,71,1438,49,113,34,15,25,2,7,3,12,2005
194,Brian Cardinal,MEM,58,1433,114,254,88,26,58,20,10,9,17,2005
195,Howard Eisley,UTA,74,1429,250,535,215,35,79,31,105,18,17,2005
196,Chris Andersen,NOH,67,1424,71,148,65,6,23,3,39,1,5,2005
197,Marquis Daniels,DAL,60,1416,128,285,99,29,55,14,30,13,16,2005
198,Robert Horry,SAS,75,1410,80,183,57,23,38,9,10,7,16,2005
199,Jacque Vaughn,NJN,71,1400,135,308,97,38,40,14,43,12,26,2005
200,Nick Collison,SEA,82,1397,32,71,25,7,19,2,4,1,6,2005
201,Zaza Pachulia,MIL,74,1396,60,136,44,16,16,8,20,3,13,2005
202,James Posey,MEM,50,1384,88,212,52,36,31,4,17,13,23,2005
203,Keith McLeod,UTA,53,1382,236,503,205,31,81,19,105,7,24,2005
204,Trevor Ariza,NYK,80,1380,85,188,67,18,33,9,25,4,14,2005
205,Rodney Rogers,PHI,58,1367,86,188,70,16,43,8,19,2,14,2005
206,Richard Jefferson,NJN,33,1364,133,297,102,31,36,17,49,12,19,2005
207,Andrei Kirilenko,UTA,41,1353,132,275,121,11,74,8,39,9,2,2005
208,Tony Delk,ATL,56,1348,104,220,92,12,47,7,38,2,10,2005
209,Maurice Taylor,NYK,65,1343,67,145,56,11,26,15,15,5,6,2005
210,Bostjan Nachbar,NOH,71,1340,74,168,54,20,27,8,19,7,13,2005
211,Mickael Pietrus,GSW,67,1336,82,193,53,29,19,5,29,8,21,2005
212,Sebastian Telfair,POR,68,1330,224,496,176,48,104,15,57,17,31,2005
213,Robert Traylor,CLE,74,1329,61,132,51,10,25,10,16,4,6,2005
214,Eric Williams,TOR,55,1325,92,203,73,19,34,9,30,6,13,2005
215,Jerome James,SEA,80,1325,19,43,14,5,10,3,1,2,3,2005
216,James Jones,IND,75,1323,57,138,33,24,18,3,12,14,10,2005
217,Jiri Welsch,CLE,71,1320,103,218,91,12,43,13,35,5,7,2005
218,Nene,DEN,55,1315,84,179,73,11,44,7,22,5,6,2005
219,Rodney Buford,NJN,64,1310,63,140,49,14,20,5,24,4,10,2005
220,Dale Davis,IND,61,1307,47,108,33,14,14,5,14,5,9,2005
221,Jamaal Tinsley,IND,40,1301,257,569,202,55,105,42,55,17,38,2005
222,Stromile Swift,MEM,60,1280,43,98,31,12,20,5,6,6,6,2005
223,Othella Harrington,CHI,70,1278,56,131,37,19,15,5,17,4,15,2005
224,Fred Hoiberg,MIN,76,1267,85,184,71,14,24,24,23,5,9,2005
225,Michael Ruffin,WAS,79,1257,64,149,43,21,16,8,19,5,16,2005
226,Tony Allen,BOS,77,1254,64,143,49,15,33,9,7,7,8,2005
227,Derek Anderson,POR,47,1237,143,318,111,32,59,16,36,1,31,2005
228,Devin Brown,SAS,67,1232,92,209,67,25,31,13,23,10,15,2005
229,Maurice Evans,SAC,65,1225,45,105,30,15,8,5,17,6,9,2005
230,DerMarr Johnson,DEN,71,1223,75,159,66,9,31,11,24,4,5,2005
231,Dikembe Mutombo,HOU,80,1220,10,24,6,4,3,1,2,1,3,2005
232,Michael Olowokandi,MIN,62,1218,29,65,22,7,11,2,9,1,6,2005
233,Jerome Williams,NYK,79,1211,41,89,34,7,14,6,14,2,5,2005
234,Rasual Butler,MIA,65,1199,62,130,56,6,28,6,22,1,5,2005
235,Alan Henderson,DAL,78,1196,21,46,17,4,7,1,9,0,4,2005
236,Boris Diaw,ATL,66,1194,149,324,123,26,55,26,42,7,19,2005
237,Keyon Dooling,MIA,74,1184,132,291,105,27,39,16,50,13,14,2005
238,Eduardo Najera,DEN,68,1183,65,148,47,18,19,8,20,5,13,2005
239,Devin Harris,DAL,76,1176,169,376,131,38,64,14,53,13,25,2005
240,Shandon Anderson,MIA,66,1173,70,156,54,16,31,6,17,6,10,2005
241,Mikki Moore,LAC,74,1172,47,99,42,5,13,6,23,2,3,2005
242,Michael Doleac,MIA,80,1169,47,103,38,9,21,2,15,1,8,2005
243,Brian Scalabrine,NJN,54,1164,88,190,74,14,33,7,34,4,10,2005
244,Beno Udrih,SAS,80,1155,150,339,111,39,50,27,34,23,16,2005
245,Brian Grant,LAL,69,1143,34,79,23,11,6,5,12,1,10,2005
246,Marcus Banks,BOS,81,1142,155,335,130,25,53,22,55,8,17,2005
247,Lindsey Hunter,DET,76,1134,130,277,113,17,54,20,39,7,10,2005
248,Lucious Harris,CLE,73,1127,49,104,43,6,18,9,16,3,3,2005
249,Aaron McKie,PHI,68,1126,103,240,69,34,30,8,31,10,24,2005
250,Toni Kukoc,MIL,53,1100,160,339,141,19,91,18,32,9,10,2005
251,Leandro Barbosa,PHX,63,1085,126,298,80,46,48,10,22,18,28,2005
252,Brian Cook,LAL,72,1082,35,83,22,13,13,3,6,5,8,2005
253,DeShawn Stevenson,ORL,55,1081,69,145,62,7,38,10,14,3,4,2005
254,Willie Green,PHI,57,1067,100,225,75,25,36,7,32,4,21,2005
255,Tierre Brown,LAL,76,1058,155,382,83,72,39,13,31,22,50,2005
256,Juan Dixon,WAS,63,1053,111,255,78,33,31,15,32,6,27,2005
257,Steven Hunter,PHX,76,1051,13,29,10,3,6,1,3,1,2,2005
258,Danny Fortson,SEA,62,1047,8,20,4,4,3,1,0,0,4,2005
259,Al Jefferson,BOS,71,1044,24,53,19,5,10,0,9,1,4,2005
260,Bryon Russell,DEN,70,1026,72,161,55,17,29,8,18,4,13,2005
261,Eddie Gill,IND,73,1014,83,197,52,31,21,7,24,15,16,2005
262,Erick Strickland,MIL,62,1011,115,248,97,18,29,27,41,8,10,2005
263,Chris Wilcox,LAC,54,1007,38,79,35,3,17,11,7,0,3,2005
264,Darrell Armstrong,DAL,66,987,178,398,136,42,52,23,61,11,31,2005
265,John Salmons,PHI,58,985,114,260,82,32,35,17,30,16,16,2005
266,Etan Thomas,WAS,47,979,20,43,17,3,10,0,7,1,2,2005
267,Kareem Rush,CHA,48,965,68,143,61,7,28,9,24,1,6,2005
268,Tom Gugliotta,ATL,47,963,68,144,60,8,49,4,7,2,6,2005
269,Jarron Collins,UTA,50,960,61,124,59,2,34,6,19,0,2,2005
270,Pat Garrity,ORL,71,949,30,69,21,9,8,4,9,2,7,2005
271,Calbert Cheaney,GSW,55,945,64,142,50,14,19,10,21,3,11,2005
272,Brian Skinner,SAC,49,944,43,97,32,11,14,1,17,2,9,2005
273,Jason Collier,ATL,70,942,18,38,16,2,10,0,6,1,1,2005
274,Francisco Elson,DEN,67,940,34,72,30,4,15,4,11,0,4,2005
275,Scott Padgett,HOU,66,939,55,129,36,19,18,7,11,6,13,2005
276,George Lynch,NOH,44,933,88,192,72,16,33,6,33,3,13,2005
277,Zeljko Rebraca,LAC,58,928,26,53,25,1,7,6,12,0,1,2005
278,Lamond Murray,TOR,62,916,47,106,35,12,16,4,15,8,4,2005
279,Kwame Brown,WAS,42,907,39,88,29,10,10,7,12,1,9,2005
280,Marcus Fizer,MIL,54,904,64,146,46,18,25,10,11,3,15,2005
281,Walter McCarty,PHX,72,900,37,88,23,14,12,7,4,8,6,2005
282,Kirk Snyder,UTA,68,900,36,78,30,6,20,4,6,2,4,2005
283,Anfernee Hardaway,NYK,37,895,74,160,62,12,27,7,28,6,6,2005
284,Eddie House,SAC,68,884,96,208,80,16,29,17,34,12,4,2005
285,Shawn Bradley,DAL,77,882,15,38,7,8,3,0,4,0,8,2005
286,Flip Murray,SEA,49,879,65,150,45,20,21,8,16,8,12,2005
287,Kris Humphries,UTA,67,869,43,90,39,4,23,7,9,2,2,2005
288,Anderson Varejao,CLE,54,869,27,57,24,3,11,1,12,3,0,2005
289,Scot Pollard,IND,49,867,18,39,15,3,3,5,7,0,3,2005
290,Sasha Pavlovic,CLE,65,867,49,100,47,2,22,6,19,1,1,2005
291,Curtis Borchardt,UTA,67,856,49,108,39,10,12,1,26,2,8,2005
292,Eric Piatkowski,CHI,68,839,51,110,43,8,18,11,14,4,4,2005
293,Shaun Livingston,LAC,30,820,151,319,134,17,67,24,43,3,14,2005
294,Royal Ivey,ATL,62,813,103,223,86,17,31,13,42,6,11,2005
295,Travis Outlaw,POR,59,793,35,75,30,5,23,3,4,0,5,2005
296,Luke Walton,LAL,61,762,93,204,75,18,51,11,13,6,12,2005
297,David Harrison,IND,43,760,13,29,10,3,6,0,4,1,2,2005
298,Steven Smith,MIA,49,745,71,154,59,12,24,12,23,6,6,2005
299,Kenny Anderson,LAC,43,744,103,223,86,17,42,10,34,5,12,2005
300,Christian Laettner,MIA,49,739,41,90,33,8,27,2,4,4,4,2005
301,Rafael Araujo,TOR,59,736,16,34,14,2,10,1,3,1,1,2005
302,Obinna Ekezie,ATL,42,730,11,22,11,0,8,1,2,0,0,2005
303,Anthony Carter,MIN,66,716,161,339,144,17,59,28,57,4,13,2005
304,Jamaal Magloire,NOH,23,707,29,66,21,8,6,2,13,2,6,2005
305,Jackson Vroman,NOH,46,706,40,87,33,7,15,2,16,0,7,2005
306,Matt Barnes,SAC,43,704,57,122,49,8,9,6,34,3,5,2005
307,Alonzo Mourning,MIA,37,704,18,38,16,2,7,1,8,0,2,2005
308,Loren Woods,TOR,45,703,17,36,15,2,5,4,6,1,1,2005
309,Tony Massenburg,SAS,61,692,14,32,10,4,6,2,2,2,2,2005
310,Rodney White,GSW,58,678,44,96,36,8,16,1,19,4,4,2005
311,Wesley Person,DEN,41,671,39,88,29,10,17,3,9,6,4,2005
312,Adrian Griffin,CHI,69,658,53,121,38,15,18,5,15,4,11,2005
313,Stacey Augmon,ORL,55,654,36,78,30,6,9,1,20,1,5,2005
314,Steve Blake,WAS,44,648,69,153,54,15,28,9,17,3,12,2005
315,Jabari Smith,NJN,45,647,38,86,28,10,10,3,15,1,9,2005
316,Dahntay Jones,MEM,52,644,21,47,16,5,10,1,5,1,4,2005
317,Mark Madsen,MIN,41,602,18,42,12,6,4,1,7,2,4,2005
318,Ryan Bowen,HOU,65,581,18,43,11,7,5,1,5,3,4,2005
319,Greg Ostertag,SAC,56,557,37,87,24,13,10,3,11,5,8,2005
320,Junior Harrington,NOH,29,549,62,136,50,12,16,6,28,2,10,2005
321,David West,NOH,30,549,23,49,20,3,10,2,8,0,3,2005
322,Kendrick Perkins,BOS,60,541,21,44,19,2,11,1,7,0,2,2005
323,Bobby Jackson,SAC,25,540,59,135,42,17,9,9,24,6,11,2005
324,Allan Houston,NYK,20,534,42,86,40,2,15,13,12,0,2,2005
325,Anthony Goldwire,MIL,33,530,78,174,60,18,20,12,28,2,16,2005
326,Viktor Khryapa,POR,32,529,25,58,17,8,13,3,1,4,4,2005
327,Anthony Peeler,WAS,40,527,57,131,40,17,17,6,17,6,11,2005
328,Clar. Weatherspoon,HOU,40,523,17,37,14,3,8,2,4,0,3,2005
329,John Thomas,MIN,44,520,17,38,13,4,3,2,8,1,3,2005
330,Raul Lopez,UTA,31,517,123,262,107,16,49,11,47,10,6,2005
331,Damien Wilkins,SEA,29,516,26,59,19,7,8,6,5,1,6,2005
332,Malik Allen,CHA,36,516,18,41,13,5,6,4,3,1,4,2005
333,Zoran Planinic,NJN,43,510,44,96,36,8,12,4,20,4,4,2005
334,Theron Smith,CHA,33,507,28,63,21,7,9,5,7,4,3,2005
335,Delonte West,BOS,39,505,53,117,42,11,18,6,18,3,8,2005
336,Richie Frahm,POR,43,490,30,65,25,5,14,5,6,3,2,2005
337,Andre Barrett,ORL,38,477,69,153,54,15,25,10,19,3,12,2005
338,Zarko Cabarkapa,GSW,40,475,25,57,18,7,12,1,5,3,4,2005
339,Ronald Dupree,DET,47,466,24,52,20,4,5,5,10,1,3,2005
340,Carlos Delfino,DET,30,462,38,84,30,8,17,3,10,4,4,2005
341,Kevin Martin,SAC,45,458,22,49,17,5,8,1,8,1,4,2005
342,Calvin Booth,MIL,51,454,8,22,2,6,1,0,1,1,5,2005
343,Jannero Pargo,CHI,32,450,76,174,54,22,28,6,20,8,14,2005
344,Matt Freije,NOH,23,437,20,44,16,4,9,2,5,1,3,2005
345,Donta Smith,ATL,38,433,39,83,34,5,20,3,11,0,5,2005
346,Matt Carroll,CHA,25,433,17,37,14,3,5,1,8,1,2,2005
347,Lionel Chalmers,LAC,36,424,51,108,45,6,19,5,21,2,4,2005
348,Slava Medvedenko,LAL,43,421,13,32,7,6,2,4,1,0,6,2005
349,Laron Profit,WAS,42,420,37,85,26,11,11,7,8,4,7,2005
350,Ervin Johnson,MIN,46,409,6,13,5,1,2,0,3,0,1,2005
351,Sasha Vujacic,LAL,35,402,51,123,30,21,15,0,15,8,13,2005
352,Elden Campbell,DET,40,393,19,39,18,1,10,3,5,0,1,2005
353,Ron Mercer,NJN,18,390,20,47,13,7,5,2,6,3,4,2005
354,Andris Biedrins,GSW,30,382,12,31,5,7,2,1,2,3,4,2005
355,Maciej Lampe,NOH,37,379,11,24,9,2,5,1,3,1,1,2005
356,Jake Voskuhl,PHX,38,362,17,39,12,5,6,2,4,3,2,2005
357,Charlie Ward,HOU,14,360,43,98,31,12,8,14,9,3,9,2005
358,Moochie Norris,HOU,38,356,39,83,34,5,10,4,20,2,3,2005
359,Mario Kasun,ORL,44,351,8,17,7,1,6,0,1,0,1,2005
360,Billy Thomas,NJN,25,350,17,41,10,7,2,0,8,1,6,2005
361,Kevin Willis,ATL,29,346,9,22,5,4,3,0,2,0,4,2005
362,Vitaly Potapenko,SEA,33,335,9,21,6,3,3,0,3,0,3,2005
363,Bernard Robinson,CHA,31,329,30,69,21,9,8,3,10,4,5,2005
364,Jamal Sampson,CHA,23,327,8,18,6,2,0,1,5,0,2,2005
365,Josh Davis,PHI,42,319,12,28,8,4,5,1,2,1,3,2005
366,Ryan Humphrey,MEM,35,317,6,14,4,2,4,0,0,1,1,2005
367,Aaron Williams,TOR,42,312,8,17,7,1,2,0,5,0,1,2005
368,Devean George,LAL,15,308,14,32,10,4,7,2,1,0,4,2005
369,DeSagana Diop,CLE,39,305,15,31,14,1,8,1,5,1,0,2005
370,Ben Handlogten,UTA,21,295,13,28,11,2,5,0,6,0,2,2005
371,Metta World Peace,IND,7,290,22,56,10,12,5,2,3,2,10,2005
372,Kendall Gill,MIL,14,284,27,63,18,9,9,5,4,4,5,2005
373,Jake Tsakalidis,MEM,31,281,10,23,7,3,4,0,3,3,0,2005
374,Mike Wilks,SAS,48,269,33,74,25,8,10,6,9,3,5,2005
375,Darvin Ham,DET,47,256,5,10,5,0,3,1,1,0,0,2005
376,Darko Milicic,DET,37,252,7,15,6,1,5,1,0,1,0,2005
377,Michael Curry,IND,18,252,15,31,14,1,6,4,4,0,1,2005
378,Pape Sow,TOR,27,252,2,5,1,1,0,1,0,0,1,2005
379,Kerry Kittles,LAC,11,243,20,43,17,3,10,2,5,1,2,2005
380,Sean Marks,SAS,23,242,8,20,4,4,0,3,1,1,3,2005
381,Randy Livingston,UTA,17,230,45,94,41,4,20,5,16,3,1,2005
382,Jermaine Jackson,NYK,21,225,24,52,20,4,11,2,7,2,2,2005
383,Antonio Burks,MEM,24,217,28,64,20,8,7,5,8,3,5,2005
384,Brandon Hunter,ORL,31,217,3,6,3,0,3,0,0,0,0,2005
385,Bo Outlaw,PHX,39,215,13,30,9,4,5,0,4,4,0,2005
386,Nikoloz Tskitishvili,GSW,35,214,10,22,8,2,5,0,3,1,1,2005
387,Vin Baker,HOU,27,203,10,22,8,2,4,1,3,2,0,2005
388,Cory Alexander,CHA,16,198,37,80,31,6,9,1,21,2,4,2005
389,Rod Strickland,HOU,16,197,39,87,30,9,8,5,17,3,6,2005
390,Darrick Martin,LAC,11,190,28,58,26,2,8,5,13,0,2,2005
391,Reece Gaines,MIL,21,180,7,18,3,4,1,0,2,1,3,2005
392,Jamison Brewer,NYK,18,180,12,26,10,2,3,0,7,0,2,2005
393,Zendon Hamilton,MIL,16,161,6,12,6,0,4,1,1,0,0,2005
394,Kevin Ollie,PHI,26,160,19,45,12,7,4,4,4,1,6,2005
395,Glenn Robinson,SAS,9,158,8,20,4,4,2,1,1,2,2,2005
396,Scott Williams,CLE,19,152,8,17,7,1,2,2,3,0,1,2005
397,Damone Brown,WAS,14,151,14,31,11,3,7,1,3,2,1,2005
398,Alex Garcia,NOH,8,146,18,39,15,3,3,4,8,1,2,2005
399,Michael Stewart,ATL,12,143,5,12,3,2,0,1,2,1,1,2005
400,Smush Parker,PHX,16,140,15,33,12,3,7,3,2,0,3,2005
401,Samaki Walker,WAS,14,136,4,8,4,0,1,1,2,0,0,2005
402,John Edwards,IND,25,133,3,7,2,1,1,0,1,0,1,2005
403,Jahidi White,CHA,17,133,1,3,0,1,0,0,0,0,1,2005
404,Jared Reiner,CHI,19,132,1,2,1,0,0,0,1,0,0,2005
405,Vlade Divac,LAL,15,131,19,43,14,5,8,1,5,0,5,2005
406,Aleksandar Radojevic,UTA,12,128,6,12,6,0,2,0,4,0,0,2005
407,Ansu Sesay,GSW,16,128,12,26,10,2,1,1,8,1,1,2005
408,Jerome Moiso,CLE,20,118,1,3,0,1,0,0,0,1,0,2005
409,Michael Bradley,PHI,18,115,5,12,3,2,2,1,0,0,2,2005
410,Mark Jones,ORL,10,115,6,13,5,1,1,1,3,0,1,2005
411,Justin Reed,BOS,23,115,10,23,7,3,3,1,3,1,2,2005
412,James Thomas,ATL,11,113,4,8,4,0,3,1,0,0,0,2005
413,Corsley Edwards,NOH,10,110,3,6,3,0,0,0,3,0,0,2005
414,Marcus Haislip,IND,9,105,3,7,2,1,2,0,0,0,1,2005
415,Daniel Santiago,MIL,11,105,1,2,1,0,1,0,0,0,0,2005
416,Dajuan Wagner,CLE,11,102,13,30,9,4,4,1,4,2,2,2005
417,Horace Jenkins,DET,15,101,9,18,9,0,3,1,5,0,0,2005
418,Ha Ha,POR,19,100,2,5,1,1,0,0,1,0,1,2005
419,Jonathan Bender,IND,7,92,4,9,3,1,1,0,2,0,1,2005
420,Wang Zhi-zhi,MIA,20,91,5,10,5,0,1,0,4,0,0,2005
421,Jelani McCoy,ATL,10,86,0,0,0,0,0,0,0,0,0,2005
422,Britton Johnsen,IND,6,84,4,10,2,2,2,0,0,0,2,2005
423,Tamar Slay,CHA,8,77,3,7,2,1,1,0,1,1,0,2005
424,Luis Flores,DEN,16,74,11,25,8,3,6,0,2,0,3,2005
425,Omar Cook,TOR,5,73,22,48,18,4,8,2,8,2,2,2005
426,Mamadou N'diaye,LAC,11,73,1,2,1,0,0,1,0,0,0,2005
427,Erik Daniels,SAC,21,71,4,9,3,1,3,0,0,0,1,2005
428,Frank Williams,CHI,9,70,11,23,10,1,6,1,3,0,1,2005
429,Robert Swift,SEA,16,70,2,4,2,0,1,0,1,0,0,2005
430,Bruno Sundov,NYK,21,68,2,4,2,0,2,0,0,0,0,2005
431,Dion Glover,SAS,7,66,4,10,2,2,1,1,0,2,0,2005
432,Mateen Cleaves,SEA,14,64,7,15,6,1,3,0,3,0,1,2005
433,DJ Mbenga,DAL,15,57,0,0,0,0,0,0,0,0,0,2005
434,Voshon Lenard,DEN,3,56,6,13,5,1,1,0,4,1,0,2005
435,Kaniel Dickens,NJN,11,54,1,3,0,1,0,0,0,1,0,2005
436,Kedrick Brown,PHI,8,54,4,8,4,0,4,0,0,0,0,2005
437,Ndudi Ebi,MIN,2,54,1,2,1,0,0,1,0,0,0,2005
438,Tremaine Fowlkes,IND,8,51,0,0,0,0,0,0,0,0,0,2005
439,Andrew DeClercq,ORL,8,51,0,0,0,0,0,0,0,0,0,2005
440,Derrick Coleman,DET,5,49,0,0,0,0,0,0,0,0,0,2005
441,Luke Jackson,CLE,10,43,3,6,3,0,0,2,1,0,0,2005
442,Qyntel Woods,MIA,3,39,0,0,0,0,0,0,0,0,0,2005
443,Lonny Baxter,NOH,4,36,0,0,0,0,0,0,0,0,0,2005
444,Paul Shirley,PHX,9,30,3,8,1,2,1,0,0,2,0,2005
445,Dorell Wright,MIA,3,28,3,6,3,0,2,1,0,0,0,2005
446,Awvee Storey,NJN,9,27,1,2,1,0,1,0,0,0,0,2005
447,Andre Emmett,MEM,8,26,0,0,0,0,0,0,0,0,0,2005
448,Mark Pope,DEN,9,25,1,2,1,0,1,0,0,0,0,2005
449,Torraye Braggs,HOU,7,22,0,0,0,0,0,0,0,0,0,2005
450,Lawrence Funderburke,CHI,2,22,0,0,0,0,0,0,0,0,0,2005
451,Peter John Ramos,WAS,6,20,0,0,0,0,0,0,0,0,0,2005
452,Maurice Baker,POR,5,19,1,3,0,1,0,0,0,0,1,2005
453,Yuta Tabuse,PHX,4,17,3,7,2,1,2,0,0,0,1,2005
454,Donnell Harvey,NJN,3,16,1,2,1,0,0,0,1,0,0,2005
455,Geno Carlisle,POR,6,15,1,2,1,0,0,0,1,0,0,2005
456,Linton Johnson,SAS,2,15,0,0,0,0,0,0,0,0,0,2005
457,Kirk Penney,LAC,4,12,1,3,0,1,0,0,0,0,1,2005
458,Tony Bobbitt,LAL,2,12,0,0,0,0,0,0,0,0,0,2005
459,Ibrahim Kutluay,SEA,5,11,0,0,0,0,0,0,0,0,0,2005
460,Anthony Miller,ATL,2,10,1,2,1,0,1,0,0,0,0,2005
461,Pavel Podkolzin,DAL,5,8,0,0,0,0,0,0,0,0,0,2005
462,Jackie Butler,NYK,3,4,0,0,0,0,0,0,0,0,0,2005
463,Brandin Knight,HOU,1,3,1,2,1,0,0,0,1,0,0,2005
0,Joe Johnson,PHX,82,3334,362,831,255,107,113,53,89,42,65,2004
1,Peja Stojakovic,SAC,81,3269,173,381,138,35,54,13,71,11,24,2004
2,Stephon Marbury,NYK,81,3255,719,1576,581,138,233,102,246,71,67,2004
3,Cuttino Mobley,HOU,80,3236,258,582,192,66,95,34,63,33,33,2004
4,Kevin Garnett,MIN,82,3235,409,908,319,90,114,64,141,33,57,2004
5,Shawn Marion,PHX,79,3210,214,477,165,49,83,25,57,18,31,2004
6,Steve Francis,HOU,79,3197,493,1130,349,144,167,61,121,55,89,2004
7,Richard Jefferson,NJN,82,3136,315,679,266,49,142,30,94,8,41,2004
8,LeBron James,CLE,79,3127,465,983,412,53,186,78,148,29,24,2004
9,Damon Stoudamire,POR,82,3123,500,1072,428,72,191,107,130,18,54,2004
10,Jim Jackson,HOU,80,3120,226,488,190,36,75,63,52,19,17,2004
11,Latrell Sprewell,MIN,82,3101,286,605,253,33,84,70,99,5,28,2004
12,Paul Pierce,BOS,80,3100,410,973,257,153,138,36,83,61,92,2004
13,Zach Randolph,POR,81,3072,163,360,129,34,66,25,38,4,30,2004
14,Ben Wallace,DET,81,3060,138,299,115,23,69,20,26,8,15,2004
15,Michael Redd,MIL,82,3020,185,407,148,37,67,30,51,12,25,2004
16,Jason Terry,ATL,81,3013,437,957,354,83,170,60,124,27,56,2004
17,Lamar Odom,MIA,80,3002,327,739,242,85,129,19,94,25,60,2004
18,Eddie Jones,MIA,81,3001,258,550,224,34,97,26,101,10,24,2004
19,Carmelo Anthony,DEN,82,2991,227,490,191,36,113,27,51,19,17,2004
20,Mike Bibby,SAC,82,2983,444,982,350,94,178,35,137,34,60,2004
21,Donyell Marshall,TOR,82,2982,122,284,82,40,41,10,31,24,16,2004
22,Eric Snow,PHI,82,2976,563,1246,443,120,182,66,195,48,72,2004
23,Stephen Jackson,ATL,80,2943,244,522,210,34,124,33,53,13,21,2004
24,Jason Richardson,GSW,78,2941,226,510,168,58,77,36,55,22,36,2004
25,Rashard Lewis,SEA,80,2934,175,434,91,84,39,19,33,25,59,2004
26,Dirk Nowitzki,DAL,77,2920,207,456,165,42,92,38,35,16,26,2004
27,Andrei Kirilenko,UTA,78,2906,244,508,224,20,120,16,88,10,10,2004
28,Juwan Howard,ORL,81,2884,158,363,111,47,50,17,44,13,34,2004
29,Sam Cassell,MIN,81,2848,592,1248,528,64,161,121,246,24,40,2004
30,Kerry Kittles,NJN,82,2847,206,465,153,53,65,22,66,16,37,2004
31,Andre Miller,DEN,82,2847,501,1071,432,69,271,28,133,26,43,2004
32,Clifford Robinson,GSW,82,2842,271,588,225,46,113,48,64,17,29,2004
33,Antoine Walker,DAL,82,2837,369,810,297,72,140,45,112,18,54,2004
34,Gary Payton,LAL,82,2836,449,974,373,76,172,69,132,21,55,2004
35,Jamal Crawford,CHI,80,2814,405,891,324,81,155,53,116,28,53,2004
36,Jamaal Magloire,NOH,82,2795,86,196,62,24,25,5,32,5,19,2004
37,Jermaine O'Neal,IND,78,2789,164,372,120,44,68,9,43,23,21,2004
38,Vince Carter,TOR,73,2787,348,799,245,103,100,28,117,73,30,2004
39,Richard Hamilton,DET,78,2785,310,687,243,67,137,44,62,27,40,2004
40,Doug Christie,SAC,82,2783,347,785,256,91,140,23,93,37,54,2004
41,Michael Finley,DAL,72,2782,212,480,156,56,77,24,55,8,48,2004
42,Chauncey Billups,DET,78,2772,446,934,404,42,187,80,137,18,24,2004
43,P.J. Brown,NOH,80,2757,155,338,127,28,57,17,53,9,19,2004
44,Metta World Peace,IND,73,2716,272,608,208,64,101,40,67,30,34,2004
45,Kirk Hinrich,CHI,76,2709,517,1108,443,74,147,90,206,28,46,2004
46,Kenny Thomas,PHI,74,2704,111,257,76,35,38,16,22,12,23,2004
47,Yao Ming,HOU,82,2702,122,295,71,51,38,4,29,14,37,2004
48,Tayshaun Prince,DET,82,2697,191,413,160,31,78,33,49,6,25,2004
49,Shareef Abdur-Rahim,POR,85,2690,174,390,132,42,65,20,47,14,28,2004
50,Tracy McGrady,ORL,67,2688,370,802,308,62,126,73,109,28,34,2004
51,Baron Davis,NOH,67,2687,501,1105,398,103,203,56,139,41,62,2004
52,Elton Brand,LAC,69,2675,227,504,177,50,82,19,76,6,44,2004
53,Theo Ratliff,POR,85,2662,71,161,52,19,26,6,20,1,18,2004
54,Corey Maggette,LAC,73,2630,224,482,190,34,85,50,55,9,25,2004
55,Bruce Bowen,SAS,82,2627,113,242,97,16,41,22,34,4,12,2004
56,Brad Miller,SAC,72,2627,312,695,241,71,121,26,94,17,54,2004
57,Steve Nash,DAL,78,2616,687,1532,529,158,262,95,172,25,133,2004
58,Carlos Boozer,CLE,75,2598,148,317,127,21,51,27,49,4,17,2004
59,Rafer Alston,MIA,82,2585,372,841,275,97,112,33,130,31,66,2004
60,Tony Parker,SAS,75,2579,411,927,306,105,118,62,126,62,43,2004
61,Antonio Davis,CHI,80,2579,137,317,94,43,33,24,37,11,32,2004
62,Zydrunas Ilgauskas,CLE,81,2543,109,237,90,19,40,15,35,5,14,2004
63,Kurt Thomas,NYK,80,2542,149,341,106,43,48,25,33,13,30,2004
64,Desmond Mason,MIL,82,2535,152,340,116,36,57,26,33,12,24,2004
65,Tim Duncan,SAS,69,2525,213,475,164,49,87,23,54,18,31,2004
66,Chris Bosh,TOR,75,2517,78,178,56,22,25,7,24,11,11,2004
67,Jalen Rose,TOR,66,2512,329,739,248,81,104,36,108,34,47,2004
68,Nene,DEN,77,2512,168,361,143,25,81,12,50,7,18,2004
69,Ricky Davis,BOS,79,2474,259,587,190,69,94,33,63,24,45,2004
70,Shaquille O'Neal,LAL,67,2466,196,431,157,39,90,18,49,0,39,2004
71,Jason Kidd,NJN,67,2464,618,1310,544,74,341,63,140,13,61,2004
72,Pau Gasol,MEM,78,2452,198,455,139,59,92,27,20,16,43,2004
73,Kobe Bryant,LAL,65,2447,330,719,271,59,171,43,57,26,33,2004
74,DeShawn Stevenson,ORL,80,2444,158,335,139,19,78,16,45,5,14,2004
75,James Posey,MEM,82,2443,122,282,84,38,40,20,24,2,36,2004
76,Al Harrington,IND,79,2441,131,307,86,45,46,12,28,24,21,2004
77,Erick Dampier,GSW,74,2408,60,144,36,24,18,5,13,4,20,2004
78,Mark Blount,BOS,82,2405,75,173,52,23,32,3,17,8,15,2004
79,Rasheed Wallace,DET,68,2394,156,341,127,29,66,31,30,8,21,2004
80,Antawn Jamison,DAL,82,2379,70,162,48,22,29,4,15,6,16,2004
81,Jeff McInnis,CLE,70,2377,430,916,374,56,162,107,105,12,44,2004
82,Rasho Nesterovic,SAS,82,2359,114,250,92,22,51,11,30,4,18,2004
83,Keith Van Horn,MIL,72,2342,120,268,92,28,40,24,28,6,22,2004
84,Mike Dunleavy,GSW,75,2341,220,484,176,44,102,18,56,7,37,2004
85,Quentin Richardson,LAC,65,2340,139,303,114,25,63,21,30,4,21,2004
86,Tyronn Lue,ORL,76,2336,317,696,255,62,70,37,148,14,48,2004
87,Vladimir Radmanovic,SEA,77,2322,142,336,90,52,56,16,18,28,24,2004
88,Vlade Divac,SAC,81,2314,432,991,305,127,159,24,122,42,85,2004
89,Brian Grant,MIA,76,2302,69,162,45,24,26,6,13,3,21,2004
90,Reggie Miller,IND,80,2267,249,527,220,29,97,71,52,10,19,2004
91,Trenton Hassell,MIN,81,2263,133,291,108,25,33,29,46,6,19,2004
92,Kenyon Martin,NJN,65,2259,160,348,132,28,69,10,53,7,21,2004
93,Joe Smith,MIL,76,2259,78,173,61,17,23,27,11,7,10,2004
94,Manu Ginobili,SAS,77,2255,291,640,233,58,118,37,78,37,21,2004
95,Darrell Armstrong,NOH,79,2245,311,695,238,73,116,30,92,29,44,2004
96,Voshon Lenard,DEN,73,2244,151,318,135,16,81,15,39,0,16,2004
97,Kwame Brown,WAS,74,2230,112,248,88,24,43,16,29,3,21,2004
98,Jason Collins,NJN,78,2225,153,335,124,29,49,14,61,4,25,2004
99,Samuel Dalembert,PHI,82,2204,21,47,16,5,10,2,4,2,3,2004
100,Mike James,DET,81,2196,339,757,260,79,118,43,99,29,50,2004
101,Jiri Welsch,BOS,81,2185,183,416,133,50,52,31,50,20,30,2004
102,Marcus Camby,DEN,72,2165,132,281,115,17,78,12,25,4,13,2004
103,Eddy Curry,CHI,73,2158,68,155,49,19,17,8,24,2,17,2004
104,Ray Allen,SEA,56,2157,268,623,181,87,97,39,45,21,66,2004
105,Greg Ostertag,UTA,78,2153,123,252,117,6,32,6,79,1,5,2004
106,Morris Peterson,TOR,82,2139,113,259,80,33,33,16,31,13,20,2004
107,Drew Gooden,ORL,79,2137,89,204,63,26,33,10,20,9,17,2004
108,Dwyane Wade,MIA,61,2136,275,647,178,97,78,21,79,24,73,2004
109,Aaron McKie,PHI,75,2117,195,419,166,29,85,26,55,6,23,2004
110,Jason Williams,MEM,72,2111,492,1057,419,73,211,74,134,17,56,2004
111,Anfernee Hardaway,NYK,76,2095,176,385,143,33,72,27,44,13,20,2004
112,Tim Thomas,NYK,66,2089,124,275,97,27,25,30,42,9,18,2004
113,Maurice Taylor,HOU,75,2081,107,232,89,18,59,15,15,6,12,2004
114,Darius Miles,POR,79,2080,162,349,137,25,77,17,43,12,13,2004
115,Hedo Turkoglu,SAS,80,2080,154,334,128,26,61,28,39,11,15,2004
116,Larry Hughes,WAS,61,2067,148,324,120,28,65,17,38,9,19,2004
117,Gilbert Arenas,WAS,55,2067,275,605,220,55,121,36,63,19,36,2004
118,Calbert Cheaney,GSW,79,2062,136,307,101,35,53,15,33,16,19,2004
119,Allen Iverson,PHI,48,2047,324,695,277,47,140,55,82,27,20,2004
120,Jarvis Hayes,WAS,70,2044,106,241,77,29,45,11,21,9,20,2004
121,Gordan Giricek,UTA,73,2041,122,282,84,38,35,24,25,8,30,2004
122,Caron Butler,MIA,68,2026,126,296,82,44,29,11,42,19,25,2004
123,Amar'e Stoudemire,PHX,55,2025,78,172,62,16,35,6,21,7,9,2004
124,Flip Murray,SEA,82,2025,205,472,143,62,81,20,42,15,47,2004
125,Raja Bell,UTA,82,2021,107,234,87,20,40,5,42,5,15,2004
126,Damon Jones,MIL,82,2009,478,1046,388,90,181,79,128,24,66,2004
127,David Wesley,NOH,61,2006,175,392,133,42,69,24,40,10,32,2004
128,Carlos Arroyo,UTA,71,2003,355,756,309,46,153,25,131,15,31,2004
129,Shandon Anderson,NYK,80,1966,122,270,96,26,38,23,35,8,18,2004
130,Jeff Foster,IND,82,1953,64,147,45,19,21,11,13,8,11,2004
131,Devean George,LAL,82,1953,112,243,93,19,38,21,34,7,12,2004
132,Shane Battier,MEM,79,1948,101,220,83,18,41,19,23,5,13,2004
133,Jared Jeffries,WAS,82,1917,93,219,60,33,32,9,19,7,26,2004
134,Boris Diaw,ATL,76,1915,182,411,135,47,60,24,51,20,27,2004
135,Etan Thomas,WAS,79,1900,68,154,50,18,16,7,27,6,12,2004
136,Walter McCarty,BOS,77,1898,124,274,98,26,48,17,33,7,19,2004
137,Eric Williams,CLE,71,1881,120,263,97,23,44,22,31,7,16,2004
138,Bonzi Wells,MEM,72,1872,139,307,110,29,56,19,35,7,22,2004
139,Chris Kaman,LAC,82,1850,85,179,76,9,51,8,17,3,6,2004
140,Earl Boykins,DEN,82,1838,295,646,239,56,99,31,109,12,44,2004
141,Casey Jacobsen,PHX,78,1831,98,231,63,35,42,7,14,13,22,2004
142,Derek Anderson,POR,51,1813,228,506,178,50,90,32,56,6,44,2004
143,Brent Barry,SEA,59,1803,342,777,249,93,121,52,76,34,59,2004
144,Udonis Haslem,MIA,75,1797,51,123,30,21,13,4,13,4,17,2004
145,Fred Hoiberg,MIN,79,1795,109,234,93,16,26,31,36,4,12,2004
146,Allan Houston,NYK,50,1794,99,218,79,20,21,24,34,3,17,2004
147,Keith Bogans,ORL,73,1786,98,210,84,14,30,13,41,1,13,2004
148,Mike Miller,MEM,65,1765,232,519,177,55,77,43,57,19,36,2004
149,Marko Jaric,LAC,58,1760,281,613,230,51,105,48,77,7,44,2004
150,Derek Fisher,LAL,82,1759,187,403,158,29,84,19,55,2,27,2004
151,Kelvin Cato,HOU,69,1747,72,163,53,19,33,6,14,8,11,2004
152,Alvin Williams,TOR,56,1737,224,501,171,53,64,34,73,28,25,2004
153,Jarron Collins,UTA,81,1731,77,160,71,6,24,7,40,1,5,2004
154,George Lynch,NOH,78,1691,117,258,93,24,43,16,34,7,17,2004
155,Dale Davis,POR,76,1684,72,164,52,20,15,15,22,3,17,2004
156,Lorenzen Wright,MEM,65,1677,71,160,53,18,36,6,11,5,13,2004
157,Earl Watson,MEM,81,1673,402,860,346,56,170,39,137,31,25,2004
158,Bob Sura,ATL,80,1657,233,530,169,64,78,17,74,22,42,2004
159,Ruben Patterson,POR,73,1652,139,311,106,33,66,10,30,14,19,2004
160,Dion Glover,TOR,69,1642,130,289,101,29,40,21,40,16,13,2004
161,Brian Cardinal,GSW,76,1631,103,224,85,18,46,13,26,4,14,2004
162,Jerome Williams,CHI,68,1624,72,158,58,14,25,11,22,3,11,2004
163,Raul Lopez,UTA,82,1622,305,657,258,47,136,26,96,13,34,2004
164,Bo Outlaw,MEM,82,1614,90,200,70,20,47,9,14,7,13,2004
165,Nazr Mohammed,NYK,80,1611,36,72,36,0,20,5,11,0,0,2004
166,Anthony Johnson,IND,73,1603,202,453,153,49,71,22,60,12,37,2004
167,Jake Voskuhl,PHX,66,1599,57,123,48,9,26,10,12,3,6,2004
168,Speedy Claxton,GSW,60,1594,267,616,185,82,59,26,100,23,59,2004
169,John Salmons,PHI,77,1588,134,294,108,26,48,18,42,11,15,2004
170,Mehmet Okur,DET,71,1588,69,156,51,18,24,11,16,7,11,2004
171,Josh Howard,DAL,67,1586,97,214,77,20,36,11,30,5,15,2004
172,Brian Skinner,MIL,56,1580,49,107,40,9,18,7,15,2,7,2004
173,Corliss Williamson,DET,79,1574,57,122,49,8,28,13,8,3,5,2004
174,Chucky Atkins,BOS,64,1539,223,482,187,36,102,30,55,7,29,2004
175,Stromile Swift,MEM,77,1530,38,86,28,10,21,4,3,6,4,2004
176,Antonio Daniels,SEA,71,1516,298,715,179,119,67,34,78,40,79,2004
177,Toni Kukoc,MIL,73,1515,200,432,168,32,94,35,39,9,23,2004
178,Lucious Harris,NJN,69,1504,135,303,102,33,53,10,39,15,18,2004
179,Leandro Barbosa,PHX,70,1501,165,359,136,29,62,25,49,20,9,2004
180,Fred Jones,IND,81,1500,173,379,140,33,51,26,63,13,20,2004
181,Dikembe Mutombo,NYK,65,1499,25,55,20,5,5,4,11,0,5,2004
182,Brendan Haywood,WAS,77,1493,43,97,32,11,11,3,18,2,9,2004
183,T.J. Ford,MIL,55,1484,356,775,293,63,140,67,86,19,44,2004
184,Juan Dixon,WAS,71,1475,137,303,108,29,58,14,36,8,21,2004
185,Tony Battie,CLE,73,1475,58,129,45,13,17,14,14,2,11,2004
186,Howard Eisley,PHX,67,1459,273,600,219,54,83,35,101,28,26,2004
187,Slava Medvedenko,LAL,68,1449,57,126,45,12,16,3,26,3,9,2004
188,Vitaly Potapenko,SEA,65,1423,53,125,34,19,21,4,9,4,15,2004
189,Stacey Augmon,NOH,69,1419,85,196,59,26,22,10,27,5,21,2004
190,Rodney Rogers,NJN,69,1414,137,295,116,21,66,13,37,8,13,2004
191,Kendall Gill,CHI,56,1409,89,194,73,16,36,12,25,3,13,2004
192,Kevin Ollie,CLE,82,1390,234,505,197,37,77,35,85,12,25,2004
193,Steve Blake,WAS,75,1387,209,468,159,50,89,23,47,20,30,2004
194,Anthony Peeler,SAC,75,1383,120,269,91,29,51,5,35,18,11,2004
195,Karl Malone,LAL,42,1380,163,345,144,19,107,15,22,3,16,2004
196,Marcus Banks,BOS,81,1377,175,387,138,37,71,15,52,10,27,2004
197,Jamaal Tinsley,IND,52,1376,303,662,247,56,131,36,80,13,43,2004
198,Bobby Simmons,LAC,56,1373,96,211,77,19,48,14,15,1,18,2004
199,Glenn Robinson,PHI,42,1345,57,122,49,8,26,8,15,2,6,2004
200,Chris Wilcox,LAC,65,1340,51,107,46,5,33,3,10,0,5,2004
201,Aaron Williams,NJN,72,1336,81,172,71,10,51,5,15,3,7,2004
202,Chris Mihm,BOS,76,1328,21,46,17,4,12,1,4,0,4,2004
203,Vin Baker,NYK,54,1321,66,151,47,19,19,6,22,4,15,2004
204,Robert Horry,SAS,81,1288,101,225,78,23,42,14,22,7,16,2004
205,Reggie Evans,SEA,75,1286,33,75,24,9,11,6,7,1,8,2004
206,Jacque Vaughn,ATL,71,1265,195,431,154,41,64,23,67,17,24,2004
207,Nick Van Exel,GSW,39,1257,206,458,160,46,94,24,42,8,38,2004
208,Malik Rose,SAS,67,1254,69,154,53,16,33,10,10,8,8,2004
209,Charlie Ward,SAS,71,1253,215,462,183,32,67,37,79,12,20,2004
210,Dan Gadzuric,MIL,75,1252,28,62,22,6,9,7,6,0,6,2004
211,Kareem Rush,LAL,72,1248,59,129,48,11,12,9,27,4,7,2004
212,Ira Newble,CLE,64,1245,72,153,63,9,24,14,25,4,5,2004
213,Mark Madsen,MIN,72,1243,28,61,23,5,6,3,14,1,4,2004
214,Michael Curry,TOR,70,1223,53,122,37,16,14,8,15,8,8,2004
215,Chris Crawford,ATL,56,1209,45,103,32,13,13,5,14,6,7,2004
216,Andrew DeClercq,ORL,71,1209,44,104,28,16,12,4,12,2,14,2004
217,Milt Palacio,TOR,59,1207,184,423,129,55,44,16,69,31,24,2004
218,Rod Strickland,TOR,61,1202,244,531,201,43,80,31,90,8,35,2004
219,Calvin Booth,SEA,71,1198,28,69,15,13,6,2,7,5,8,2004
220,Bobby Jackson,SAC,50,1189,105,228,87,18,39,11,37,5,13,2004
221,Eddie House,LAC,60,1181,148,311,133,15,68,28,37,4,11,2004
222,Sasha Pavlovic,UTA,79,1136,60,123,57,3,22,5,30,1,2,2004
223,Keyon Dooling,LAC,58,1132,130,289,101,29,54,12,35,5,24,2004
224,Matt Harpring,UTA,31,1131,63,139,50,13,15,4,31,4,9,2004
225,Luke Ridnour,SEA,69,1113,163,382,107,56,56,15,36,22,34,2004
226,Horace Grant,LAL,55,1110,71,155,58,13,15,11,32,3,10,2004
227,Jon Barry,DEN,57,1090,147,315,126,21,74,14,38,0,21,2004
228,Austin Croshere,IND,77,1043,52,119,37,15,15,6,16,7,8,2004
229,Corie Blount,TOR,62,1043,55,124,41,14,20,2,19,1,13,2004
230,Doug Overton,LAC,61,1036,138,299,115,23,39,21,55,1,22,2004
231,Wesley Person,ATL,58,1035,66,143,55,11,22,11,22,5,6,2004
232,Marquis Daniels,DAL,56,1034,116,254,94,22,37,14,43,7,15,2004
233,Brevin Knight,MIL,56,1033,204,436,176,28,104,18,54,4,24,2004
234,Chris Andersen,DEN,71,1029,35,72,33,2,17,4,12,0,2,2004
235,Michael Doleac,DEN,72,1025,44,97,35,9,15,10,10,0,9,2004
236,Eddie Robinson,CHI,51,1023,58,122,52,6,22,13,17,1,5,2004
237,Gary Trent,MIN,68,1022,49,110,37,12,17,5,15,3,9,2004
238,Jerome James,SEA,65,992,32,85,11,21,6,1,4,4,17,2004
239,Rodney White,DEN,72,987,60,130,50,10,23,5,22,1,9,2004
240,Christian Laettner,WAS,48,983,89,197,70,19,37,11,22,5,14,2004
241,Darius Songaila,SAC,73,974,48,113,31,17,10,1,20,6,11,2004
242,Ervin Johnson,MIN,66,970,24,55,17,7,6,0,11,1,6,2004
243,Kedrick Brown,CLE,55,969,64,137,55,9,25,14,16,2,7,2004
244,Predrag Drobnjak,LAC,61,952,39,88,29,10,14,2,13,0,10,2004
245,Robert Traylor,NOH,71,939,43,104,25,18,8,5,12,3,15,2004
246,Bryon Russell,LAL,72,935,71,155,58,13,21,13,24,3,10,2004
247,Antonio McDyess,PHX,42,930,36,82,26,10,13,5,8,4,6,2004
248,David West,NOH,71,929,60,135,45,15,21,4,20,3,12,2004
249,Michael Olowokandi,MIN,43,925,24,56,16,8,2,2,12,1,7,2004
250,Steven Smith,NOH,71,922,56,122,46,10,21,8,17,1,9,2004
251,Brian Scalabrine,NJN,69,917,65,143,52,13,24,3,25,4,9,2004
252,Kenny Anderson,IND,44,910,125,277,98,27,46,18,34,10,17,2004
253,Ronald Dupree,CHI,47,902,55,128,37,18,17,7,13,1,17,2004
254,Elden Campbell,DET,65,899,45,95,40,5,21,7,12,1,4,2004
255,Francisco Elson,DEN,62,876,32,68,28,4,7,7,14,2,2,2004
256,Clar. Weatherspoon,HOU,52,872,30,70,20,10,13,3,4,1,9,2004
257,Othella Harrington,NYK,56,871,29,65,22,7,5,6,11,3,4,2004
258,Jahidi White,PHX,62,868,7,15,6,1,4,0,2,0,1,2004
259,Kyle Korver,PHI,74,862,40,84,36,4,20,10,6,2,2,2004
260,Rick Fox,LAL,38,846,98,203,91,7,49,18,24,3,4,2004
261,Derrick Coleman,PHI,34,846,46,101,37,9,17,10,10,3,6,2004
262,Moochie Norris,NYK,66,844,121,269,94,27,33,20,41,10,17,2004
263,Chris Webber,SAC,23,833,105,236,79,26,42,9,28,10,16,2004
264,Tom Gugliotta,UTA,55,818,63,140,49,14,22,8,19,3,11,2004
265,Steven Hunter,ORL,59,790,12,29,7,5,2,2,3,0,5,2004
266,Donnell Harvey,PHX,60,789,21,43,20,1,14,1,5,0,1,2004
267,Tyson Chandler,CHI,35,787,23,49,20,3,12,2,6,0,3,2004
268,Tony Massenburg,SAC,59,783,29,63,24,5,10,3,11,2,3,2004
269,Lee Nailon,CLE,57,779,38,81,33,5,23,6,4,2,3,2004
270,Jerry Stackhouse,WAS,26,775,103,237,72,31,47,12,13,5,26,2004
271,Mo Williams,UTA,57,773,76,165,63,13,36,4,23,6,7,2004
272,Willie Green,PHI,53,767,53,112,47,6,19,11,17,0,6,2004
273,Lonny Baxter,WAS,62,764,20,44,16,4,7,1,8,3,1,2004
274,Shawn Bradley,DAL,66,763,20,43,17,3,8,2,7,0,3,2004
275,Travis Best,DAL,61,762,112,238,98,14,39,13,46,3,11,2004
276,Shammond Williams,NOH,53,760,116,251,97,19,43,19,35,3,16,2004
277,Mickael Pietrus,GSW,53,752,27,64,17,10,11,2,4,3,7,2004
278,Marcus Fizer,CHI,46,741,43,99,30,13,12,3,15,5,8,2004
279,Linton Johnson,CHI,41,732,27,59,22,5,8,4,10,1,4,2004
280,Jamal Mashburn,NOH,19,730,47,114,27,20,11,7,9,8,12,2004
281,Michael Ruffin,UTA,41,729,41,86,37,4,12,3,22,2,2,2004
282,DeSagana Diop,CLE,56,722,34,70,32,2,13,11,8,1,1,2004
283,Matt Barnes,LAC,38,720,48,100,44,4,20,5,19,1,3,2004
284,Eduardo Najera,DAL,58,720,25,54,21,4,13,2,6,1,3,2004
285,Luke Walton,LAL,72,718,113,250,89,24,59,13,17,5,19,2004
286,Frank Williams,NYK,56,713,121,268,95,26,33,15,47,8,18,2004
287,Dajuan Wagner,CLE,44,710,51,107,46,5,14,10,22,1,4,2004
288,Daniel Santiago,MIL,54,709,24,54,18,6,9,4,5,0,6,2004
289,Eric Piatkowski,HOU,49,702,26,62,16,10,4,4,8,4,6,2004
290,Greg Buckner,PHI,53,697,45,99,36,9,18,5,13,2,7,2004
291,Scot Pollard,IND,61,679,10,23,7,3,2,0,5,0,3,2004
292,Rasual Butler,MIA,45,675,23,54,15,8,9,3,3,3,5,2004
293,Qyntel Woods,POR,62,665,46,98,40,6,15,11,14,1,5,2004
294,Jason Hart,SAS,53,663,81,184,59,22,24,8,27,7,15,2004
295,Zaza Pachulia,ORL,59,659,13,28,11,2,6,1,4,1,1,2004
296,Lindsey Hunter,DET,33,653,85,182,73,12,31,23,19,3,9,2004
297,Avery Johnson,GSW,46,637,111,245,88,23,35,12,41,8,15,2004
298,Amal McCaskill,PHI,59,634,20,47,13,7,7,3,3,3,4,2004
299,Wally Szczerbiak,MIN,28,624,33,74,25,8,6,6,13,2,6,2004
300,Danny Fortson,DAL,56,620,9,21,6,3,4,0,2,1,2,2004
301,Devin Brown,SAS,58,619,33,71,28,5,12,5,11,1,4,2004
302,Malik Allen,MIA,45,616,16,39,9,7,7,1,1,0,7,2004
303,Troy Murphy,GSW,28,612,20,41,19,1,12,1,6,0,1,2004
304,Marc Jackson,PHI,22,597,18,41,13,5,9,2,2,2,3,2004
305,Sean Rooks,ORL,55,588,29,63,24,5,10,8,6,3,2,2004
306,Mark Jackson,HOU,42,579,119,277,80,39,33,11,36,16,23,2004
307,Ansu Sesay,SEA,57,575,19,47,10,9,5,3,2,6,3,2004
308,Adonal Foyle,GSW,44,575,17,39,12,5,8,1,3,3,2,2004
309,Zarko Cabarkapa,PHX,49,575,40,84,36,4,21,6,9,2,2,2004
310,Erick Strickland,MIL,43,573,90,195,75,15,33,16,26,3,12,2004
311,Mitchell Butler,WAS,41,554,32,74,22,10,12,2,8,2,8,2004
312,Scott Padgett,HOU,58,549,23,55,14,9,7,4,3,3,6,2004
313,Jason Collier,ATL,20,546,17,39,12,5,7,0,5,1,4,2004
314,Scott Williams,DAL,43,535,17,35,16,1,10,4,2,0,1,2004
315,Jake Tsakalidis,MEM,40,532,18,41,13,5,8,2,3,1,4,2004
316,Lamond Murray,TOR,33,521,28,60,24,4,9,5,10,1,3,2004
317,Ron Mercer,SAS,39,519,22,46,20,2,7,6,7,0,2,2004
318,Tony Delk,DAL,33,515,28,59,25,3,9,8,8,2,1,2004
319,Travis Hansen,ATL,41,510,19,43,14,5,4,3,7,2,3,2004
320,Melvin Ely,LAC,42,508,22,50,16,6,5,4,7,0,6,2004
321,Bostjan Nachbar,HOU,45,507,30,73,17,13,6,4,7,2,11,2004
322,Troy Hudson,MIN,29,505,70,147,63,7,20,18,25,5,2,2004
323,Oliver Miller,MIN,48,505,36,76,32,4,17,4,11,0,4,2004
324,Loren Woods,MIA,38,502,10,25,5,5,2,1,2,1,4,2004
325,Michael Sweetney,NYK,42,497,14,31,11,3,6,1,4,0,3,2004
326,Jannero Pargo,CHI,31,477,70,155,55,15,28,5,22,5,10,2004
327,Darvin Ham,DET,54,471,16,36,12,4,1,5,6,2,2,2004
328,Zendon Hamilton,PHI,45,471,13,28,11,2,2,4,5,1,1,2004
329,Zoran Planinic,NJN,49,467,68,149,55,13,27,6,22,5,8,2004
330,Richie Frahm,SEA,54,459,24,57,15,9,7,1,7,2,7,2004
331,Vladimir Stepania,POR,42,454,23,49,20,3,7,3,10,1,2,2004
332,J.R. Bremer,GSW,36,438,51,109,44,7,18,7,19,5,2,2004
333,Brian Cook,LAL,35,438,20,43,17,3,5,4,8,1,2,2004
334,Brandon Armstrong,NJN,56,426,14,34,8,6,4,0,4,2,4,2004
335,Jason Kapono,CLE,41,423,14,29,13,1,5,2,6,0,1,2004
336,Samaki Walker,MIA,33,416,6,14,4,2,3,0,1,2,0,2004
337,Jerome Moiso,TOR,34,415,8,18,6,2,3,1,2,2,0,2004
338,Scottie Pippen,CHI,23,411,50,110,40,10,21,9,10,1,9,2004
339,Rick Brunson,CHI,40,407,82,174,72,10,25,9,38,3,7,2004
340,Brandon Hunter,BOS,36,405,19,42,15,4,10,1,4,1,3,2004
341,Mikki Moore,UTA,32,395,19,41,16,3,4,1,11,0,3,2004
342,Ryan Bowen,DEN,52,389,18,39,15,3,5,4,6,0,3,2004
343,Keith McLeod,MIN,33,385,59,124,53,6,20,12,21,3,3,2004
344,Jumaine Jones,BOS,42,371,14,33,9,5,6,3,0,1,4,2004
345,Mamadou N'diaye,ATL,28,371,0,0,0,0,0,0,0,0,0,2004
346,Kevin Willis,SAS,48,370,11,24,9,2,5,1,3,0,2,2004
347,John Wallace,MIA,36,365,14,31,11,3,5,2,4,1,2,2004
348,Reece Gaines,ORL,38,354,40,89,31,9,7,6,18,2,7,2004
349,Joel Przybilla,ATL,17,345,7,18,3,4,1,1,1,1,3,2004
350,Gerald Wallace,SAC,37,336,19,41,16,3,5,2,9,2,1,2004
351,Raef LaFrentz,BOS,17,330,24,51,21,3,10,5,6,1,2,2004
352,Roger Mason Jr.,TOR,26,324,26,58,20,6,2,4,14,3,3,2004
353,Nikoloz Tskitishvili,DEN,39,306,10,23,7,3,2,0,5,0,3,2004
354,Britton Johnsen,ORL,20,292,12,28,8,4,3,1,4,1,3,2004
355,Dan Dickau,POR,43,291,38,79,35,3,14,3,18,1,2,2004
356,DerMarr Johnson,NYK,21,283,11,23,10,1,7,2,1,0,1,2004
357,Zeljko Rebraca,ATL,24,270,6,15,3,3,2,0,1,1,2,2004
358,Jonathan Bender,IND,21,269,9,20,7,2,3,1,3,0,2,2004
359,Marcus Haislip,MIL,31,262,4,10,2,2,0,0,2,0,2,2004
360,Glen Rice,LAC,18,260,24,53,19,5,12,4,3,0,5,2004
361,Curtis Borchardt,UTA,16,257,15,31,14,1,3,0,11,0,1,2004
362,Robert Archibald,TOR,32,252,13,29,10,3,7,1,2,1,2,2004
363,Tremaine Fowlkes,DET,36,251,14,29,13,1,6,1,6,0,1,2004
364,Maciej Lampe,PHX,21,225,9,21,6,3,3,1,2,2,1,2004
365,Alonzo Mourning,NJN,12,216,8,17,7,1,2,1,4,0,1,2004
366,Robert Pack,NJN,26,215,27,56,25,2,10,7,8,1,1,2004
367,Chris Jefferies,CHI,21,198,7,14,7,0,0,1,6,0,0,2004
368,Chris Whitney,WAS,16,183,14,28,14,0,8,0,6,0,0,2004
369,Theron Smith,MEM,20,179,7,16,5,2,2,2,1,0,2,2004
370,Darrick Martin,MIN,16,174,23,50,19,4,3,6,10,1,3,2004
371,Ben Handlogten,UTA,17,171,6,13,5,1,1,1,3,0,1,2004
372,Jabari Smith,SAC,31,170,11,24,9,2,5,2,2,1,1,2004
373,Bimbo Coles,MIA,22,168,15,33,12,3,2,0,10,2,1,2004
374,Jamison Brewer,IND,13,162,17,39,12,5,6,2,4,3,2,2004
375,Darko Milicic,DET,34,160,7,16,5,2,5,0,0,1,1,2004
376,Tamar Slay,NJN,22,159,14,30,12,2,2,3,7,1,1,2004
377,Dahntay Jones,MEM,20,154,12,25,11,1,7,1,3,1,0,2004
378,Eddie Gill,POR,22,153,16,34,14,2,9,4,1,2,0,2004
379,Torraye Braggs,WAS,15,150,7,15,6,1,4,1,1,1,0,2004
380,Michael Stewart,BOS,25,148,0,0,0,0,0,0,0,0,0,2004
381,Mike Wilks,HOU,26,140,17,43,8,9,4,0,4,2,7,2004
382,Omar Cook,POR,17,138,24,53,19,5,9,2,8,4,1,2004
383,Rodney Buford,SAC,22,138,7,14,7,0,2,0,5,0,0,2004
384,Jamal Sampson,LAL,10,131,7,15,6,1,0,1,5,0,1,2004
385,Adrian Griffin,HOU,19,122,10,22,8,2,2,1,5,0,2,2004
386,Wang Zhi-zhi,MIA,16,114,2,5,1,1,0,0,1,0,1,2004
387,Maurice Carter,NOH,10,109,4,8,4,0,2,0,2,0,0,2004
388,Michael Bradley,ATL,16,98,1,2,1,0,0,1,0,0,0,2004
389,Jeff Trepagnier,DEN,11,97,4,9,3,1,1,2,0,1,0,2004
390,Paul Grant,UTA,10,96,3,6,3,0,1,0,2,0,0,2004
391,Mateen Cleaves,CLE,4,91,19,38,19,0,11,4,4,0,0,2004
392,Anthony Carter,SAS,5,87,12,27,9,3,4,3,2,1,2,2004
393,Desmond Penigar,ORL,10,86,3,6,3,0,1,1,1,0,0,2004
394,Paul Shirley,CHI,7,84,4,8,4,0,2,0,2,0,0,2004
395,Anthony Goldwire,NJN,11,83,11,24,9,2,3,2,4,2,0,2004
396,Derrick Dial,ORL,9,83,2,4,2,0,1,0,1,0,0,2004
397,Hubert Davis,NJN,17,76,4,8,4,0,3,1,0,0,0,2004
398,Bryce Drew,NOH,15,76,13,29,10,3,5,1,4,0,3,2004
399,Primoz Brezec,IND,18,70,3,6,3,0,0,1,2,0,0,2004
400,Shane Heal,SAS,6,69,5,11,4,1,0,1,3,0,1,2004
401,Alan Henderson,ATL,6,68,2,4,2,0,2,0,0,0,0,2004
402,Matt Carroll,SAS,16,66,2,4,2,0,0,1,1,0,0,2004
403,Quincy Lewis,MIN,14,63,2,4,2,0,1,1,0,0,0,2004
404,Sean Lampley,GSW,10,61,2,5,1,1,0,1,0,0,1,2004
405,Cherokee Parks,GSW,11,58,1,2,1,0,1,0,0,0,0,2004
406,Randy Livingston,LAC,4,48,4,8,4,0,1,3,0,0,0,2004
407,Hiram Fuller,ATL,4,43,2,5,1,1,0,0,1,0,1,2004
408,Alton Ford,HOU,9,40,3,6,3,0,3,0,0,0,0,2004
409,Mengke Bateer,TOR,7,39,1,3,0,1,0,0,0,1,0,2004
410,Tyrone Hill,MIA,5,37,0,0,0,0,0,0,0,0,0,2004
411,Kendrick Perkins,BOS,10,35,3,8,1,2,1,0,0,0,2,2004
412,Dan Langhi,MIL,6,35,0,0,0,0,0,0,0,0,0,2004
413,Tracy Murray,POR,7,35,1,2,1,0,1,0,0,0,0,2004
414,Troy Bell,MEM,6,35,4,8,4,0,2,1,1,0,0,2004
415,Ndudi Ebi,MIN,17,32,3,6,3,0,2,0,1,0,0,2004
416,Bruno Sundov,NYK,5,31,1,2,1,0,1,0,0,0,0,2004
417,Desmond Ferguson,POR,7,31,1,2,1,0,1,0,0,0,0,2004
418,Keon Clark,UTA,2,28,1,2,1,0,0,0,1,0,0,2004
419,Ime Udoka,LAL,4,28,2,5,1,1,0,1,0,0,1,2004
420,James Jones,IND,6,26,0,0,0,0,0,0,0,0,0,2004
421,Ruben Boumtje-Boumtje,POR,9,25,1,3,0,1,0,0,0,0,1,2004
422,Charles Oakley,HOU,7,24,2,4,2,0,2,0,0,0,0,2004
423,Josh Davis,ATL,4,22,0,0,0,0,0,0,0,0,0,2004
424,Pat Garrity,ORL,2,21,1,3,0,1,0,0,0,1,0,2004
425,Mark Pope,DEN,4,20,0,0,0,0,0,0,0,0,0,2004
426,Rusty LaRue,GSW,4,19,2,4,2,0,1,0,1,0,0,2004
427,Travis Outlaw,POR,8,19,1,2,1,0,1,0,0,0,0,2004
428,Tierre Brown,NOH,3,18,2,4,2,0,1,0,1,0,0,2004
429,Kirk Penney,MIA,2,17,1,2,1,0,0,0,1,0,0,2004
430,Damone Brown,NJN,3,16,0,0,0,0,0,0,0,0,0,2004
431,Jelani McCoy,CLE,2,13,0,0,0,0,0,0,0,0,0,2004
432,Kaniel Dickens,POR,3,13,0,0,0,0,0,0,0,0,0,2004
433,Cezary Trybanski,NYK,7,13,0,0,0,0,0,0,0,0,0,2004
434,Alex Garcia,SAS,2,13,0,0,0,0,0,0,0,0,0,2004
435,Ryan Humphrey,MEM,2,12,1,2,1,0,1,0,0,0,0,2004
436,Olden Polynice,LAC,2,11,1,2,1,0,0,0,1,0,0,2004
437,Dana Barros,BOS,1,11,0,0,0,0,0,0,0,0,0,2004
438,Popeye Jones,GSW,5,10,0,0,0,0,0,0,0,0,0,2004
439,Jerome Beasley,MIA,2,5,0,0,0,0,0,0,0,0,0,2004
440,Leon Smith,SEA,1,4,0,0,0,0,0,0,0,0,0,2004
441,Slavko Vranes,POR,1,3,0,0,0,0,0,0,0,0,0,2004
0,Allen Iverson,PHI,82,3484,454,948,414,40,244,70,100,23,17,2003
1,Kobe Bryant,LAL,82,3404,481,1065,378,103,192,80,106,48,55,2003
2,Shawn Marion,PHX,81,3375,198,424,170,28,87,21,62,13,15,2003
3,Jalen Rose,CHI,82,3352,395,857,328,67,189,66,73,22,45,2003
4,Jamal Mashburn,NOH,82,3326,462,1009,377,85,145,78,154,29,56,2003
5,Kevin Garnett,MIN,82,3322,495,1065,420,75,168,74,178,26,49,2003
6,Steve Francis,HOU,81,3322,502,1141,365,137,215,51,99,29,108,2003
7,Stephon Marbury,PHX,81,3248,654,1485,477,177,226,61,190,100,77,2003
8,Antoine Walker,BOS,78,3236,373,860,259,114,170,27,62,37,77,2003
9,Antawn Jamison,GSW,82,3229,156,351,117,39,54,26,37,11,28,2003
10,Gary Payton,MIL,80,3210,663,1467,522,141,172,89,261,31,110,2003
11,Tim Duncan,SAS,81,3183,316,709,239,77,170,26,43,32,45,2003
12,Ricky Davis,CLE,79,3137,436,940,368,68,160,60,148,39,29,2003
13,Dirk Nowitzki,DAL,80,3121,239,538,179,60,102,22,55,16,44,2003
14,Allan Houston,NYK,82,3110,220,489,171,49,47,67,57,19,30,2003
15,Eric Snow,PHI,82,3109,544,1171,461,83,223,70,168,24,59,2003
16,Paul Pierce,BOS,79,3097,349,856,191,158,112,26,53,54,104,2003
17,Jason Terry,ATL,81,3084,600,1290,510,90,170,114,226,28,62,2003
18,Shareef Abdur-Rahim,ATL,81,3080,242,555,171,71,66,32,73,26,45,2003
19,Rashard Lewis,SEA,77,3041,133,296,103,30,39,15,49,6,24,2003
20,Cuttino Mobley,HOU,73,3041,208,473,151,57,76,20,55,17,40,2003
21,Michael Jordan,WAS,82,3029,311,674,259,52,97,37,125,13,39,2003
22,Jason Kidd,NJN,80,2989,711,1505,628,83,398,91,139,23,60,2003
23,Tracy McGrady,ORL,75,2950,411,943,290,121,148,23,119,36,85,2003
24,Pau Gasol,MEM,82,2946,229,523,164,65,77,34,53,18,47,2003
25,Morris Peterson,TOR,82,2945,188,408,156,32,56,36,64,10,22,2003
26,Karl Malone,UTA,81,2935,379,778,359,20,198,33,128,3,17,2003
27,Andre Miller,LAC,80,2913,537,1169,442,95,219,97,126,16,79,2003
28,Ray Allen,SEA,76,2880,334,771,231,103,105,48,78,49,54,2003
29,Richard Jefferson,NJN,80,2874,201,451,152,49,74,19,59,15,34,2003
30,Ben Wallace,DET,73,2871,120,265,95,25,33,12,50,4,21,2003
31,Gilbert Arenas,GSW,82,2868,514,1112,430,84,202,94,134,19,65,2003
32,Jermaine O'Neal,IND,77,2863,155,331,134,21,79,15,40,5,16,2003
33,Latrell Sprewell,NYK,74,2858,332,764,232,100,70,80,82,29,71,2003
34,Caron Butler,MIA,78,2856,213,462,177,36,70,28,79,12,24,2003
35,Derek Fisher,LAL,82,2829,298,669,225,73,118,46,61,14,59,2003
36,Clifford Robinson,DET,81,2825,268,610,194,74,100,35,59,24,50,2003
37,Tony Parker,SAS,82,2780,432,966,330,102,153,76,101,64,38,2003
38,Desmond Mason,MIL,80,2765,163,380,109,54,39,31,39,17,37,2003
39,Jerry Stackhouse,WAS,70,2748,316,673,275,41,82,34,159,12,29,2003
40,Juwan Howard,DEN,77,2733,234,505,197,37,103,23,71,11,26,2003
41,Steve Nash,DAL,82,2712,598,1353,441,157,197,67,177,45,112,2003
42,David Wesley,NOH,73,2711,251,545,208,43,69,57,82,14,29,2003
43,Doug Christie,SAC,80,2710,376,814,314,62,144,40,130,36,26,2003
44,Sam Cassell,MIL,78,2699,450,996,354,96,163,84,107,25,71,2003
45,Jason Richardson,GSW,82,2697,247,543,198,49,68,43,87,12,37,2003
46,Rasheed Wallace,POR,74,2687,153,328,131,22,84,23,24,6,16,2003
47,Alvin Williams,TOR,78,2642,416,919,329,87,141,46,142,31,56,2003
48,Michael Finley,DAL,69,2642,205,482,133,72,62,13,58,23,49,2003
49,Brian Grant,MIA,82,2642,104,225,87,17,31,18,38,4,13,2003
50,Richard Hamilton,DET,82,2640,208,470,154,54,72,33,49,18,36,2003
51,Kenyon Martin,NJN,77,2626,185,403,152,33,68,20,64,6,27,2003
52,Chris Webber,SAC,67,2617,364,818,274,90,152,30,92,34,56,2003
53,P.J. Brown,NOH,78,2616,147,327,114,33,42,26,46,11,22,2003
54,Troy Hudson,MIN,79,2602,452,949,407,45,133,94,180,16,29,2003
55,Glenn Robinson,ATL,69,2592,205,462,153,52,90,27,36,23,29,2003
56,Pat Garrity,ORL,81,2587,121,277,86,35,27,13,46,8,27,2003
57,Kurt Thomas,NYK,81,2575,162,381,105,57,52,25,28,17,40,2003
58,Amar'e Stoudemire,PHX,82,2570,78,165,69,9,38,17,14,3,6,2003
59,Bruce Bowen,SAS,82,2568,113,266,73,40,29,21,23,14,26,2003
60,Matt Harpring,UTA,78,2556,133,277,122,11,41,14,67,2,9,2003
61,Derek Anderson,POR,76,2553,325,708,267,58,139,57,71,21,37,2003
62,Shaquille O'Neal,LAL,67,2534,206,470,148,58,75,18,55,9,49,2003
63,Theo Ratliff,ATL,81,2524,73,159,60,13,29,12,19,4,9,2003
64,James Posey,HOU,83,2518,184,403,149,35,65,40,44,18,17,2003
65,Troy Murphy,GSW,79,2516,106,239,79,27,40,20,19,4,23,2003
66,Brent Barry,SEA,75,2482,384,845,307,77,153,60,94,21,56,2003
67,Al Harrington,IND,82,2468,125,286,89,36,49,10,30,9,27,2003
68,Peja Stojakovic,SAC,72,2451,141,317,106,35,39,14,53,14,21,2003
69,Elton Brand,LAC,62,2450,157,367,104,53,54,12,38,5,48,2003
70,Jamaal Magloire,NOH,82,2444,88,197,67,21,25,13,29,8,13,2003
71,Zydrunas Ilgauskas,CLE,81,2434,127,277,104,23,47,13,44,5,18,2003
72,Jason Williams,MEM,76,2405,631,1392,501,130,227,108,166,44,86,2003
73,Bonzi Wells,POR,75,2397,246,525,213,33,138,35,40,9,24,2003
74,Vlade Divac,SAC,80,2387,274,609,213,61,129,15,69,24,37,2003
75,Yao Ming,HOU,82,2382,137,310,101,36,67,7,27,8,28,2003
76,Shane Battier,MEM,78,2382,105,231,84,21,29,12,43,8,13,2003
77,Aaron McKie,PHI,80,2377,278,596,238,40,118,51,69,11,29,2003
78,Donyell Marshall,CHI,78,2376,137,295,116,21,65,20,31,4,17,2003
79,Tim Thomas,MIL,80,2360,102,238,68,34,28,14,26,14,20,2003
80,Calbert Cheaney,UTA,81,2353,163,343,146,17,57,27,62,5,12,2003
81,Eric Williams,BOS,82,2350,140,330,90,50,51,18,21,11,39,2003
82,Darrell Armstrong,ORL,82,2349,323,740,229,94,107,22,100,12,82,2003
83,Robert Horry,LAL,80,2344,233,519,180,53,79,33,68,11,42,2003
84,Jerome Williams,TOR,71,2343,95,214,71,24,31,8,32,7,17,2003
85,Keith Van Horn,PHI,74,2341,93,196,83,10,41,12,30,2,8,2003
86,Rasho Nesterovic,MIN,77,2338,114,244,98,16,38,9,51,2,14,2003
87,Chauncey Billups,DET,74,2330,287,619,242,45,91,44,107,13,32,2003
88,Malik Allen,MIA,80,2320,54,123,39,15,17,5,17,4,11,2003
89,Michael Redd,MIL,82,2319,117,267,84,33,50,11,23,10,23,2003
90,Metta World Peace,IND,69,2317,198,438,156,42,56,21,79,12,30,2003
91,Dale Davis,POR,78,2281,94,217,65,29,29,11,25,7,22,2003
92,John Stockton,UTA,82,2274,629,1313,574,55,280,67,227,19,36,2003
93,Brad Miller,IND,73,2271,193,412,167,26,87,24,56,7,19,2003
94,Nene,DEN,80,2258,149,319,128,21,49,20,59,4,17,2003
95,Joe Johnson,PHX,82,2253,210,460,170,40,70,35,65,13,27,2003
96,Stephen Jackson,SAS,80,2252,183,401,148,35,86,29,33,19,16,2003
97,Howard Eisley,NYK,82,2245,444,995,337,107,85,76,176,40,67,2003
98,Anthony Peeler,MIN,82,2243,244,512,220,24,89,63,68,9,15,2003
99,Jamaal Tinsley,IND,73,2238,548,1176,468,80,231,97,140,21,59,2003
100,Andrei Kirilenko,UTA,80,2214,138,293,121,17,74,15,32,4,13,2003
101,Christian Laettner,WAS,76,2212,235,506,199,36,60,32,107,10,26,2003
102,Jumaine Jones,CLE,80,2201,112,238,98,14,47,19,32,3,11,2003
103,Mike Miller,MEM,65,2185,170,381,129,41,46,13,70,11,30,2003
104,Rick Fox,LAL,76,2183,253,539,220,33,127,44,49,11,22,2003
105,Gordan Giricek,ORL,76,2154,137,302,109,28,46,13,50,5,23,2003
106,Larry Hughes,WAS,67,2137,205,429,186,19,86,23,77,8,11,2003
107,Reggie Miller,IND,70,2121,170,366,144,26,65,42,37,10,16,2003
108,Anthony Mason,MIL,65,2118,209,491,136,73,44,38,54,6,67,2003
109,Kendall Gill,MIN,82,2070,156,322,146,10,56,32,58,4,6,2003
110,Corliss Williamson,DET,82,2061,104,254,58,46,26,12,20,17,29,2003
111,Carlos Boozer,CLE,81,2048,106,224,94,12,40,17,37,4,8,2003
112,Nick Van Exel,DAL,73,2033,312,726,210,102,105,21,84,29,73,2003
113,Clar. Weatherspoon,NYK,79,2026,68,154,50,18,27,10,13,8,10,2003
114,Darius Miles,CLE,67,2006,176,370,158,18,83,21,54,6,12,2003
115,Corey Maggette,LAC,64,2005,123,263,106,17,45,31,30,1,16,2003
116,Junior Harrington,DEN,82,2000,277,577,254,23,98,39,117,5,18,2003
117,Trenton Hassell,CHI,82,1997,151,343,110,41,61,24,25,14,27,2003
118,Jamal Crawford,CHI,80,1988,334,715,287,47,131,51,105,22,25,2003
119,Tyronn Lue,WAS,75,1987,263,556,233,30,58,34,141,12,18,2003
120,Lorenzen Wright,MEM,70,1984,80,179,61,19,24,14,23,4,15,2003
121,Predrag Drobnjak,SEA,82,1982,86,198,60,26,20,10,30,11,15,2003
122,Kenny Thomas,PHI,66,1980,112,244,92,20,54,10,28,4,16,2003
123,Erick Dampier,GSW,82,1977,58,136,38,20,13,6,19,3,17,2003
124,Milt Palacio,CLE,80,1974,259,563,214,45,109,31,74,17,28,2003
125,Lucious Harris,NJN,77,1971,155,340,125,30,71,15,39,6,24,2003
126,Jay Williams,CHI,75,1961,350,748,302,48,141,73,88,15,33,2003
127,Kerry Kittles,NJN,65,1955,170,372,138,32,65,25,48,5,27,2003
128,Walter McCarty,BOS,82,1949,106,249,69,37,38,17,14,5,32,2003
129,Wesley Person,MEM,66,1939,112,252,84,28,38,18,28,10,18,2003
130,Brendan Haywood,WAS,81,1930,29,63,24,5,8,3,13,2,3,2003
131,Voshon Lenard,TOR,63,1928,144,320,112,32,55,23,34,9,23,2003
132,Ira Newble,ATL,73,1927,99,220,77,22,29,17,31,3,19,2003
133,Greg Ostertag,UTA,81,1927,55,119,46,9,20,1,25,2,7,2003
134,Malik Rose,SAS,79,1926,124,273,99,25,62,24,13,11,14,2003
135,Scottie Pippen,POR,64,1912,285,625,230,55,118,49,63,14,41,2003
136,Vladimir Radmanovic,SEA,72,1910,97,213,78,19,38,11,29,7,12,2003
137,Kevin Ollie,SEA,82,1900,291,699,174,117,74,35,65,29,88,2003
138,Antonio Davis,TOR,53,1898,131,291,102,29,44,12,46,12,17,2003
139,Jason Collins,NJN,81,1898,87,185,76,11,27,10,39,4,7,2003
140,Baron Davis,NOH,50,1893,320,700,260,60,131,41,88,21,39,2003
141,Dion Glover,ATL,76,1888,141,318,105,36,37,29,39,20,16,2003
142,Eddie Griffin,HOU,77,1882,86,193,65,21,31,21,13,6,15,2003
143,Shammond Williams,DEN,78,1876,266,601,197,69,79,36,82,14,55,2003
144,Drew Gooden,ORL,70,1876,83,181,68,15,34,14,20,4,11,2003
145,Tony Delk,BOS,67,1873,146,344,94,52,50,15,29,20,32,2003
146,Othella Harrington,NYK,74,1846,62,150,36,26,15,10,11,12,14,2003
147,Mike Bibby,SAC,55,1835,285,611,244,41,124,27,93,17,24,2003
148,Wally Szczerbiak,MIN,52,1834,136,291,117,19,35,30,52,5,14,2003
149,Tyson Chandler,CHI,75,1825,76,162,66,10,37,14,15,3,7,2003
150,Travis Best,MIA,72,1805,255,566,199,56,59,26,114,23,33,2003
151,Bo Outlaw,PHX,80,1800,112,243,93,19,51,13,29,7,12,2003
152,Eddie Jones,MIA,47,1788,173,376,143,30,57,21,65,9,21,2003
153,Adonal Foyle,GSW,82,1786,37,76,35,2,13,7,15,0,2,2003
154,Keon Clark,SAC,80,1779,80,179,61,19,40,4,17,8,11,2003
155,Kwame Brown,WAS,80,1778,58,125,49,9,21,3,25,6,3,2003
156,Anfernee Hardaway,PHX,58,1777,235,497,208,27,106,40,62,15,12,2003
157,Derrick Coleman,PHI,64,1742,87,183,78,9,47,15,16,3,6,2003
158,Shandon Anderson,NYK,82,1729,87,193,68,19,32,14,22,6,13,2003
159,Shawn Bradley,DAL,81,1729,54,118,44,10,26,6,12,1,9,2003
160,Mike James,MIA,78,1723,246,542,196,50,51,25,120,19,31,2003
161,Toni Kukoc,MIL,63,1702,230,522,168,62,95,33,40,18,44,2003
162,Jacque Vaughn,ORL,80,1690,232,529,167,65,71,13,83,12,53,2003
163,Tony Battie,BOS,67,1685,49,120,27,22,14,2,11,5,17,2003
164,Lamar Odom,LAC,49,1678,178,382,152,26,72,43,37,8,18,2003
165,Bobby Jackson,SAC,59,1673,182,396,150,32,63,16,71,14,18,2003
166,David Robinson,SAS,64,1672,61,132,51,10,40,4,7,5,5,2003
167,Ron Mercer,IND,72,1670,112,256,80,32,31,13,36,2,30,2003
168,Ruben Patterson,POR,78,1657,101,220,83,18,47,13,23,2,16,2003
169,Shawn Kemp,ORL,79,1630,55,121,44,11,21,2,21,5,6,2003
170,Donnell Harvey,DEN,77,1614,100,211,89,11,35,13,41,2,9,2003
171,Devean George,LAL,71,1612,92,209,67,25,28,12,27,5,20,2003
172,Raef LaFrentz,DAL,69,1610,54,120,42,12,20,8,14,1,11,2003
173,Aaron Williams,NJN,81,1601,88,192,72,16,32,10,30,5,11,2003
174,Vladimir Stepania,MIA,79,1594,24,54,18,6,10,1,7,2,4,2003
175,Eddy Curry,CHI,81,1576,37,84,27,10,8,8,11,2,8,2003
176,Rodney White,DEN,72,1565,121,255,108,13,46,22,40,3,10,2003
177,Michael Curry,DET,78,1555,104,240,72,32,18,12,42,9,23,2003
178,Glen Rice,HOU,62,1534,65,141,54,11,22,18,14,3,8,2003
179,Greg Buckner,PHI,75,1516,96,205,83,13,43,12,28,3,10,2003
180,Rasual Butler,MIA,72,1515,93,205,74,19,27,14,33,6,13,2003
181,J.R. Bremer,BOS,64,1501,164,392,100,64,47,17,36,22,42,2003
182,George Lynch,NOH,81,1496,104,224,88,16,36,14,38,5,11,2003
183,Alan Henderson,ATL,82,1493,41,86,37,4,19,6,12,1,3,2003
184,Jon Barry,DET,80,1476,206,458,160,46,76,50,34,17,29,2003
185,Stromile Swift,MEM,67,1474,45,96,39,6,16,7,16,4,2,2003
186,Vince Carter,TOR,43,1470,143,321,108,35,70,8,30,18,17,2003
187,Mark Jackson,UTA,82,1469,375,789,336,39,142,33,161,5,34,2003
188,Charlie Ward,NYK,66,1467,306,684,234,72,82,41,111,25,47,2003
189,Manu Ginobili,SAS,69,1434,138,307,107,31,65,13,29,12,19,2003
190,Mark Blount,BOS,81,1407,56,124,44,12,28,4,12,2,10,2003
191,Chucky Atkins,DET,65,1398,175,395,130,45,53,27,50,11,34,2003
192,Bryon Russell,WAS,70,1389,72,157,59,13,16,17,26,1,12,2003
193,Dajuan Wagner,CLE,47,1385,130,280,110,20,44,22,44,13,7,2003
194,Brian Skinner,PHI,77,1385,19,39,18,1,10,6,2,1,0,2003
195,Marko Jaric,LAC,66,1384,193,433,146,47,85,33,28,15,32,2003
196,Maurice Taylor,HOU,67,1380,66,142,56,10,39,14,3,1,9,2003
197,Vincent Yarbrough,DEN,59,1379,130,270,120,10,37,30,53,3,7,2003
198,Moochie Norris,HOU,82,1376,196,446,142,54,63,19,60,18,36,2003
199,Adrian Griffin,DAL,74,1370,105,239,76,29,28,8,40,8,21,2003
200,Michael Olowokandi,LAC,36,1370,47,118,23,24,8,2,13,3,21,2003
201,Reggie Evans,SEA,67,1369,34,80,22,12,9,3,10,4,8,2003
202,Quentin Richardson,LAC,59,1368,52,117,39,13,18,12,9,2,11,2003
203,Jelani McCoy,TOR,67,1367,43,96,33,10,13,5,15,4,6,2003
204,Mehmet Okur,DET,72,1366,71,173,40,31,18,11,11,8,23,2003
205,Earl Watson,MEM,79,1362,225,496,179,46,81,32,66,16,30,2003
206,Eric Piatkowski,LAC,62,1361,70,154,56,14,27,17,12,3,11,2003
207,Courtney Alexander,NOH,66,1359,79,176,61,18,24,13,24,2,16,2003
208,Eddie Robinson,CHI,64,1354,66,144,54,12,27,18,9,2,10,2003
209,Tyrone Hill,PHI,56,1353,41,90,33,8,10,10,13,1,7,2003
210,Sean Rooks,LAC,70,1343,69,151,56,13,35,15,6,2,11,2003
211,Andrew DeClercq,ORL,77,1330,52,117,39,13,15,2,22,1,12,2003
212,Scott Padgett,UTA,82,1322,86,189,69,17,34,7,28,8,9,2003
213,Earl Boykins,GSW,68,1321,221,495,168,53,71,27,70,16,37,2003
214,Nikoloz Tskitishvili,DEN,81,1320,91,192,81,10,38,18,25,1,9,2003
215,Damon Stoudamire,POR,59,1314,204,458,154,50,79,24,51,15,35,2003
216,Jeff McInnis,POR,75,1312,170,367,143,27,76,24,43,7,20,2003
217,Michael Bradley,TOR,67,1311,67,149,52,15,31,2,19,4,11,2003
218,Jim Jackson,SAC,63,1310,118,272,82,36,37,13,32,13,23,2003
219,Rodney Rogers,NJN,68,1307,107,235,86,21,47,10,29,7,14,2003
220,Mike Dunleavy,GSW,82,1306,106,230,88,18,37,23,28,6,12,2003
221,Zach Randolph,POR,77,1301,41,87,36,5,20,7,9,0,5,2003
222,Erick Strickland,IND,71,1277,209,456,171,38,63,38,70,5,33,2003
223,Kelvin Cato,HOU,73,1252,20,43,17,3,8,3,6,1,2,2003
224,Mike Batiste,MEM,75,1249,52,112,44,8,23,5,16,3,5,2003
225,Samaki Walker,LAL,67,1244,64,139,53,11,22,3,28,1,10,2003
226,Gary Trent,MIN,80,1223,77,167,64,13,19,9,36,0,13,2003
227,Arvydas Sabonis,POR,78,1203,142,303,123,19,70,26,27,4,15,2003
228,Hedo Turkoglu,SAC,67,1178,87,196,65,22,30,6,29,12,10,2003
229,Raja Bell,DAL,75,1174,57,134,37,20,14,3,20,9,11,2003
230,Ervin Johnson,MIL,69,1171,24,55,17,7,7,2,8,1,6,2003
231,Walt Williams,DAL,66,1162,59,136,41,18,22,13,6,5,13,2003
232,Casey Jacobsen,PHX,72,1145,73,162,57,16,20,10,27,8,8,2003
233,Kenny Anderson,NOH,61,1135,198,428,166,32,63,28,75,9,23,2003
234,Bob Sura,GSW,55,1130,177,394,137,40,54,30,53,11,29,2003
235,Joe Smith,MIN,54,1118,38,84,30,8,8,3,19,1,7,2003
236,Smush Parker,CLE,66,1101,162,345,141,21,85,15,41,9,12,2003
237,Eduardo Najera,DAL,48,1101,47,110,31,16,12,4,15,2,14,2003
238,Chris Whitney,ORL,51,1050,145,307,128,17,42,37,49,6,11,2003
239,Marc Jackson,MIN,77,1041,37,78,33,4,9,3,21,0,4,2003
240,Michael Doleac,NYK,75,1040,42,107,19,23,9,4,6,5,18,2003
241,Steven Smith,SAS,53,1032,70,156,54,16,22,14,18,5,11,2003
242,Eddie House,MIA,55,1025,87,190,71,16,31,14,26,8,8,2003
243,Jeryl Sasser,ORL,75,1024,65,136,59,6,24,12,23,2,4,2003
244,Ryan Bowen,DEN,62,996,54,113,49,5,21,13,15,1,4,2003
245,Rafer Alston,TOR,47,982,192,419,157,35,78,17,62,9,26,2003
246,Keyon Dooling,LAC,55,970,89,198,69,20,32,20,17,2,18,2003
247,Rod Strickland,MIN,47,956,215,455,190,25,61,43,86,7,18,2003
248,Steve Kerr,SAS,75,950,70,159,51,19,21,13,17,7,12,2003
249,Jake Voskuhl,PHX,65,947,36,75,33,3,20,6,7,1,2,2003
250,DeSagana Diop,CLE,80,946,43,90,39,4,19,5,15,0,4,2003
251,Vin Baker,BOS,52,945,29,73,14,15,5,4,5,1,14,2003
252,Brevin Knight,MEM,55,928,233,494,205,28,101,36,68,16,12,2003
253,Darvin Ham,ATL,75,925,38,86,28,10,15,4,9,6,4,2003
254,Anthony Carter,MIA,49,913,203,439,170,33,74,21,75,17,16,2003
255,Chris Andersen,DEN,59,902,32,69,27,5,13,3,11,1,4,2003
256,Brian Shaw,LAL,72,898,103,229,80,23,36,21,23,4,19,2003
257,Jason Caffey,MIL,51,895,38,85,29,9,16,7,6,0,9,2003
258,Scott Williams,PHX,69,875,22,47,19,3,10,3,6,1,2,2003
259,Kareem Rush,LAL,76,875,68,150,54,14,25,16,13,2,12,2003
260,Antonio Daniels,POR,67,870,85,187,68,17,38,8,22,6,11,2003
261,Elden Campbell,SEA,56,868,51,112,41,10,19,9,13,1,9,2003
262,Stacey Augmon,NOH,70,860,69,156,51,18,15,11,25,6,12,2003
263,Robert Traylor,NOH,69,847,50,103,47,3,21,3,23,1,2,2003
264,Anthony Johnson,NJN,66,843,86,186,72,14,32,9,31,2,12,2003
265,Kevin Willis,SAS,71,842,24,59,13,11,7,1,5,2,9,2003
266,Grant Hill,ORL,29,841,122,279,87,35,36,7,44,9,26,2003
267,Corie Blount,CHI,50,836,50,109,41,9,19,12,10,2,7,2003
268,Jonathan Bender,IND,46,819,42,88,38,4,14,5,19,0,4,2003
269,Todd MacCulloch,PHI,42,809,20,43,17,3,10,5,2,0,3,2003
270,Marcus Fizer,CHI,38,808,48,106,38,10,18,7,13,3,7,2003
271,Chris Mihm,CLE,52,806,28,60,24,4,15,3,6,1,3,2003
272,Melvin Ely,LAC,52,803,15,36,9,6,5,1,3,1,5,2003
273,Jeff Foster,IND,77,802,51,112,41,10,21,6,14,1,9,2003
274,Tony Massenburg,UTA,58,790,17,37,14,3,4,0,10,1,2,2003
275,Fred Hoiberg,CHI,63,786,70,152,58,12,21,14,23,3,9,2003
276,Pat Burke,ORL,62,786,23,52,17,6,8,2,7,3,3,2003
277,Mark Madsen,LAL,54,783,38,86,28,10,12,5,11,0,10,2003
278,LaPhonso Ellis,MIA,55,781,15,35,10,5,2,2,6,2,3,2003
279,Jerome James,SEA,51,765,27,55,26,1,14,0,12,0,1,2003
280,DeShawn Stevenson,UTA,61,761,40,84,36,4,16,1,19,1,3,2003
281,Dan Gadzuric,MIL,49,759,9,21,6,3,2,1,3,0,3,2003
282,Brian Scalabrine,NJN,59,721,46,99,39,7,25,5,9,1,6,2003
283,Damon Jones,SAC,49,711,80,176,64,16,32,6,26,8,8,2003
284,Bimbo Coles,BOS,35,690,72,153,63,9,16,17,30,2,7,2003
285,Mike Wilks,MIN,46,690,92,204,72,20,19,15,38,2,18,2003
286,Lonny Baxter,CHI,55,684,16,34,14,2,7,3,4,1,1,2003
287,Juaquin Hawkins,HOU,58,681,47,100,41,6,22,8,11,0,6,2003
288,Lindsey Hunter,TOR,29,672,71,159,54,17,28,8,18,8,9,2003
289,Kedrick Brown,BOS,51,667,20,48,12,8,6,2,4,1,7,2003
290,Chris Jefferies,TOR,51,667,22,50,16,6,12,0,4,3,3,2003
291,Juan Dixon,WAS,42,648,40,84,36,4,15,7,14,2,2,2003
292,Cherokee Parks,LAC,30,646,21,43,20,1,11,2,7,0,1,2003
293,Jerome Moiso,NOH,51,636,22,49,17,5,6,1,10,2,3,2003
294,Terence Morris,HOU,49,632,25,56,19,6,11,3,5,3,3,2003
295,Austin Croshere,IND,49,631,56,121,47,9,17,13,17,1,8,2003
296,Slava Medvedenko,LAL,58,620,18,41,13,5,3,3,7,1,4,2003
297,Marcus Camby,DEN,29,615,47,99,42,5,26,7,9,2,3,2003
298,Danny Ferry,SAS,64,600,21,51,12,9,4,3,5,4,5,2003
299,Calvin Booth,SEA,46,575,12,27,9,3,1,1,7,1,2,2003
300,Tremaine Fowlkes,LAC,37,573,23,52,17,6,10,3,4,2,4,2003
301,Gerald Wallace,SAC,47,573,23,57,12,11,8,1,3,6,5,2003
302,Jermaine Jackson,ATL,53,555,74,166,56,18,26,11,19,3,15,2003
303,Joel Przybilla,MIL,32,543,12,27,9,3,5,1,3,0,3,2003
304,Jake Tsakalidis,PHX,33,542,13,26,13,0,8,0,5,0,0,2003
305,Greg Foster,TOR,29,539,13,29,10,3,2,2,6,1,2,2003
306,Dan Langhi,PHX,60,538,21,47,16,5,7,5,4,2,3,2003
307,Dan Dickau,ATL,50,518,85,182,73,12,26,17,30,5,7,2003
308,Charles Oakley,WAS,42,515,40,90,30,10,10,1,19,5,5,2003
309,Dikembe Mutombo,NJN,24,515,19,45,12,7,6,0,6,1,6,2003
310,Etan Thomas,WAS,38,514,3,7,2,1,0,0,2,0,1,2003
311,Kenny Satterfield,PHI,39,499,68,142,62,6,30,12,20,3,3,2003
312,John Salmons,PHI,64,495,47,98,43,4,18,8,17,3,1,2003
313,Zeljko Rebraca,DET,30,490,9,21,6,3,4,2,0,0,3,2003
314,Grant Long,BOS,41,490,25,55,20,5,10,2,8,0,5,2003
315,Sean Lampley,MIA,35,488,31,66,27,4,11,4,12,2,2,2003
316,Chris Wilcox,LAC,46,480,21,44,19,2,14,1,4,1,1,2003
317,John Amaechi,UTA,50,475,21,44,19,2,14,0,5,0,2,2003
318,Speedy Claxton,SAS,30,469,75,182,43,32,22,8,13,16,16,2003
319,Nazr Mohammed,ATL,35,450,6,12,6,0,4,2,0,0,0,2003
320,Steven Hunter,ORL,33,447,6,14,4,2,1,1,2,0,2,2003
321,Ansu Sesay,SEA,44,445,23,52,17,6,4,6,7,2,4,2003
322,Tom Gugliotta,PHX,27,445,31,67,26,5,12,3,11,1,4,2003
323,Ryan Humphrey,MEM,48,443,11,23,10,1,5,0,5,1,0,2003
324,Marcus Haislip,MIL,39,441,9,22,5,4,4,0,1,0,4,2003
325,Robert Pack,NOH,28,438,81,182,61,20,21,7,33,9,11,2003
326,Tayshaun Prince,DET,42,435,24,54,18,6,5,6,7,2,4,2003
327,Avery Johnson,DAL,48,427,64,146,46,18,22,5,19,6,12,2003
328,Jarron Collins,UTA,22,421,14,29,13,1,7,1,5,0,1,2003
329,Wang Zhi-zhi,LAC,41,411,10,22,8,2,5,1,2,0,2,2003
330,Lee Nailon,NYK,38,406,26,58,20,6,11,3,6,2,4,2003
331,Vitaly Potapenko,SEA,26,401,4,11,1,3,1,0,0,0,3,2003
332,Bobby Simmons,WAS,36,374,20,41,19,1,5,5,9,0,1,2003
333,Mamadou N'diaye,TOR,22,366,7,17,4,3,3,1,0,0,3,2003
334,Loren Woods,MIN,38,351,19,39,18,1,5,5,8,0,1,2003
335,Emanual Davis,ATL,24,340,36,76,32,4,13,6,13,2,2,2003
336,Jannero Pargo,LAL,34,339,39,88,29,10,14,5,10,2,8,2003
337,Qyntel Woods,POR,53,335,12,25,11,1,7,1,3,1,0,2003
338,Scot Pollard,SAC,23,324,6,13,5,1,0,0,5,0,1,2003
339,Hubert Davis,DET,43,323,29,72,15,14,6,3,6,2,12,2003
340,Jared Jeffries,WAS,20,290,16,36,12,4,5,1,6,2,2,2003
341,Travis Knight,NYK,32,287,14,31,11,3,6,2,3,0,3,2003
342,Carlos Arroyo,UTA,44,284,53,109,50,3,28,7,15,0,3,2003
343,Monty Williams,PHI,21,276,26,56,22,4,13,6,3,1,3,2003
344,Tamar Slay,NJN,36,274,14,30,12,2,6,1,5,0,2,2003
345,Chris Mills,GSW,21,264,22,48,18,4,6,3,9,2,2,2003
346,Randy Brown,PHX,32,260,35,73,32,3,16,5,11,2,1,2003
347,Predrag Savovic,DEN,27,256,22,47,19,3,7,4,8,1,2,2003
348,Michael Stewart,CLE,47,251,6,14,4,2,2,0,2,2,0,2003
349,Igor Rakocevic,MIN,42,240,33,69,30,3,18,1,11,1,2,2003
350,Jahidi White,WAS,16,230,2,5,1,1,1,0,0,1,0,2003
351,Jiri Welsch,GSW,37,230,27,59,22,5,10,4,8,1,4,2003
352,Lawrence Funderburke,SAC,27,228,8,17,7,1,1,2,4,0,1,2003
353,Sean Marks,MIA,23,224,3,6,3,0,2,0,1,0,0,2003
354,Popeye Jones,DAL,26,223,8,20,4,4,1,0,3,0,4,2003
355,Danny Fortson,GSW,17,221,12,26,10,2,4,2,4,0,2,2003
356,Art Long,TOR,26,210,6,14,4,2,3,0,1,1,1,2003
357,Tariq Abdul-Wahad,DAL,14,204,21,52,11,10,5,2,4,3,7,2003
358,Rick Brunson,CHI,17,194,36,75,33,3,14,11,8,3,0,2003
359,Tracy Murray,LAL,31,189,12,26,10,2,5,2,3,1,1,2003
360,John Crotty,DEN,12,180,29,63,24,5,2,9,13,4,1,2003
361,Tierre Brown,CLE,15,168,39,87,30,9,16,8,6,7,2,2003
362,Frank Williams,NYK,21,167,34,76,26,8,10,3,13,3,5,2003
363,Ken Johnson,MIA,16,156,0,0,0,0,0,0,0,0,0,2003
364,Corey Benjamin,ATL,9,150,10,24,6,4,2,2,2,1,3,2003
365,Olumide Oyedeji,ORL,27,144,5,11,4,1,1,1,2,0,1,2003
366,Efthimios Rentzias,PHI,35,143,7,16,5,2,3,0,2,1,1,2003
367,Reggie Slater,MIN,26,142,4,8,4,0,3,0,1,0,0,2003
368,Bruno Sundov,BOS,26,139,7,15,6,1,3,3,0,0,1,2003
369,Evan Eschmeyer,DAL,17,135,6,16,2,4,0,0,2,1,3,2003
370,Tim Hardaway,IND,10,126,24,49,23,1,6,6,11,1,0,2003
371,Damone Brown,TOR,5,115,3,6,3,0,2,0,1,0,0,2003
372,Roger Mason Jr.,CHI,17,114,12,27,9,3,3,3,3,0,3,2003
373,Fred Jones,IND,19,112,5,13,2,3,1,1,0,1,2,2003
374,Adam Harrington,DEN,19,110,12,25,11,1,6,1,4,0,1,2003
375,Primoz Brezec,IND,22,108,4,8,4,0,2,1,1,0,0,2003
376,Chris Childs,NJN,12,105,16,33,15,1,8,1,6,0,1,2003
377,Jason Collier,HOU,13,105,1,2,1,0,1,0,0,0,0,2003
378,Maceo Baston,TOR,16,104,0,0,0,0,0,0,0,0,0,2003
379,Oscar Torres,GSW,16,104,3,7,2,1,1,0,1,0,1,2003
380,Matt Maloney,ATL,14,103,17,40,11,6,4,2,5,1,5,2003
381,Mark Bryant,BOS,16,99,4,10,2,2,0,0,2,1,1,2003
382,Lavor Postell,NYK,12,99,3,7,2,1,1,0,1,1,0,2003
383,Jeff Trepagnier,DEN,8,97,6,13,5,1,1,1,3,1,0,2003
384,Dean Oliver,GSW,15,94,23,49,20,3,9,5,6,2,1,2003
385,Devin Brown,DEN,10,92,7,14,7,0,5,0,2,0,0,2003
386,Antoine Rigaudeau,DAL,11,89,6,15,3,3,0,2,1,2,1,2003
387,Cezary Trybanski,MEM,15,88,1,2,1,0,0,1,0,0,0,2003
388,Danny Manning,DET,13,88,7,15,6,1,4,1,1,0,1,2003
389,Michael Dickerson,MEM,6,87,8,16,8,0,2,5,1,0,0,2003
390,Anthony Goldwire,WAS,15,86,4,9,3,1,1,0,2,1,0,2003
391,Horace Grant,ORL,5,85,7,17,4,3,3,0,1,0,3,2003
392,Joseph Forte,SEA,17,85,11,23,10,1,3,1,6,0,1,2003
393,Jamison Brewer,IND,10,80,18,40,14,4,4,3,7,1,3,2003
394,Bryce Drew,NOH,13,80,11,23,10,1,2,3,5,1,0,2003
395,Bostjan Nachbar,HOU,14,78,3,6,3,0,2,1,0,0,0,2003
396,Nate Huffman,TOR,7,78,5,11,4,1,1,0,3,0,1,2003
397,Soumaila Samake,LAL,13,77,4,8,4,0,1,0,3,0,0,2003
398,Dalibor Bagaric,CHI,10,76,4,9,3,1,2,1,0,0,1,2003
399,Robert Archibald,MEM,12,72,3,6,3,0,2,0,1,0,0,2003
400,Amal McCaskill,ATL,11,70,5,11,4,1,2,1,1,0,1,2003
401,Brandon Armstrong,NJN,17,70,2,6,0,2,0,0,0,0,2,2003
402,Flip Murray,SEA,14,63,5,11,4,1,2,1,1,0,1,2003
403,Kirk Haston,NOH,12,58,3,6,3,0,3,0,0,0,0,2003
404,Mateen Cleaves,SAC,12,55,10,22,8,2,7,0,1,2,0,2003
405,Mengke Bateer,SAS,12,47,4,8,4,0,0,1,3,0,0,2003
406,Mikki Moore,ATL,8,43,3,6,3,0,2,0,1,0,0,2003
407,Chris Crawford,ATL,5,38,1,2,1,0,0,0,1,0,0,2003
408,Pepe Sanchez,DET,9,36,8,16,8,0,4,1,3,0,0,2003
409,Tito Maddox,HOU,9,34,5,11,4,1,2,0,2,0,1,2003
410,Antonio Harvey,ATL,4,33,0,0,0,0,0,0,0,0,0,2003
411,Alton Ford,PHX,11,29,1,2,1,0,1,0,0,0,0,2003
412,Ruben Wolkowyski,BOS,7,24,1,2,1,0,0,1,0,0,0,2003
413,Brandon Williams,ATL,6,20,0,0,0,0,0,0,0,0,0,2003
414,Brian Cardinal,WAS,5,14,1,2,1,0,1,0,0,0,0,2003
415,Mark Strickland,DAL,4,13,0,0,0,0,0,0,0,0,0,2003
416,Charles Smith,POR,3,13,1,2,1,0,1,0,0,0,0,2003
417,Randy Livingston,NOH,2,12,1,3,0,1,0,0,0,1,0,2003
418,Zendon Hamilton,TOR,3,11,0,0,0,0,0,0,0,0,0,2003
419,Chris Dudley,POR,3,10,0,0,0,0,0,0,0,0,0,2003
420,Don Reid,DET,1,10,0,0,0,0,0,0,0,0,0,2003
421,Jamal Sampson,MIL,5,9,1,2,1,0,1,0,0,0,0,2003
422,A.J. Guyton,GSW,2,9,2,5,1,1,0,0,1,0,1,2003
423,Chris Owens,MEM,1,6,0,0,0,0,0,0,0,0,0,2003
424,Donny Marshall,NJN,3,6,0,0,0,0,0,0,0,0,0,2003
425,Paul Shirley,ATL,2,6,0,0,0,0,0,0,0,0,0,2003
426,Ruben Boumtje-Boumtje,POR,2,5,1,2,1,0,1,0,0,0,0,2003
427,Guy Rucker,GSW,3,3,1,2,1,0,1,0,0,0,0,2003
0,Antoine Walker,BOS,81,3407,407,902,319,88,184,25,110,19,69,2002
1,Tim Duncan,SAS,82,3332,307,684,237,70,166,22,49,20,50,2002
2,Latrell Sprewell,NYK,81,3328,313,711,228,85,81,73,74,33,52,2002
3,Baron Davis,CHH,82,3320,698,1478,616,82,293,77,246,23,59,2002
4,Paul Pierce,BOS,82,3299,261,609,174,87,87,18,69,23,64,2002
5,Gary Payton,SEA,82,3297,737,1666,545,192,226,111,208,43,149,2002
6,Stephon Marbury,PHX,82,3187,666,1439,559,107,270,68,221,38,69,2002
7,Kevin Garnett,MIN,81,3172,422,904,362,60,122,66,174,21,39,2002
8,Jalen Rose,CHI,83,3156,355,770,295,60,155,52,88,12,48,2002
9,Eddie Jones,MIA,81,3155,262,551,235,27,86,52,97,14,13,2002
10,Anthony Mason,MIL,82,3140,346,784,254,92,71,73,110,24,68,2002
11,Wally Szczerbiak,MIN,82,3121,257,551,220,37,69,68,83,10,27,2002
12,Cuttino Mobley,HOU,74,3116,187,425,136,51,69,13,54,19,32,2002
13,Shawn Marion,PHX,81,3108,163,354,135,28,64,30,41,4,24,2002
14,Shane Battier,MEM,78,3098,216,467,181,35,81,31,69,11,24,2002
15,Kobe Bryant,LAL,80,3065,438,1036,278,160,141,66,71,67,93,2002
16,Jason Kidd,NJN,82,3056,808,1743,681,127,443,94,144,21,106,2002
17,Brent Barry,SEA,81,3038,426,912,366,60,179,67,120,21,39,2002
18,Karl Malone,UTA,80,3038,341,710,313,28,192,24,97,5,23,2002
19,Antawn Jamison,GSW,82,3033,161,348,135,26,52,23,60,4,22,2002
20,Jeff McInnis,LAC,81,3032,500,1088,412,88,191,115,106,11,77,2002
21,Andre Miller,CLE,81,3019,882,1938,708,174,252,105,351,47,127,2002
22,Elton Brand,LAC,80,3016,191,447,126,65,54,32,40,6,59,2002
23,Pau Gasol,MEM,82,3002,223,487,182,41,64,41,77,11,30,2002
24,Shareef Abdur-Rahim,ATL,77,2978,239,560,157,82,83,15,59,18,64,2002
25,Antonio Davis,TOR,77,2977,155,342,123,32,49,20,54,11,21,2002
26,Jason Terry,ATL,78,2968,444,954,378,66,182,61,135,21,45,2002
27,Rasheed Wallace,POR,79,2966,152,326,130,22,83,11,36,4,18,2002
28,Alvin Williams,TOR,82,2933,468,1035,369,99,147,75,147,21,78,2002
29,Ben Wallace,DET,80,2919,115,265,80,35,29,9,42,15,20,2002
30,Allan Houston,NYK,77,2915,190,429,141,49,49,43,49,22,27,2002
31,Tracy McGrady,ORL,76,2909,400,930,270,130,146,27,97,36,94,2002
32,Dikembe Mutombo,PHI,80,2906,83,175,74,9,30,10,34,2,7,2002
33,Dirk Nowitzki,DAL,76,2891,186,426,132,54,65,31,36,9,45,2002
34,Reggie Miller,IND,79,2891,253,535,224,29,97,63,64,13,16,2002
35,Clifford Robinson,DET,80,2855,202,457,149,53,84,19,46,25,28,2002
36,Steve Nash,DAL,82,2838,634,1428,474,160,243,74,157,47,113,2002
37,Doug Christie,SAC,81,2796,340,718,302,38,156,30,116,23,15,2002
38,Damon Stoudamire,POR,75,2793,490,1096,374,116,176,55,143,31,85,2002
39,Wesley Person,CLE,78,2793,173,371,148,25,58,37,53,8,17,2002
40,Kurt Thomas,NYK,82,2770,87,195,66,21,36,12,18,4,17,2002
41,Michael Finley,DAL,69,2755,230,543,147,83,61,30,56,16,67,2002
42,Darrell Armstrong,ORL,82,2733,453,1031,328,125,168,22,138,19,106,2002
43,Jermaine O'Neal,IND,72,2708,118,255,99,19,47,10,42,9,10,2002
44,Jerry Stackhouse,DET,76,2686,403,932,277,126,144,53,80,36,90,2002
45,Mike Bibby,SAC,80,2657,403,893,316,87,168,28,120,31,56,2002
46,Peja Stojakovic,SAC,71,2648,175,392,133,42,56,17,60,19,23,2002
47,Juwan Howard,DEN,81,2634,169,380,127,42,61,19,47,11,31,2002
48,Jason Richardson,GSW,80,2628,236,501,207,29,78,57,72,5,24,2002
49,Allen Iverson,PHI,60,2624,331,689,304,27,132,58,114,18,9,2002
50,Sam Cassell,MIL,74,2607,493,1095,384,109,150,128,106,21,88,2002
51,Kerry Kittles,NJN,82,2599,216,484,164,52,86,26,52,14,38,2002
52,Rashard Lewis,SEA,71,2584,123,287,82,41,34,12,36,14,27,2002
53,Michael Olowokandi,LAC,80,2570,90,223,47,43,19,11,17,3,40,2002
54,John Stockton,UTA,82,2570,674,1418,604,70,340,64,200,22,48,2002
55,P.J. Brown,CHH,80,2563,107,242,79,28,25,17,37,5,23,2002
56,Matt Harpring,PHI,81,2547,107,235,86,21,29,29,28,2,19,2002
57,Ray Allen,MIL,69,2526,271,616,197,74,90,47,60,23,51,2002
58,Kenyon Martin,NJN,73,2505,192,423,153,39,82,21,50,9,30,2002
59,Nick Van Exel,DAL,72,2498,478,1056,378,100,195,43,140,35,65,2002
60,David Wesley,CHH,67,2490,236,511,197,39,89,44,64,4,35,2002
61,Kenny Thomas,HOU,72,2482,137,325,86,51,47,9,30,21,30,2002
62,Anfernee Hardaway,PHX,80,2465,324,695,277,47,133,49,95,8,39,2002
63,Keith Van Horn,NJN,81,2462,164,355,137,27,73,25,39,5,22,2002
64,Raef LaFrentz,DAL,78,2454,89,196,71,18,33,10,28,8,10,2002
65,Alonzo Mourning,MIA,75,2453,87,190,71,16,33,5,33,9,7,2002
66,Dale Davis,POR,78,2447,96,215,73,23,34,7,32,4,19,2002
67,Jamaal Tinsley,IND,80,2443,647,1423,518,129,231,118,169,43,86,2002
68,Kenny Anderson,BOS,76,2428,403,960,249,154,139,26,84,32,122,2002
69,Shaquille O'Neal,LAL,67,2421,200,446,154,46,93,19,42,6,40,2002
70,Vlade Divac,SAC,80,2419,297,636,255,42,130,25,100,14,28,2002
71,Desmond Mason,SEA,75,2418,104,248,64,40,31,9,24,16,24,2002
72,Pat Garrity,ORL,80,2401,99,239,58,41,25,11,22,9,32,2002
73,Vince Carter,TOR,60,2386,239,519,198,41,105,33,60,13,28,2002
74,Mark Jackson,NYK,82,2364,605,1339,476,129,160,97,219,30,99,2002
75,Chauncey Billups,MIN,82,2356,450,969,381,69,110,102,169,16,53,2002
76,Bonzi Wells,POR,74,2351,204,439,173,31,103,25,45,9,22,2002
77,Glenn Robinson,MIL,66,2348,168,384,120,48,57,36,27,16,32,2002
78,Steve Francis,HOU,57,2341,362,816,270,92,149,23,98,25,67,2002
79,Lamond Murray,CLE,71,2311,157,334,137,20,59,34,44,7,13,2002
80,David Robinson,SAS,78,2305,94,207,75,19,53,9,13,5,14,2002
81,Rod Strickland,MIA,76,2291,463,1005,384,79,125,56,203,28,51,2002
82,Rick Fox,LAL,82,2290,283,617,232,51,135,47,50,19,32,2002
83,Chucky Atkins,DET,79,2281,263,587,202,61,91,36,75,25,36,2002
84,Tony Parker,SAS,77,2271,334,743,259,75,114,66,79,45,30,2002
85,Brad Miller,IND,76,2264,152,322,134,18,47,22,65,3,15,2002
86,Brian Grant,MIA,72,2257,137,290,121,16,59,23,39,3,13,2002
87,Moochie Norris,HOU,82,2246,403,936,273,130,136,31,106,30,100,2002
88,James Posey,DEN,73,2243,180,410,130,50,54,23,53,15,35,2002
89,Jason Williams,MEM,65,2238,519,1089,468,51,243,84,141,20,31,2002
90,Trenton Hassell,CHI,78,2236,172,369,147,25,56,32,59,6,19,2002
91,Eric Snow,PHI,61,2225,400,854,346,54,147,75,124,15,39,2002
92,Darius Miles,LAC,82,2225,184,422,130,54,64,34,32,11,43,2002
93,Rasho Nesterovic,MIN,82,2221,75,167,58,17,22,12,24,3,14,2002
94,Danny Fortson,GSW,77,2219,127,278,103,24,58,31,14,3,21,2002
95,Steven Smith,SAS,77,2212,151,339,114,37,62,28,24,18,19,2002
96,Horace Grant,ORL,76,2212,104,248,64,40,26,11,27,8,32,2002
97,Richard Hamilton,WAS,63,2200,171,360,153,18,58,31,64,5,13,2002
98,Keon Clark,TOR,81,2187,88,198,66,22,36,11,19,5,17,2002
99,Chris Whitney,WAS,82,2171,314,652,290,24,96,53,141,5,19,2002
100,Nazr Mohammed,ATL,82,2170,33,73,26,7,21,3,2,1,6,2002
101,Antonio Daniels,SAS,82,2170,228,519,165,63,64,41,60,35,28,2002
102,Elden Campbell,CHH,77,2158,102,226,80,22,29,13,38,5,17,2002
103,Quentin Richardson,LAC,81,2154,128,280,104,24,52,28,24,4,20,2002
104,Andrei Kirilenko,UTA,82,2154,94,196,86,8,42,6,38,3,5,2002
105,Jumaine Jones,CLE,81,2143,116,253,95,21,34,23,38,9,12,2002
106,Robert Horry,LAL,81,2143,232,509,187,45,102,33,52,9,36,2002
107,Mike Miller,ORL,63,2128,198,444,150,48,57,13,80,14,34,2002
108,Michael Jordan,WAS,60,2089,310,685,245,65,86,45,114,19,46,2002
109,Derrick Coleman,PHI,58,2081,98,200,94,4,54,16,24,2,2,2002
110,Chris Webber,SAC,54,2072,259,567,210,49,113,28,69,17,32,2002
111,Anthony Peeler,MIN,82,2060,177,380,151,26,57,36,58,10,16,2002
112,Larry Hughes,GSW,73,2046,316,671,277,39,128,65,84,12,27,2002
113,Scottie Pippen,POR,62,1999,363,797,292,71,135,44,113,26,45,2002
114,Bryon Russell,UTA,66,1998,136,288,120,16,48,19,53,0,16,2002
115,Tim Thomas,MIL,74,1991,105,247,68,37,24,18,26,18,19,2002
116,Morris Peterson,TOR,63,1990,153,329,130,23,59,26,45,10,13,2002
117,Jon Barry,DET,82,1989,274,609,213,61,122,53,38,29,32,2002
118,Derek Fisher,LAL,70,1975,181,388,155,26,82,40,33,6,20,2002
119,Hedo Turkoglu,SAC,80,1969,163,369,120,43,67,9,44,15,28,2002
120,Marcus Fizer,CHI,76,1965,120,268,92,28,34,9,49,5,23,2002
121,Ricky Davis,CLE,82,1956,178,401,133,45,50,32,51,19,26,2002
122,Bo Outlaw,PHX,83,1929,127,275,106,21,44,21,41,4,17,2002
123,Joe Smith,MIN,72,1925,82,183,63,19,20,13,30,3,16,2002
124,Richard Jefferson,NJN,79,1919,140,305,115,25,58,19,38,8,17,2002
125,Kelvin Cato,HOU,75,1919,29,65,22,7,13,0,9,3,4,2002
126,Popeye Jones,WAS,79,1918,127,271,110,17,50,15,45,3,14,2002
127,Joe Johnson,PHX,77,1917,179,407,130,49,46,28,56,15,34,2002
128,Lee Nailon,CHH,79,1913,94,202,80,14,37,12,31,3,11,2002
129,Michael Curry,DET,82,1905,127,308,73,54,32,10,31,21,33,2002
130,Eddie Griffin,HOU,73,1895,53,121,38,15,14,9,15,2,13,2002
131,Scot Pollard,SAC,80,1882,53,116,43,10,19,7,17,1,9,2002
132,Rodney Rogers,BOS,77,1880,111,243,90,21,52,21,17,4,17,2002
133,Grant Long,MEM,66,1868,136,288,120,16,57,28,35,8,8,2002
134,Troy Hudson,ORL,81,1857,255,563,202,53,113,20,69,16,37,2002
135,Derek Anderson,POR,70,1856,216,481,167,49,88,23,56,9,40,2002
136,Jacque Vaughn,ATL,82,1855,349,769,278,71,133,35,110,29,42,2002
137,George McCloud,DEN,69,1832,204,441,171,33,74,51,46,11,22,2002
138,Jim Jackson,MIA,55,1823,140,298,122,18,41,21,60,8,10,2002
139,Tony Battie,BOS,74,1821,35,82,23,12,10,3,10,1,11,2002
140,Stromile Swift,MEM,68,1801,50,108,42,8,17,8,17,1,7,2002
141,Jeff Foster,IND,82,1785,70,151,59,11,32,9,18,4,7,2002
142,Bob Sura,GSW,78,1784,275,595,230,45,108,42,80,10,35,2002
143,Rodney Buford,MEM,63,1770,71,153,60,11,31,9,20,5,6,2002
144,Ruben Patterson,POR,75,1766,107,238,83,24,37,9,37,11,13,2002
145,Devean George,LAL,82,1762,111,250,83,28,35,16,32,7,21,2002
146,Bobby Jackson,SAC,81,1753,164,363,129,35,64,18,47,11,24,2002
147,Travis Best,CHI,74,1750,324,712,260,64,82,59,119,25,39,2002
148,Eric Williams,BOS,74,1750,109,272,55,54,31,8,16,11,43,2002
149,Donyell Marshall,UTA,58,1749,101,213,90,11,51,12,27,2,9,2002
150,Erick Dampier,GSW,73,1737,87,192,69,18,26,12,31,2,16,2002
151,Malik Rose,SAS,82,1728,61,140,43,18,26,7,10,9,9,2002
152,Clar. Weatherspoon,NYK,56,1726,60,134,46,14,24,10,12,3,11,2002
153,Kevin Ollie,IND,81,1724,291,640,233,58,72,39,122,7,51,2002
154,DerMarr Johnson,ATL,72,1722,81,171,72,9,44,7,21,3,6,2002
155,Ron Mercer,IND,53,1718,128,281,103,25,36,14,53,4,21,2002
156,Eric Piatkowski,LAC,71,1717,112,231,105,7,37,50,18,1,6,2002
157,Vin Baker,SEA,55,1711,72,171,45,27,17,11,17,5,22,2002
158,Corliss Williamson,DET,78,1707,94,226,56,38,26,12,18,15,23,2002
159,Bruce Bowen,SAS,59,1699,88,201,63,25,26,17,20,14,11,2002
160,Ryan Bowen,DEN,75,1688,52,115,41,11,22,6,13,3,8,2002
161,LaPhonso Ellis,MIA,66,1684,56,122,46,10,15,3,28,4,6,2002
162,Ervin Johnson,MIL,81,1659,27,64,17,10,8,2,7,6,4,2002
163,Chris Mihm,CLE,74,1658,24,56,16,8,5,3,8,1,7,2002
164,Voshon Lenard,DEN,71,1656,130,286,104,26,51,11,42,9,17,2002
165,Samaki Walker,LAL,69,1654,64,150,42,22,16,8,18,2,20,2002
166,Jonathan Bender,IND,78,1646,62,135,51,11,12,17,22,6,5,2002
167,Metta World Peace,IND,55,1641,127,272,109,18,56,12,41,3,15,2002
168,Erick Strickland,BOS,79,1640,184,455,97,87,47,18,32,21,66,2002
169,Calbert Cheaney,DEN,68,1637,110,243,87,23,41,15,31,10,13,2002
170,Jerome Williams,TOR,68,1636,75,169,56,19,15,9,32,5,14,2002
171,Corey Maggette,LAC,63,1617,112,243,93,19,40,30,23,6,13,2002
172,Lindsey Hunter,LAL,82,1614,129,281,106,23,49,22,35,12,11,2002
173,Tim Hardaway,DEN,68,1600,278,601,233,45,91,48,94,9,36,2002
174,Jamal Mashburn,CHH,40,1596,171,374,139,32,63,27,49,9,23,2002
175,Shandon Anderson,NYK,82,1595,76,168,60,16,27,17,16,4,12,2002
176,Jake Tsakalidis,PHX,67,1585,23,50,19,4,9,3,7,1,3,2002
177,Chris Childs,TOR,69,1579,351,757,296,55,121,47,128,16,39,2002
178,Othella Harrington,NYK,77,1564,37,89,22,15,6,9,7,4,11,2002
179,Lucious Harris,NJN,74,1556,116,259,89,27,39,16,34,8,19,2002
180,Jamaal Magloire,CHH,82,1552,31,66,27,4,9,5,13,0,4,2002
181,Aaron Williams,NJN,82,1550,77,163,68,9,27,8,33,5,4,2002
182,Speedy Claxton,PHI,67,1530,198,426,168,30,68,32,68,13,17,2002
183,Greg Anthony,MIL,60,1513,282,601,245,37,92,45,108,14,23,2002
184,Todd MacCulloch,NJN,62,1502,78,169,65,13,22,10,33,4,9,2002
185,Tyrone Nesby,WAS,70,1499,91,202,71,20,19,17,35,6,14,2002
186,Toni Kukoc,ATL,59,1496,209,458,169,40,103,19,47,7,33,2002
187,Adonal Foyle,GSW,79,1485,41,86,37,4,19,9,9,0,4,2002
188,Aaron McKie,PHI,48,1469,179,373,164,15,67,37,60,3,12,2002
189,Tyronn Lue,WAS,71,1462,246,511,227,19,71,46,110,4,15,2002
190,Troy Murphy,GSW,82,1450,70,156,54,16,28,10,16,4,12,2002
191,Tony Delk,BOS,63,1446,132,306,90,42,40,17,33,4,38,2002
192,Jarron Collins,UTA,70,1445,58,128,46,12,22,4,20,2,10,2002
193,Christian Laettner,WAS,57,1444,151,327,126,25,33,30,63,4,21,2002
194,Corie Blount,PHI,72,1429,44,96,36,8,24,4,8,3,5,2002
195,Michael Redd,MIL,67,1417,91,204,69,22,27,18,24,7,15,2002
196,Kendall Gill,MIA,65,1414,100,216,84,16,40,14,30,7,9,2002
197,Fred Hoiberg,CHI,79,1406,136,291,117,19,44,19,54,5,14,2002
198,Jason Collins,NJN,77,1403,81,173,70,11,32,10,28,3,8,2002
199,Tyson Chandler,CHI,71,1393,54,112,50,4,24,5,21,3,1,2002
200,Adrian Griffin,DAL,58,1387,106,249,69,37,31,12,26,12,25,2002
201,Charles Oakley,CHI,57,1384,114,241,101,13,43,17,41,2,11,2002
202,Hakeem Olajuwon,TOR,61,1375,66,148,50,16,29,5,16,2,14,2002
203,Hanno Mottola,ATL,82,1368,50,120,30,20,17,2,11,5,15,2002
204,Avery Johnson,DAL,68,1353,286,651,207,79,89,27,91,32,47,2002
205,Eduardo Najera,DAL,62,1351,38,92,22,16,10,3,9,2,14,2002
206,Jahidi White,WAS,71,1347,17,38,13,4,7,1,5,0,4,2002
207,Vitaly Potapenko,BOS,79,1344,30,72,18,12,4,2,12,1,11,2002
208,Zydrunas Ilgauskas,CLE,62,1330,70,158,52,18,30,9,13,2,16,2002
209,Courtney Alexander,WAS,56,1323,86,185,73,13,16,24,33,4,9,2002
210,Stacey Augmon,CHH,77,1316,103,233,76,27,27,16,33,6,21,2002
211,Al Harrington,IND,44,1309,54,123,39,15,18,4,17,8,7,2002
212,Scott Padgett,UTA,75,1292,82,182,64,18,31,7,26,4,14,2002
213,Terry Porter,SAS,72,1289,205,458,157,48,87,31,39,26,22,2002
214,Monty Williams,ORL,68,1285,96,217,71,25,35,8,28,7,18,2002
215,Austin Croshere,IND,76,1283,77,181,50,27,24,9,17,11,16,2002
216,Ira Newble,ATL,42,1275,45,106,29,16,15,6,8,4,12,2002
217,Brendan Haywood,WAS,62,1267,29,63,24,5,4,9,11,2,3,2002
218,Lorenzen Wright,MEM,43,1251,44,100,32,12,13,8,11,4,8,2002
219,Tony Massenburg,MEM,73,1245,26,54,24,2,7,3,14,0,2,2002
220,Chris Mills,GSW,66,1235,72,163,53,19,20,13,20,7,12,2002
221,Vladimir Radmanovic,SEA,61,1235,81,180,63,18,25,13,25,9,9,2002
222,Shawn Kemp,POR,75,1235,52,115,41,11,25,4,12,2,9,2002
223,Hubert Davis,WAS,51,1232,107,232,89,18,15,23,51,5,13,2002
224,Eddie House,MIA,64,1230,123,272,97,26,35,10,52,9,17,2002
225,Darvin Ham,MIL,70,1207,73,171,48,25,23,12,13,12,13,2002
226,Dan Majerle,PHX,65,1182,90,188,82,8,34,26,22,1,7,2002
227,Zeljko Rebraca,DET,74,1178,38,96,18,20,11,2,5,5,15,2002
228,Predrag Drobnjak,SEA,64,1174,51,114,39,12,16,4,19,4,8,2002
229,Dion Glover,ATL,55,1156,84,185,67,17,29,13,25,8,9,2002
230,Gilbert Arenas,GSW,47,1152,174,390,132,42,65,23,44,14,28,2002
231,Eddy Curry,CHI,72,1151,25,53,22,3,9,4,9,0,3,2002
232,Brevin Knight,MEM,53,1149,302,645,261,41,118,52,91,6,35,2002
233,Charles Smith,SAS,60,1143,80,173,67,13,40,17,10,8,5,2002
234,Gary Trent,MIN,64,1141,60,138,42,18,12,11,19,3,15,2002
235,Tom Gugliotta,PHX,44,1134,77,164,67,10,35,15,17,2,8,2002
236,DeShawn Stevenson,UTA,67,1131,116,239,109,7,54,11,44,2,5,2002
237,Joel Przybilla,MIL,71,1126,21,45,18,3,7,7,4,3,0,2002
238,Walt Williams,HOU,48,1119,69,149,58,11,24,14,20,4,7,2002
239,Terence Morris,HOU,68,1115,64,142,50,14,23,6,21,5,9,2002
240,Greg Ostertag,UTA,74,1110,50,111,39,11,20,2,17,0,11,2002
241,Brian Skinner,CLE,65,1108,17,41,10,7,2,2,6,2,5,2002
242,Damon Jones,DET,67,1088,140,314,106,34,50,18,38,13,21,2002
243,Oscar Torres,HOU,65,1077,40,86,34,6,13,5,16,0,6,2002
244,Charlie Ward,NYK,63,1057,203,442,167,36,59,38,70,16,20,2002
245,Anthony Carter,MIA,46,1050,214,477,165,49,64,25,76,22,27,2002
246,Marcus Camby,NYK,29,1009,33,74,25,8,19,3,3,2,6,2002
247,Lamar Odom,LAC,29,999,171,370,143,28,54,55,34,4,24,2002
248,Art Long,SEA,63,989,41,88,35,6,18,6,11,2,4,2002
249,Earl Watson,SEA,64,965,125,272,103,22,45,14,44,8,14,2002
250,Terrell Brandon,MIN,32,964,264,556,236,28,96,41,99,9,19,2002
251,Jerome James,SEA,56,952,24,54,18,6,6,5,7,1,5,2002
252,John Starks,UTA,66,930,70,149,61,9,36,7,18,6,3,2002
253,Jake Voskuhl,PHX,59,901,18,38,16,2,8,3,5,0,2,2002
254,Patrick Ewing,ORL,65,899,35,84,21,14,11,2,8,5,9,2002
255,George Lynch,CHH,45,893,54,114,48,6,25,11,12,1,5,2002
256,Raja Bell,PHI,74,892,71,156,57,14,20,13,24,7,7,2002
257,Dell Curry,TOR,56,885,61,126,57,4,27,10,20,0,4,2002
258,Greg Buckner,DAL,44,885,48,106,38,10,18,5,15,2,8,2002
259,Vladimir Stepania,MIA,67,883,16,34,14,2,5,0,9,0,2,2002
260,Will Solomon,MEM,62,883,92,195,81,11,35,20,26,2,9,2002
261,Kevin Willis,HOU,52,866,14,36,6,8,4,1,1,3,5,2002
262,Zendon Hamilton,DEN,54,846,14,32,10,4,5,1,4,1,3,2002
263,Donnell Harvey,DEN,47,844,37,79,32,5,22,5,5,1,4,2002
264,Kwame Brown,WAS,57,817,43,93,36,7,19,5,12,0,7,2002
265,Chris Gatling,MIA,54,810,25,60,15,10,8,1,6,7,3,2002
266,Tyrone Hill,CLE,26,809,23,49,20,3,11,3,6,0,3,2002
267,John Crotty,UTA,41,799,141,313,110,31,43,15,52,10,21,2002
268,Danny Ferry,SAS,50,799,48,107,37,11,16,12,9,5,6,2002
269,Milt Palacio,PHX,69,790,83,196,53,30,27,6,20,9,21,2002
270,Derrick McKey,PHI,41,783,45,92,43,2,20,12,11,0,2,2002
271,Emanual Davis,ATL,28,775,68,150,54,14,23,16,15,3,11,2002
272,Steve Kerr,POR,65,773,63,142,47,16,17,10,20,3,13,2002
273,Bryce Drew,CHH,61,771,101,221,82,19,35,15,32,3,16,2002
274,Earl Boykins,LAC,68,762,145,316,119,26,52,25,42,6,20,2002
275,Shawn Bradley,DAL,53,757,20,41,19,1,11,1,7,0,1,2002
276,Scott Williams,DEN,41,736,13,33,6,7,3,1,2,0,7,2002
277,Sean Rooks,LAC,61,730,25,53,22,3,7,5,10,0,3,2002
278,Slava Medvedenko,LAL,71,725,43,96,33,10,10,3,20,1,9,2002
279,Johnny Newman,DAL,47,725,14,31,11,3,4,2,5,2,1,2002
280,Sam Mitchell,MIN,74,722,45,103,32,13,9,10,13,4,9,2002
281,Lawrence Funderburke,SAC,56,721,32,72,24,8,10,3,11,4,4,2002
282,Walter McCarty,BOS,56,719,41,100,23,18,11,6,6,5,13,2002
283,Don Reid,ORL,68,713,27,60,21,6,16,0,5,1,5,2002
284,Mitch Richmond,LAL,64,711,57,130,41,16,19,11,11,7,9,2002
285,Michael Doleac,CLE,42,709,25,52,23,2,7,5,11,1,1,2002
286,Bimbo Coles,CLE,47,694,107,228,93,14,25,12,56,5,9,2002
287,Jud Buechler,ORL,66,678,32,72,24,8,9,6,9,2,6,2002
288,Robert Traylor,CHH,61,678,37,78,33,4,20,6,7,2,2,2002
289,Bryant Stith,CLE,50,663,42,88,38,4,10,11,17,1,3,2002
290,Eric Montross,TOR,49,656,16,36,12,4,4,1,7,1,3,2002
291,Mark Strickland,ATL,46,656,20,49,11,9,3,0,8,5,4,2002
292,Eddie Robinson,CHI,29,652,37,76,35,2,18,3,14,1,1,2002
293,Mark Madsen,LAL,59,649,44,98,34,10,9,7,18,3,7,2002
294,Dalibor Bagaric,CHI,50,635,23,53,16,7,9,4,3,0,7,2002
295,Andrew DeClercq,ORL,61,635,22,52,14,8,7,1,6,5,3,2002
296,Brian Shaw,LAL,58,628,89,201,66,23,31,17,18,11,12,2002
297,Etan Thomas,WAS,47,621,6,13,5,1,4,0,1,0,1,2002
298,Howard Eisley,NYK,39,610,100,217,83,17,32,21,30,5,12,2002
299,Glen Rice,HOU,20,607,31,64,29,2,17,6,6,1,1,2002
300,A.J. Guyton,CHI,45,604,81,178,65,16,26,9,30,1,15,2002
301,Shammond Williams,SEA,50,603,83,181,68,15,27,13,28,5,10,2002
302,Mookie Blaylock,GSW,35,600,114,241,101,13,40,18,43,4,9,2002
303,Rafer Alston,MIL,50,596,143,333,96,47,33,22,41,18,29,2002
304,Wang Zhi-zhi,DAL,55,594,22,50,16,6,4,3,9,1,5,2002
305,Dana Barros,DET,29,586,77,166,65,12,22,14,29,3,9,2002
306,John Amaechi,UTA,54,586,29,63,24,5,9,1,14,1,4,2002
307,Cal Bowdler,ATL,52,585,11,23,10,1,5,1,4,0,1,2002
308,Felipe Lopez,MIN,67,573,39,84,33,6,11,10,12,1,5,2002
309,Kenny Satterfield,DEN,36,560,108,228,96,12,48,14,34,3,9,2002
310,Danny Manning,DAL,41,554,30,64,26,4,15,3,8,0,4,2002
311,Rusty LaRue,UTA,33,540,71,154,59,12,20,8,31,3,9,2002
312,Rick Brunson,POR,59,520,114,246,96,18,41,13,42,3,15,2002
313,Loren Woods,MIN,60,516,22,50,16,6,7,3,6,2,4,2002
314,Steven Hunter,ORL,53,514,5,13,2,3,2,0,0,1,2,2002
315,Grant Hill,ORL,14,514,64,141,51,13,22,9,20,4,9,2002
316,Marc Jackson,MIN,39,498,14,29,13,1,8,1,4,1,0,2002
317,Vonteego Cummings,PHI,58,495,60,127,53,7,23,12,18,2,5,2002
318,Quincy Lewis,UTA,36,488,36,78,30,6,14,4,12,2,4,2002
319,John Wallace,PHX,46,485,29,63,24,5,17,4,3,2,3,2002
320,Jamal Crawford,CHI,23,482,55,118,47,8,21,4,22,0,8,2002
321,Trajan Langdon,CLE,44,477,60,128,52,8,13,6,33,3,5,2002
322,Tracy Murray,TOR,40,473,19,40,17,2,8,3,6,1,1,2002
323,Alton Ford,PHX,52,450,7,14,7,0,3,0,4,0,0,2002
324,Tariq Abdul-Wahad,DAL,24,442,24,54,18,6,10,3,5,3,3,2002
325,Dan Langhi,HOU,34,433,14,32,10,4,2,1,7,3,1,2002
326,Gerald Wallace,SAC,54,432,27,61,20,7,10,3,7,1,6,2002
327,Travis Knight,NYK,49,430,8,18,6,2,3,1,2,1,1,2002
328,Mark Pope,MIL,45,425,17,43,8,9,3,2,3,4,5,2002
329,Alan Henderson,ATL,26,423,11,23,10,1,4,1,5,0,1,2002
330,Mark Blount,BOS,44,416,10,24,6,4,2,3,1,0,4,2002
331,Mengke Bateer,DEN,27,408,22,46,20,2,10,2,8,0,2,2002
332,Tierre Brown,HOU,40,402,70,157,53,17,25,5,23,7,10,2002
333,Eddie Gill,MEM,23,381,49,104,43,6,17,11,15,2,4,2002
334,Carlos Arroyo,DEN,37,370,70,147,63,7,41,8,14,0,7,2002
335,Anthony Johnson,NJN,34,366,48,103,41,7,16,4,21,3,4,2002
336,Jason Collier,HOU,25,363,9,21,6,3,2,1,3,2,1,2002
337,Matt Bullard,CHH,31,350,16,36,12,4,3,2,7,1,3,2002
338,Tremaine Fowlkes,LAC,22,341,17,39,12,5,1,6,5,0,5,2002
339,Bobby Simmons,WAS,30,340,17,37,14,3,7,5,2,2,1,2002
340,Chris Dudley,POR,43,327,13,31,8,5,3,0,5,1,4,2002
341,Sean Marks,MIA,21,319,8,18,6,2,2,1,3,1,1,2002
342,Antonis Fotsis,MEM,28,317,10,21,9,1,7,0,2,0,1,2002
343,Ike Austin,MEM,21,306,13,28,11,2,3,1,7,2,0,2002
344,Evan Eschmeyer,DAL,31,299,9,21,6,3,5,0,1,0,3,2002
345,Derrick Dial,TOR,32,299,35,75,30,5,11,5,14,2,3,2002
346,Brian Scalabrine,NJN,28,291,21,51,12,9,7,0,5,3,6,2002
347,Jason Caffey,MIL,23,285,12,29,7,5,5,2,0,1,4,2002
348,Calvin Booth,SEA,15,278,16,33,15,1,6,1,8,0,1,2002
349,Jermaine Jackson,TOR,24,278,57,124,47,10,20,4,23,5,5,2002
350,Chris Andersen,DEN,24,261,7,15,6,1,4,0,2,0,1,2002
351,William Avery,MIN,28,260,36,79,29,7,6,7,16,0,7,2002
352,Robert Pack,MIN,16,254,49,103,44,5,14,13,17,3,2,2002
353,Shawnelle Scott,DEN,21,249,8,17,7,1,4,2,1,1,0,2002
354,Felton Spencer,NYK,32,248,3,7,2,1,1,1,0,0,1,2002
355,Kedrick Brown,BOS,29,245,15,39,6,9,3,1,2,2,7,2002
356,Ruben Boumtje-Boumtje,POR,33,245,4,10,2,2,2,0,0,1,1,2002
357,Zach Randolph,POR,40,237,13,30,9,4,4,2,3,0,4,2002
358,Antonio McDyess,DEN,10,235,18,41,13,5,5,3,5,0,5,2002
359,Cherokee Parks,SAS,42,233,10,21,9,1,4,1,4,1,0,2002
360,Erick Barkley,POR,19,226,34,73,29,5,12,6,11,0,5,2002
361,Stephen Jackson,SAS,23,226,11,23,10,1,7,3,0,1,0,2002
362,Olumide Oyedeji,SEA,36,222,4,8,4,0,1,2,1,0,0,2002
363,Nick Anderson,MEM,15,220,14,30,12,2,6,2,4,2,0,2002
364,Mikki Moore,DET,29,213,12,26,10,2,7,0,3,2,0,2002
365,Mark Bryant,SAS,30,202,10,22,8,2,7,1,0,0,2,2002
366,Brandon Armstrong,NJN,35,195,8,17,7,1,3,2,2,1,0,2002
367,Jabari Smith,PHI,23,181,11,22,11,0,2,1,8,0,0,2002
368,Dean Garrett,GSW,34,181,5,11,4,1,1,1,2,1,0,2002
369,Lavor Postell,NYK,23,178,5,10,5,0,1,2,2,0,0,2002
370,Harold Jamison,LAC,25,177,6,13,5,1,1,4,0,1,0,2002
371,Randy Livingston,SEA,13,176,26,55,23,3,8,8,7,0,3,2002
372,Samuel Dalembert,PHI,34,176,5,10,5,0,3,0,2,0,0,2002
373,Isaiah Rider,DEN,10,174,12,24,12,0,5,3,4,0,0,2002
374,Carlos Rogers,IND,22,169,3,6,3,0,1,0,2,0,0,2002
375,Michael Ruffin,PHI,15,169,5,11,4,1,1,2,1,0,1,2002
376,Malik Allen,MIA,12,161,5,12,3,2,1,0,2,2,0,2002
377,Sam Mack,MIA,12,161,4,8,4,0,1,1,2,0,0,2002
378,Primoz Brezec,IND,22,161,6,13,5,1,3,1,1,1,0,2002
379,Keyon Dooling,LAC,14,157,12,28,8,4,4,1,3,1,3,2002
380,Mateen Cleaves,SAC,32,155,25,54,21,4,13,1,7,2,2,2002
381,Joe Crispin,PHX,21,154,26,56,22,4,7,7,8,1,3,2002
382,Amal McCaskill,SAS,27,153,4,8,4,0,4,0,0,0,0,2002
383,Obinna Ekezie,LAC,28,147,3,8,1,2,0,0,1,0,2,2002
384,Jaren Jackson,ORL,9,144,8,21,3,5,2,0,1,0,5,2002
385,Ansu Sesay,SEA,9,141,8,18,6,2,5,1,0,0,2,2002
386,Dean Oliver,GSW,20,139,21,49,14,7,4,2,8,2,5,2002
387,Doug Overton,LAC,18,131,13,30,9,4,3,2,4,0,4,2002
388,Chris Crawford,ATL,7,131,5,11,4,1,2,1,1,1,0,2002
389,Rodney White,DET,16,127,12,25,11,1,4,2,5,1,0,2002
390,Michael Dickerson,MEM,4,126,9,22,5,4,3,2,0,2,2,2002
391,Alvin Jones,PHI,23,125,3,6,3,0,1,1,1,0,0,2002
392,Donny Marshall,NJN,20,119,5,11,4,1,1,0,3,0,1,2002
393,Michael Bradley,TOR,26,118,3,6,3,0,0,2,1,0,0,2002
394,Mike James,MIA,15,118,19,43,14,5,7,1,6,3,2,2002
395,DeSagana Diop,CLE,18,109,5,11,4,1,3,1,0,0,1,2002
396,Jelani McCoy,LAL,21,104,7,14,7,0,5,0,2,0,0,2002
397,Leon Smith,ATL,14,101,3,6,3,0,3,0,0,0,0,2002
398,Tang Hamilton,MIA,9,98,5,11,4,1,2,0,2,0,1,2002
399,Victor Alexander,DET,14,95,6,15,3,3,2,0,1,1,2,2002
400,Jason Hart,SAS,10,93,12,29,7,5,4,1,2,3,2,2002
401,Chucky Brown,SAC,18,92,6,14,4,2,2,0,2,1,1,2002
402,Michael Stewart,TOR,11,91,3,6,3,0,0,2,1,0,0,2002
403,Mitchell Butler,POR,11,90,5,12,3,2,2,0,1,1,1,2002
404,Brent Price,SAC,20,89,9,20,7,2,3,1,3,1,1,2002
405,Bruno Sundov,IND,21,85,3,6,3,0,2,1,0,0,0,2002
406,Theo Ratliff,ATL,3,82,1,2,1,0,1,0,0,0,0,2002
407,Kirk Haston,CHH,15,77,5,10,5,0,3,1,1,0,0,2002
408,Jeff Trepagnier,CLE,12,76,12,26,10,2,7,1,2,0,2,2002
409,Ike Fontaine,MEM,6,76,4,8,4,0,2,1,1,0,0,2002
410,Jerome Moiso,CHH,15,75,4,8,4,0,0,3,1,0,0,2002
411,Cedric Henderson,GSW,12,69,4,8,4,0,2,0,2,0,0,2002
412,Norman Richardson,CHI,11,68,2,4,2,0,2,0,0,0,0,2002
413,Dee Brown,ORL,7,66,2,4,2,0,2,0,0,0,0,2002
414,Damone Brown,PHI,17,64,2,4,2,0,2,0,0,0,0,2002
415,Steve Goodrich,NJN,9,49,5,11,4,1,1,1,2,1,0,2002
416,Antonio Harvey,SEA,5,48,5,11,4,1,1,2,1,1,0,2002
417,Elliot Perry,MEM,2,48,7,14,7,0,3,2,2,0,0,2002
418,Reggie Slater,ATL,8,47,1,2,1,0,1,0,0,0,0,2002
419,Mamadou N'diaye,TOR,5,47,0,0,0,0,0,0,0,0,0,2002
420,Maurice Evans,MIN,10,43,4,9,3,1,2,0,1,0,1,2002
421,Brian Cardinal,DET,8,43,2,5,1,1,0,0,1,0,1,2002
422,Charlie Bell,DAL,7,42,2,4,2,0,1,0,1,0,0,2002
423,Jamison Brewer,IND,13,41,9,20,7,2,1,1,5,0,2,2002
424,Tim James,PHI,9,41,1,2,1,0,0,0,1,0,0,2002
425,Joseph Forte,BOS,8,38,6,14,4,2,2,0,2,1,1,2002
426,Matt Geiger,PHI,4,35,0,0,0,0,0,0,0,0,0,2002
427,Jeryl Sasser,ORL,7,34,2,5,1,1,1,0,0,1,0,2002
428,Eldridge Recasner,LAC,6,33,5,12,3,2,2,0,1,0,2,2002
429,Ira Bowman,PHI,3,29,1,2,1,0,1,0,0,0,0,2002
430,Greg Foster,MIL,6,25,1,2,1,0,1,0,0,0,0,2002
431,Daniel Santiago,PHX,3,24,2,5,1,1,0,0,1,0,1,2002
432,Darrick Martin,DAL,3,22,3,8,1,2,0,0,1,0,2,2002
433,Ernest Brown,MIA,3,21,0,0,0,0,0,0,0,0,0,2002
434,Mike Penberthy,LAL,3,12,2,4,2,0,1,0,1,0,0,2002
435,Larry Robinson,NYK,2,11,0,0,0,0,0,0,0,0,0,2002
436,Randy Brown,BOS,1,6,2,4,2,0,0,0,2,0,0,2002
437,Ratko Varda,DET,1,6,0,0,0,0,0,0,0,0,0,2002
438,Vinny Del Negro,PHX,2,5,2,6,0,2,0,0,0,1,1,2002
439,Dickey Simpkins,ATL,1,3,1,3,0,1,0,0,0,0,1,2002
0,Michael Finley,DAL,82,3444,360,841,239,121,112,48,79,44,77,2001
1,Antoine Walker,BOS,81,3394,445,960,375,70,186,52,137,22,48,2001
2,Antawn Jamison,GSW,82,3393,164,352,140,24,56,32,52,9,15,2001
3,Anthony Mason,MIA,80,3255,248,605,139,109,57,22,60,27,82,2001
4,Gary Payton,SEA,79,3244,642,1415,511,131,273,109,129,30,101,2001
5,Shareef Abdur-Rahim,VAN,81,3241,250,556,194,56,58,25,111,9,47,2001
6,Jerry Stackhouse,DET,80,3211,410,900,330,80,144,40,146,29,51,2001
7,Kevin Garnett,MIN,81,3203,401,873,330,71,112,57,161,20,51,2001
8,Steve Francis,HOU,80,3194,517,1149,402,115,229,62,111,38,77,2001
9,Mike Bibby,VAN,82,3191,685,1425,630,55,261,96,273,21,34,2001
10,Baron Davis,CHH,82,3189,598,1284,510,88,188,105,217,19,69,2001
11,Reggie Miller,IND,81,3183,260,557,223,37,86,65,72,13,24,2001
12,Tim Duncan,SAS,82,3174,245,554,181,64,102,21,58,18,46,2001
13,Ray Allen,MIL,82,3131,374,846,276,98,101,78,97,36,62,2001
14,Paul Pierce,BOS,82,3124,253,588,171,82,87,28,56,35,47,2001
15,Dirk Nowitzki,DAL,82,3123,173,387,132,41,74,26,32,10,31,2001
16,David Wesley,CHH,82,3105,361,781,302,59,119,77,106,20,39,2001
17,Tracy McGrady,ORL,77,3094,352,787,269,83,162,34,73,16,67,2001
18,Jason Terry,ATL,82,3091,403,853,356,47,152,74,130,16,31,2001
19,Jason Kidd,PHX,77,3067,753,1604,655,98,265,137,253,27,71,2001
20,Latrell Sprewell,NYK,77,3013,269,615,192,77,89,40,63,20,57,2001
21,Cuttino Mobley,HOU,79,3006,195,438,147,48,84,23,40,14,34,2001
22,Jamal Mashburn,CHH,76,2992,411,881,352,59,145,69,138,12,47,2001
23,Vince Carter,TOR,75,2980,291,621,252,39,106,38,108,13,26,2001
24,Allen Iverson,PHI,71,2976,325,696,279,46,136,62,81,22,24,2001
25,Juwan Howard,DAL,81,2976,224,502,170,54,91,33,46,13,41,2001
26,Jalen Rose,IND,72,2948,435,958,347,88,137,73,137,34,54,2001
27,Rasheed Wallace,POR,77,2943,212,463,173,39,99,35,39,9,30,2001
28,Doug Christie,SAC,81,2941,289,623,244,45,125,44,75,13,32,2001
29,Shaquille O'Neal,LAL,74,2922,277,644,187,90,101,16,70,3,87,2001
30,Elton Brand,CHI,74,2910,240,543,177,63,66,21,90,8,55,2001
31,Peja Stojakovic,SAC,75,2905,164,358,134,30,71,16,47,12,18,2001
32,Karl Malone,UTA,81,2891,361,776,307,54,177,41,89,17,37,2001
33,Derek Anderson,SAS,82,2860,301,674,229,72,115,51,63,33,39,2001
34,Shawn Marion,PHX,79,2859,160,352,128,32,55,24,49,10,22,2001
35,Allan Houston,NYK,78,2858,173,382,137,36,69,34,34,14,22,2001
36,Wally Szczerbiak,MIN,82,2856,260,571,209,51,66,49,94,19,32,2001
37,Andre Miller,CLE,82,2847,657,1388,583,74,275,86,222,32,42,2001
38,Chris Webber,SAC,70,2835,294,669,213,81,135,39,39,18,63,2001
39,Lamar Odom,LAC,76,2830,392,859,317,75,146,90,81,19,56,2001
40,Jeff McInnis,LAC,81,2829,447,993,348,99,143,94,111,13,86,2001
41,Terrell Brandon,MIN,78,2822,583,1231,518,65,188,87,243,25,40,2001
42,Glenn Robinson,MIL,76,2812,252,575,181,71,69,48,64,32,39,2001
43,P.J. Brown,CHH,80,2806,127,278,103,24,34,27,42,4,20,2001
44,Kobe Bryant,LAL,68,2791,338,735,279,59,153,65,61,14,45,2001
45,Clar. Weatherspoon,CLE,82,2778,103,217,92,11,37,17,38,4,7,2001
46,Darrell Armstrong,ORL,75,2774,524,1149,423,101,174,43,206,13,88,2001
47,Brian Grant,MIA,82,2774,101,221,82,19,53,17,12,3,16,2001
48,Charles Oakley,TOR,78,2767,264,590,202,62,95,39,68,13,49,2001
49,Ben Wallace,DET,80,2762,123,281,88,35,39,8,41,11,24,2001
50,Clifford Robinson,PHX,82,2752,237,519,192,45,94,36,62,20,25,2001
51,Antonio Davis,TOR,78,2731,106,233,85,21,35,10,40,5,16,2001
52,Rashard Lewis,SEA,78,2723,125,284,91,34,49,15,27,10,24,2001
53,Sam Cassell,MIL,76,2711,580,1301,439,141,159,117,163,33,108,2001
54,Bruce Bowen,MIA,82,2687,132,305,91,41,31,15,45,13,28,2001
55,Nick Van Exel,DEN,71,2686,600,1315,485,115,245,62,178,48,67,2001
56,Damon Stoudamire,POR,82,2653,468,992,412,56,181,65,166,17,39,2001
57,George Lynch,PHI,82,2649,139,292,125,14,64,32,29,5,9,2001
58,Jermaine O'Neal,IND,81,2638,98,223,71,27,31,7,33,7,20,2001
59,Michael Dickerson,VAN,70,2620,233,512,187,46,54,36,97,8,38,2001
60,Tim Hardaway,MIA,77,2614,483,1048,401,82,179,65,157,27,55,2001
61,Dikembe Mutombo,PHI,75,2594,76,170,58,18,19,13,26,2,16,2001
62,Mark Jackson,NYK,83,2582,661,1415,568,93,201,81,286,22,71,2001
63,Stephon Marbury,NJN,67,2558,506,1116,402,104,171,71,160,26,78,2001
64,Antonio McDyess,DEN,70,2557,146,368,70,76,31,7,32,28,48,2001
65,Steven Smith,POR,81,2541,213,474,165,48,66,19,80,12,36,2001
66,Bo Outlaw,ORL,80,2538,225,512,163,62,72,14,77,18,44,2001
67,Ron Mercer,CHI,61,2534,201,449,154,47,62,42,50,8,39,2001
68,Richard Hamilton,WAS,78,2520,224,480,192,32,88,39,65,10,22,2001
69,Bryant Stith,BOS,78,2507,168,397,107,61,45,27,35,13,48,2001
70,Bryon Russell,UTA,78,2474,160,342,138,22,72,21,45,10,12,2001
71,Raef LaFrentz,DEN,78,2457,107,240,81,26,33,20,28,9,17,2001
72,Travis Best,IND,77,2456,473,1053,366,107,115,60,191,48,59,2001
73,Howard Eisley,DAL,82,2429,295,652,233,62,84,49,100,18,44,2001
74,Vlade Divac,SAC,81,2417,231,521,172,59,120,8,44,31,28,2001
75,Shandon Anderson,HOU,82,2398,189,423,144,45,75,23,46,14,31,2001
76,John Stockton,UTA,82,2395,713,1501,638,75,351,89,198,33,42,2001
77,Alvin Williams,TOR,82,2391,407,903,318,89,112,39,167,29,60,2001
78,Aaron McKie,PHI,76,2391,377,799,332,45,157,83,92,12,33,2001
79,Horace Grant,LAL,77,2389,121,266,97,24,26,22,49,6,18,2001
80,Mike Miller,ORL,82,2389,140,313,107,33,52,15,40,9,24,2001
81,Steve Nash,DAL,70,2387,509,1132,395,114,178,74,143,25,89,2001
82,David Robinson,SAS,80,2371,116,260,88,28,52,15,21,16,12,2001
83,Tyrone Hill,PHI,76,2365,48,106,38,10,23,10,5,2,8,2001
84,Chucky Atkins,DET,81,2364,330,711,279,51,121,34,124,14,37,2001
85,Metta World Peace,CHI,76,2363,228,483,201,27,83,43,75,3,24,2001
86,Mookie Blaylock,GSW,69,2353,462,967,419,43,161,126,132,7,36,2001
87,Elden Campbell,CHH,78,2339,104,241,71,33,25,12,34,7,26,2001
88,Voshon Lenard,DEN,80,2334,190,404,166,24,79,40,47,3,21,2001
89,Aaron Williams,NJN,82,2334,88,195,69,19,41,6,22,3,16,2001
90,Donyell Marshall,UTA,81,2329,133,285,114,19,68,15,31,5,14,2001
91,Rick Fox,LAL,82,2294,262,556,230,32,116,39,75,9,23,2001
92,Jason Williams,SAC,77,2290,416,907,341,75,167,38,136,23,52,2001
93,Tony Delk,PHX,82,2287,160,342,138,22,50,35,53,7,15,2001
94,Eddie Jones,MIA,63,2277,171,382,131,40,55,28,48,11,29,2001
95,Kenyon Martin,NJN,68,2273,131,291,102,29,49,17,36,7,22,2001
96,James Posey,DEN,82,2257,163,372,117,46,40,22,55,15,31,2001
97,Fred Hoiberg,CHI,74,2245,263,554,235,28,77,78,80,6,22,2001
98,Lamond Murray,CLE,78,2225,124,259,113,11,49,24,40,4,7,2001
99,Glen Rice,NYK,75,2212,89,203,64,25,34,19,11,6,19,2001
100,Rodney Rogers,PHX,82,2182,180,386,154,26,64,26,64,10,16,2001
101,Dale Davis,POR,81,2160,103,229,80,23,26,12,42,12,11,2001
102,Eric Piatkowski,LAC,81,2144,96,207,81,15,38,19,24,4,11,2001
103,Darius Miles,LAC,81,2139,99,213,84,15,52,16,16,4,11,2001
104,Marcus Camby,NYK,63,2131,52,110,46,6,32,7,7,2,4,2001
105,Scottie Pippen,POR,64,2131,294,629,253,41,116,60,77,6,35,2001
106,Vin Baker,SEA,76,2129,90,221,49,41,30,4,15,8,33,2001
107,Kurt Thomas,NYK,77,2128,63,141,48,15,30,8,10,6,9,2001
108,Michael Olowokandi,LAC,82,2128,46,106,32,14,15,6,11,0,14,2001
109,John Starks,UTA,75,2126,178,372,162,16,81,29,52,4,12,2001
110,Anthony Peeler,MIN,75,2122,192,401,175,17,62,40,73,7,10,2001
111,Larry Johnson,NYK,65,2108,127,289,92,35,29,18,45,10,25,2001
112,Patrick Ewing,SEA,79,2102,92,210,66,26,48,8,10,5,21,2001
113,Tim Thomas,MIL,76,2084,138,321,93,45,22,34,37,17,28,2001
114,Lucious Harris,NJN,73,2071,135,296,109,26,35,22,52,8,18,2001
115,Antonio Daniels,SAS,79,2063,304,672,240,64,98,49,93,34,30,2001
116,Ruben Patterson,SEA,76,2061,161,370,113,48,66,21,26,16,32,2001
117,Johnny Newman,NJN,82,2051,115,253,92,23,41,15,36,5,18,2001
118,Lindsey Hunter,MIL,82,2003,222,494,172,50,72,43,57,15,35,2001
119,Shawn Bradley,DAL,82,2003,38,84,30,8,16,7,7,3,5,2001
120,George McCloud,DEN,76,2003,279,603,234,45,128,45,61,19,26,2001
121,Bonzi Wells,POR,75,1995,208,440,184,24,108,34,42,5,19,2001
122,Lorenzen Wright,ATL,71,1987,87,195,66,21,27,11,28,6,15,2001
123,Ervin Johnson,MIL,82,1984,40,98,22,18,17,2,3,2,16,2001
124,Maurice Taylor,HOU,69,1970,104,228,84,20,55,14,15,10,10,2001
125,LaPhonso Ellis,MIN,82,1947,93,199,80,13,37,7,36,2,11,2001
126,Joe Smith,DET,69,1942,79,177,60,19,23,5,32,7,12,2001
127,Vitaly Potapenko,BOS,82,1901,64,152,40,24,14,5,21,6,18,2001
128,Al Harrington,IND,78,1893,130,287,103,27,42,20,41,17,10,2001
129,Austin Croshere,IND,81,1874,92,201,75,17,23,21,31,5,12,2001
130,Chris Childs,TOR,77,1854,355,785,280,75,110,54,116,32,43,2001
131,Larry Hughes,GSW,50,1843,223,478,191,32,77,46,68,10,22,2001
132,Brian Shaw,LAL,80,1831,258,564,210,48,120,36,54,14,34,2001
133,Bryant Reeves,VAN,75,1829,80,174,66,14,24,13,29,2,12,2001
134,Kevin Willis,DEN,78,1829,50,113,37,13,14,5,18,7,6,2001
135,Kenny Thomas,HOU,74,1820,77,179,52,25,32,8,12,11,14,2001
136,Othella Harrington,NYK,74,1816,56,122,46,10,20,7,19,2,8,2001
137,Morris Peterson,TOR,80,1810,105,225,90,15,34,9,47,5,10,2001
138,Alan Henderson,ATL,73,1808,50,114,36,14,14,8,14,3,11,2001
139,Theo Ratliff,PHI,50,1802,58,133,41,17,21,6,14,5,12,2001
140,Chauncey Billups,MIN,77,1793,260,540,240,20,76,61,103,7,13,2001
141,Brent Barry,SEA,67,1781,225,489,186,39,108,39,39,14,25,2001
142,Eric Snow,PHI,50,1743,369,789,318,51,149,66,103,17,34,2001
143,Eric Williams,BOS,81,1743,112,263,73,39,30,11,32,6,33,2001
144,Keith Van Horn,NJN,49,1731,82,185,61,21,28,5,28,7,14,2001
145,Keon Clark,TOR,81,1720,72,158,58,14,34,6,18,6,8,2001
146,John Amaechi,ORL,82,1711,74,171,51,23,31,6,14,3,20,2001
147,Hubert Davis,WAS,66,1693,110,232,98,12,23,17,58,3,9,2001
148,Jim Jackson,CLE,56,1690,163,347,142,21,61,37,44,10,11,2001
149,Danny Ferry,SAS,80,1687,71,157,56,15,21,22,13,6,9,2001
150,Corliss Williamson,DET,69,1687,61,132,51,10,28,8,15,4,6,2001
151,Bob Sura,GSW,53,1682,242,519,207,35,90,35,82,12,23,2001
152,Terry Porter,SAS,80,1679,251,539,214,37,93,48,73,14,23,2001
153,Chris Gatling,CLE,74,1674,61,133,50,11,16,6,28,4,7,2001
154,Stephen Jackson,NJN,77,1663,140,286,134,6,89,12,33,0,6,2001
155,Scot Pollard,SAC,77,1661,47,110,31,16,14,2,15,2,14,2001
156,Christian Laettner,WAS,78,1659,124,262,110,14,47,25,38,5,9,2001
157,Moochie Norris,HOU,82,1651,283,657,192,91,100,24,68,27,64,2001
158,Bobby Jackson,SAC,79,1647,161,339,144,17,74,21,49,4,13,2001
159,Anthony Carter,MIA,72,1633,268,594,210,58,113,20,77,14,44,2001
160,Jacque Vaughn,UTA,82,1626,323,698,271,52,122,34,115,22,30,2001
161,Olden Polynice,UTA,81,1621,31,68,25,6,14,1,10,1,5,2001
162,Matt Harpring,CLE,56,1613,102,216,90,12,35,24,31,6,6,2001
163,Michael Smith,WAS,79,1612,101,221,82,19,34,19,29,4,15,2001
164,Jahidi White,WAS,68,1606,20,43,17,3,7,2,8,1,2,2001
165,Toni Kukoc,ATL,65,1598,199,427,170,29,91,28,51,8,21,2001
166,Robert Horry,LAL,79,1589,128,282,102,26,68,19,15,5,21,2001
167,Walt Williams,HOU,72,1583,97,208,83,14,51,15,17,7,7,2001
168,Marcus Fizer,CHI,72,1581,76,168,60,16,28,13,19,4,12,2001
169,Pat Garrity,ORL,76,1579,51,116,37,14,14,6,17,3,11,2001
170,Felipe Lopez,MIN,70,1566,107,225,96,11,38,23,35,5,6,2001
171,Tyrone Nesby,WAS,62,1556,76,163,65,11,28,15,22,5,6,2001
172,Sean Rooks,LAC,82,1552,77,170,61,16,37,9,15,5,11,2001
173,Hakeem Olajuwon,HOU,58,1543,72,161,55,17,36,8,11,3,14,2001
174,Chris Whitney,WAS,59,1533,248,519,225,23,80,75,70,8,15,2001
175,Desmond Mason,SEA,78,1523,63,150,39,24,21,5,13,5,19,2001
176,Grant Long,VAN,66,1511,83,188,61,22,21,8,32,7,15,2001
177,Mario Elie,PHX,68,1508,131,287,106,25,36,27,43,8,17,2001
178,Vonteego Cummings,GSW,66,1495,227,472,209,18,79,51,79,6,12,2001
179,Charlie Ward,NYK,61,1495,273,586,233,40,111,57,65,9,31,2001
180,Michael Curry,DET,68,1490,132,301,95,37,28,15,52,7,30,2001
181,Greg Ostertag,UTA,81,1488,22,49,17,5,6,2,9,1,4,2001
182,Brevin Knight,ATL,53,1462,311,676,257,54,97,49,111,8,46,2001
183,Adonal Foyle,GSW,58,1460,48,101,43,5,21,4,18,0,5,2001
184,Jason Caffey,MIL,70,1458,53,122,37,16,13,13,11,8,8,2001
185,Brad Miller,CHI,57,1437,107,227,94,13,31,11,52,1,12,2001
186,Damon Jones,VAN,71,1415,224,476,196,28,64,28,104,11,17,2001
187,A.C. Green,MIA,82,1412,39,84,33,6,17,3,13,1,5,2001
188,Marc Jackson,GSW,48,1407,59,133,44,15,20,10,14,8,7,2001
189,Matt Maloney,ATL,55,1401,154,335,127,27,33,26,68,9,18,2001
190,Michael Doleac,ORL,77,1396,65,151,44,21,20,7,17,2,19,2001
191,Courtney Alexander,WAS,65,1374,62,131,55,7,19,6,30,2,5,2001
192,Rod Strickland,POR,54,1372,303,636,273,30,112,75,86,11,19,2001
193,Corey Maggette,LAC,69,1361,82,181,65,17,31,17,17,4,13,2001
194,Quentin Richardson,LAC,76,1356,62,133,53,9,23,16,14,2,7,2001
195,Evan Eschmeyer,NJN,74,1335,40,85,35,5,20,2,13,2,3,2001
196,Stromile Swift,VAN,80,1313,28,64,20,8,5,2,13,3,5,2001
197,DerMarr Johnson,ATL,78,1310,64,135,57,7,19,12,26,2,5,2001
198,Corie Blount,GSW,68,1306,59,126,51,8,30,7,14,2,6,2001
199,Dan Majerle,MIA,53,1306,88,193,71,17,27,13,31,3,14,2001
200,Bryce Drew,CHI,48,1303,185,402,153,32,60,36,57,6,26,2001
201,Danny Manning,UTA,82,1300,92,203,73,19,42,11,20,5,14,2001
202,Arvydas Sabonis,POR,61,1295,91,196,77,14,46,7,24,2,12,2001
203,Emanual Davis,SEA,62,1290,137,293,118,19,62,31,25,5,14,2001
204,Avery Johnson,SAS,55,1288,237,526,185,52,69,32,84,28,24,2001
205,Scott Williams,MIL,66,1270,35,80,25,10,12,3,10,3,7,2001
206,Mateen Cleaves,DET,78,1266,207,452,169,38,93,21,55,13,25,2001
207,Robert Pack,DEN,74,1261,293,655,224,69,109,30,85,23,46,2001
208,Hedo Turkoglu,SAC,74,1249,69,154,53,16,28,5,20,6,10,2001
209,Keyon Dooling,LAC,76,1240,177,389,142,35,75,14,53,7,28,2001
210,Rasho Nesterovic,MIN,73,1239,45,100,35,10,8,4,23,4,6,2001
211,Shammond Williams,SEA,69,1239,190,415,155,35,75,28,52,6,29,2001
212,Randy Brown,BOS,54,1238,154,383,79,75,36,21,22,21,54,2001
213,Sean Elliott,SAS,52,1230,81,181,62,19,22,13,27,9,10,2001
214,Malik Rose,SAS,57,1218,48,106,38,10,20,4,14,6,4,2001
215,Mitch Richmond,WAS,37,1216,111,234,99,12,46,29,24,2,10,2001
216,Robert Traylor,CLE,70,1208,63,139,50,13,23,7,20,4,9,2001
217,Monty Williams,ORL,82,1208,79,171,66,13,34,8,24,1,12,2001
218,Isaiah Rider,LAL,67,1206,111,246,87,24,33,26,28,8,16,2001
219,Eddie Robinson,CHH,67,1202,59,120,57,2,26,8,23,0,2,2001
220,Stacey Augmon,POR,66,1184,98,217,77,21,35,14,28,3,18,2001
221,Jerome Williams,TOR,59,1182,45,99,36,9,16,7,13,5,4,2001
222,Chris Mihm,CLE,59,1165,16,35,13,3,4,3,6,0,3,2001
223,Tom Gugliotta,PHX,57,1160,55,123,42,13,14,4,24,3,10,2001
224,Jeff Foster,IND,71,1157,33,69,30,3,17,5,8,1,2,2001
225,Mikki Moore,DET,81,1151,33,78,21,12,5,1,15,3,9,2001
226,Chris Porter,GSW,51,1145,61,130,53,8,28,11,14,3,5,2001
227,Milt Palacio,BOS,58,1141,151,364,89,62,37,18,34,15,47,2001
228,Jelani McCoy,SEA,70,1140,57,127,44,13,17,11,16,4,9,2001
229,Ron Harper,LAL,47,1140,113,251,88,25,36,25,27,10,15,2001
230,Trajan Langdon,CLE,65,1116,81,171,72,9,34,15,23,5,4,2001
231,Mark Blount,BOS,64,1099,32,74,22,10,9,1,12,2,8,2001
232,Jamaal Magloire,CHH,74,1097,27,64,17,10,6,4,7,1,9,2001
233,Sherman Douglas,NJN,59,1090,144,302,130,14,59,22,49,4,10,2001
234,Shawn Kemp,POR,68,1084,65,144,51,14,27,7,17,2,12,2001
235,Dana Barros,DET,60,1082,110,234,96,14,38,16,42,7,7,2001
236,Cherokee Parks,LAC,65,1054,46,98,40,6,18,9,13,3,3,2001
237,Jamal Crawford,CHI,61,1047,141,292,131,10,64,30,37,0,10,2001
238,Erick Dampier,GSW,43,1042,59,132,45,14,18,7,20,3,11,2001
239,Jon Barry,SAC,62,1009,130,286,104,26,67,13,24,5,21,2001
240,Troy Hudson,ORL,75,1005,162,365,121,41,52,9,60,7,34,2001
241,Matt Bullard,HOU,61,1001,42,96,30,12,14,3,13,6,6,2001
242,Sam Perkins,IND,64,998,41,91,32,9,14,6,12,5,4,2001
243,Hanno Mottola,ATL,73,989,25,57,18,7,6,4,8,2,5,2001
244,Derrick McKey,IND,66,985,74,168,54,20,28,10,16,8,12,2001
245,Sam Mitchell,MIN,82,982,57,124,47,10,11,20,16,4,6,2001
246,Samaki Walker,SAS,61,966,29,67,20,9,5,4,11,3,6,2001
247,Cedric Henderson,CLE,55,961,79,166,71,8,34,16,21,5,3,2001
248,Wesley Person,CLE,44,959,64,133,59,5,24,8,27,4,1,2001
249,Dell Curry,TOR,71,957,75,157,68,7,30,10,28,0,7,2001
250,Jake Tsakalidis,PHX,57,947,19,40,17,2,3,4,10,0,2,2001
251,Mark Pope,MIL,63,941,38,89,25,13,4,9,12,5,8,2001
252,Khalid El-Amin,CHI,50,935,145,302,133,12,60,26,47,2,10,2001
253,Dion Glover,ATL,57,931,69,149,58,11,32,11,15,6,5,2001
254,Calvin Booth,DAL,55,929,42,90,36,6,22,6,8,2,4,2001
255,Kevin Ollie,PHI,70,925,146,313,125,21,52,17,56,7,14,2001
256,Vinny Del Negro,PHX,65,919,126,271,107,19,30,23,54,4,15,2001
257,Roshown McLeod,PHI,35,918,58,125,49,9,15,11,23,2,7,2001
258,Nazr Mohammed,ATL,58,915,19,41,16,3,13,2,1,1,2,2001
259,Chris Crawford,ATL,47,905,37,87,24,13,9,7,8,5,8,2001
260,Andrew DeClercq,ORL,67,900,32,73,23,9,12,1,10,1,8,2001
261,Kendall Gill,NJN,31,889,87,189,72,15,40,12,20,2,13,2001
262,Michael Ruffin,CHI,45,879,39,88,29,10,12,3,14,1,9,2001
263,Jumaine Jones,PHI,65,862,32,69,27,5,13,6,8,0,5,2001
264,Greg Anthony,POR,58,861,82,172,74,8,25,16,33,2,6,2001
265,Corey Benjamin,CHI,65,856,69,152,55,14,24,14,17,2,12,2001
266,Kenny Anderson,BOS,33,850,134,322,80,54,33,17,30,22,32,2001
267,Mike Penberthy,LAL,53,846,71,153,60,11,32,18,10,1,10,2001
268,Ike Austin,VAN,52,846,58,127,47,11,23,9,15,3,8,2001
269,Tony Battie,BOS,40,845,16,36,12,4,2,5,5,1,3,2001
270,Adam Keefe,GSW,67,842,36,78,30,6,11,7,12,1,5,2001
271,Dean Garrett,MIN,70,836,24,51,21,3,5,6,10,0,3,2001
272,Erick Strickland,VAN,50,828,95,210,75,20,25,13,37,7,13,2001
273,Greg Buckner,DAL,37,820,49,114,33,16,12,8,13,4,12,2001
274,Tony Massenburg,VAN,52,819,9,21,6,3,2,1,3,0,3,2001
275,Bimbo Coles,CLE,47,802,138,290,124,14,49,20,55,3,11,2001
276,Billy Owens,DET,45,796,55,117,48,7,18,8,22,2,5,2001
277,Zan Tabak,IND,55,774,33,71,28,5,15,3,10,1,4,2001
278,Don Reid,ORL,64,761,21,45,18,3,8,4,6,1,2,2001
279,Jud Buechler,DET,57,736,39,88,29,10,9,7,13,3,7,2001
280,Mark Strickland,NJN,55,722,24,53,19,5,11,0,8,1,4,2001
281,Derek Fisher,LAL,20,711,87,194,67,20,40,14,13,4,16,2001
282,Gerard King,WAS,45,705,31,68,25,6,12,6,7,1,5,2001
283,Ryan Bowen,DEN,57,698,30,62,28,2,9,7,12,1,1,2001
284,Lawrence Funderburke,SAC,59,698,17,41,10,7,6,0,4,3,4,2001
285,Reggie Slater,MIN,55,684,26,57,21,5,11,4,6,1,4,2001
286,Derrick Coleman,CHH,34,682,39,90,27,12,12,8,7,2,10,2001
287,Hersey Hawkins,CHH,59,679,72,147,69,3,27,16,26,1,2,2001
288,Vernon Maxwell,DAL,43,660,49,106,41,8,22,4,15,2,6,2001
289,Steve Kerr,SAS,55,652,57,125,46,11,14,9,23,7,4,2001
290,Eric Montross,TOR,54,649,19,45,12,7,4,1,7,1,6,2001
291,Otis Thorpe,CHH,49,649,29,64,23,6,9,8,6,0,6,2001
292,Popeye Jones,WAS,45,640,31,64,29,2,21,4,4,0,2,2001
293,Mark Madsen,LAL,69,637,24,50,22,2,7,1,14,0,2,2001
294,Kevin Edwards,VAN,46,633,52,112,44,8,19,8,17,5,3,2001
295,Larry Robinson,ATL,34,632,36,79,29,7,7,10,12,3,4,2001
296,A.J. Guyton,CHI,33,628,64,143,49,15,18,16,15,3,12,2001
297,Kelvin Cato,HOU,35,624,11,28,5,6,2,1,2,1,5,2001
298,Zydrunas Ilgauskas,CLE,24,614,18,39,15,3,6,3,6,0,3,2001
299,Chris Dudley,PHX,53,611,18,40,14,4,6,2,6,1,3,2001
300,Laron Profit,WAS,35,604,89,185,82,7,32,16,34,4,3,2001
301,Tracy Murray,TOR,52,600,23,50,19,4,9,2,8,0,4,2001
302,Dragan Tarlac,CHI,43,599,31,65,28,3,18,5,5,1,2,2001
303,Todd MacCulloch,PHI,63,596,10,21,9,1,4,2,3,0,1,2001
304,Paul McPherson,GSW,55,593,38,83,31,7,12,11,8,1,6,2001
305,Devean George,LAL,59,591,19,41,16,3,9,4,3,0,3,2001
306,Brian Skinner,LAC,39,583,18,40,14,4,5,3,6,0,4,2001
307,Daniel Santiago,PHX,54,580,11,22,11,0,6,2,3,0,0,2001
308,Jonathan Bender,IND,58,572,32,67,29,3,12,5,12,1,2,2001
309,Rodney Buford,PHI,47,572,17,37,14,3,6,3,5,0,3,2001
310,Cedric Ceballos,MIA,40,557,20,43,17,3,9,2,6,0,3,2001
311,Loy Vaught,WAS,51,548,23,49,20,3,6,4,10,0,3,2001
312,Carlos Rogers,HOU,39,547,9,20,7,2,3,2,2,0,2,2001
313,Eddie House,MIA,50,545,52,108,48,4,18,4,26,2,2,2001
314,Matt Geiger,PHI,35,544,14,30,12,2,4,2,6,2,0,2001
315,Darvin Ham,MIL,29,542,25,57,18,7,6,3,9,3,4,2001
316,John Wallace,DET,40,527,23,53,16,7,10,1,5,3,4,2001
317,Anthony Johnson,CLE,53,511,78,170,64,14,24,9,31,5,9,2001
318,Elliot Perry,PHX,49,498,79,173,64,15,24,7,33,4,11,2001
319,Chris Mills,GSW,15,494,18,38,16,2,7,7,2,0,2,2001
320,Derek Strong,LAC,28,492,7,15,6,1,1,2,3,0,1,2001
321,Mahmoud Abdul-Rauf,VAN,41,485,76,162,66,10,21,16,29,4,6,2001
322,Doug Overton,NJN,21,476,72,162,54,18,21,10,23,6,12,2001
323,Walter McCarty,BOS,60,474,39,92,25,14,11,7,7,5,9,2001
324,Tyronn Lue,LAL,38,468,45,100,35,10,26,4,5,4,6,2001
325,Lee Nailon,CHH,42,467,24,50,22,2,9,5,8,1,1,2001
326,William Avery,MIN,55,460,75,165,60,15,23,11,26,6,9,2001
327,Greg Foster,LAL,62,454,32,69,27,5,7,5,15,0,5,2001
328,David Benoit,UTA,49,444,22,48,18,4,10,2,6,1,3,2001
329,Eduardo Najera,DAL,40,433,27,58,23,4,11,1,11,0,4,2001
330,Tariq Abdul-Wahad,DEN,29,421,22,45,21,1,14,2,5,0,1,2001
331,David Vanterpool,WAS,22,410,66,138,60,6,26,5,29,0,6,2001
332,Chris Herren,BOS,25,408,56,135,33,23,10,9,14,8,15,2001
333,Eldridge Recasner,CHH,43,406,39,79,38,1,8,9,21,0,1,2001
334,Quincy Lewis,UTA,35,400,18,38,16,2,9,4,3,1,1,2001
335,Detlef Schrempf,POR,26,396,44,93,39,5,14,7,18,3,2,2001
336,Duane Causwell,MIA,31,383,5,10,5,0,2,0,3,0,0,2001
337,Adrian Griffin,BOS,44,376,27,60,21,6,8,1,12,1,5,2001
338,Cal Bowdler,ATL,44,374,4,11,1,3,0,0,1,1,2,2001
339,Chris Mullin,GSW,20,373,19,42,15,4,4,5,6,1,3,2001
340,Todd Day,MIN,31,341,28,59,25,3,14,4,7,0,3,2001
341,Chucky Brown,CLE,26,340,11,24,9,2,7,1,1,0,2,2001
342,Gary Trent,DAL,33,322,10,21,9,1,4,2,3,0,1,2001
343,Chris Carr,BOS,35,307,11,27,6,5,4,0,2,2,3,2001
344,Alonzo Mourning,MIA,13,306,12,29,7,5,6,0,1,3,2,2001
345,Ruben Wolkowyski,SEA,34,303,3,8,1,2,0,0,1,2,0,2001
346,Luc Longley,NYK,25,299,7,17,4,3,1,1,2,2,1,2001
347,DeShawn Stevenson,UTA,40,296,18,37,17,1,13,2,2,0,1,2001
348,Rafer Alston,MIL,37,287,68,155,49,19,17,6,26,3,16,2001
349,Obinna Ekezie,DAL,33,282,9,21,6,3,4,1,1,0,3,2001
350,Vladimir Stepania,NJN,29,279,16,37,11,5,5,0,6,1,4,2001
351,Joel Przybilla,MIL,33,267,2,4,2,0,0,1,1,0,0,2001
352,John Crotty,UTA,31,264,35,77,28,7,15,4,9,5,2,2001
353,Tyus Edney,IND,24,261,54,115,47,7,18,5,24,2,5,2001
354,Dalibor Bagaric,CHI,35,260,10,24,6,4,3,1,2,0,4,2001
355,Travis Knight,NYK,45,254,5,11,4,1,4,0,0,0,1,2001
356,Jerome Kersey,MIL,22,245,15,34,11,4,8,2,1,4,0,2001
357,Dan Langhi,HOU,33,241,4,10,2,2,0,2,0,1,1,2001
358,Terry Davis,DEN,19,225,7,15,6,1,4,1,1,0,1,2001
359,Cory Alexander,ORL,26,223,36,80,28,8,12,1,15,2,6,2001
360,Soumaila Samake,NJN,34,223,1,2,1,0,0,0,1,0,0,2001
361,Olumide Oyedeji,SEA,30,220,2,4,2,0,1,0,1,0,0,2001
362,Jason Collier,HOU,23,219,6,14,4,2,2,1,1,1,1,2001
363,Kornel David,DET,27,208,7,18,3,4,2,0,1,1,3,2001
364,Rick Brunson,NYK,22,206,31,76,17,14,8,3,6,4,10,2001
365,Derrick Dial,SAS,33,204,21,49,14,7,2,6,6,4,3,2001
366,Danny Fortson,GSW,6,203,5,12,3,2,1,0,2,0,2,2001
367,Anthony Goldwire,DEN,20,200,34,77,25,9,15,1,9,4,5,2001
368,Tim James,CHH,30,199,8,17,7,1,2,0,5,0,1,2001
369,Jim McIlvaine,NJN,18,194,4,8,4,0,2,0,2,0,0,2001
370,Bill Curley,GSW,20,192,3,6,3,0,2,0,1,0,0,2001
371,Ira Newble,SAS,27,182,6,13,5,1,2,1,2,0,1,2001
372,Mike Smith,WAS,17,179,10,20,10,0,5,3,2,0,0,2001
373,Darrick Martin,SAC,31,175,14,32,10,4,8,1,1,1,3,2001
374,Doug West,VAN,15,173,14,32,10,4,5,2,3,2,2,2001
375,Nick Anderson,SAC,21,170,13,28,11,2,8,1,2,1,1,2001
376,Lavor Postell,NYK,26,168,5,12,3,2,1,1,1,1,1,2001
377,Dee Brown,ORL,7,156,12,27,9,3,2,0,7,3,0,2001
378,Calbert Cheaney,DEN,9,152,9,21,6,3,3,2,1,2,1,2001
379,Eddie Gill,NJN,8,152,24,51,21,3,7,1,13,2,1,2001
380,Earl Boykins,LAC,10,149,32,66,30,2,13,6,11,0,2,2001
381,Jamie Feick,NJN,6,149,5,11,4,1,2,1,1,1,0,2001
382,Chris Garner,GSW,8,148,18,36,18,0,10,2,6,0,0,2001
383,Pepe Sanchez,PHI,29,148,41,85,38,3,19,14,5,0,3,2001
384,Jake Voskuhl,CHI,16,144,5,10,5,0,3,0,2,0,0,2001
385,Shawnelle Scott,SAS,27,142,4,9,3,1,1,1,1,0,1,2001
386,Jerome Moiso,BOS,24,136,3,7,2,1,1,0,1,1,0,2001
387,Grant Hill,ORL,4,132,25,56,19,6,12,1,6,0,6,2001
388,Steve Goodrich,CHI,12,132,6,12,6,0,0,3,3,0,0,2001
389,Scott Padgett,UTA,27,126,5,12,3,2,2,0,1,0,2,2001
390,Brian Cardinal,DET,15,124,3,6,3,0,1,0,2,0,0,2001
391,Michael Stewart,TOR,26,123,2,4,2,0,0,0,2,0,0,2001
392,Bruno Sundov,IND,11,122,2,5,1,1,0,0,1,1,0,2001
393,Tyrone Corbin,TOR,15,117,4,9,3,1,1,1,1,1,0,2001
394,Jaren Jackson,SAS,16,115,7,14,7,0,6,0,1,0,0,2001
395,Terry Mills,IND,14,113,5,11,4,1,3,1,0,0,1,2001
396,Felton Spencer,NYK,18,112,2,4,2,0,0,0,2,0,0,2001
397,Anfernee Hardaway,PHX,4,110,15,31,14,1,10,2,2,0,1,2001
398,Mark Bryant,DAL,18,103,3,8,1,2,1,0,0,0,2,2001
399,Tony Smith,ATL,6,78,10,21,9,1,5,0,4,0,1,2001
400,Don MacLean,MIA,8,76,4,9,3,1,1,0,2,1,0,2001
401,Todd Fuller,MIA,10,76,1,3,0,1,0,0,0,1,0,2001
402,Michael Hawkins,CLE,10,75,13,28,11,2,6,0,5,1,1,2001
403,Ruben Garces,GSW,13,73,5,10,5,0,1,1,3,0,0,2001
404,Jamal Robinson,MIA,6,72,2,4,2,0,1,0,1,0,0,2001
405,Antonio Harvey,POR,12,71,4,10,2,2,0,0,2,1,1,2001
406,Ricky Davis,MIA,7,71,11,24,9,2,5,1,3,0,2,2001
407,Jabari Smith,SAC,9,66,6,16,2,4,1,0,1,2,2,2001
408,Donnell Harvey,DAL,18,64,2,4,2,0,2,0,0,0,0,2001
409,Dan McClintock,DEN,6,58,1,2,1,0,0,0,1,0,0,2001
410,Sam Jacobson,MIN,14,57,4,8,4,0,3,1,0,0,0,2001
411,Jamel Thomas,NJN,5,56,0,0,0,0,0,0,0,0,0,2001
412,Will Perdue,POR,13,56,2,4,2,0,2,0,0,0,0,2001
413,James Robinson,ORL,6,50,0,0,0,0,0,0,0,0,0,2001
414,Sean Colson,HOU,13,45,10,20,10,0,5,3,2,0,0,2001
415,Scott Burrell,CHH,4,40,1,3,0,1,0,0,0,0,1,2001
416,Pervis Ellison,SEA,9,40,3,6,3,0,3,0,0,0,0,2001
417,J.R. Reid,CLE,6,40,1,3,0,1,0,0,0,0,1,2001
418,Wang Zhi-zhi,DAL,5,39,0,0,0,0,0,0,0,0,0,2001
419,Erick Barkley,POR,8,37,6,14,4,2,2,0,2,0,2,2001
420,Slava Medvedenko,LAL,7,37,2,5,1,1,1,0,0,0,1,2001
421,Michael Redd,MIL,6,35,1,3,0,1,0,0,0,0,1,2001
422,Muggsy Bogues,TOR,3,34,5,11,4,1,1,0,3,0,1,2001
423,John Coker,GSW,6,32,2,5,1,1,1,0,0,0,1,2001
424,Tom Hammonds,MIN,7,30,1,3,0,1,0,0,0,0,1,2001
425,Raja Bell,PHI,5,30,0,0,0,0,0,0,0,0,0,2001
426,Brent Price,VAN,6,30,5,11,4,1,1,0,3,1,0,2001
427,Ira Bowman,ATL,3,19,7,14,7,0,4,2,1,0,0,2001
428,Zendon Hamilton,LAC,3,19,0,0,0,0,0,0,0,0,0,2001
429,Art Long,SAC,9,19,1,2,1,0,1,0,0,0,0,2001
430,Etdrick Bohannon,CLE,6,18,0,0,0,0,0,0,0,0,0,2001
431,Gary Grant,POR,4,17,1,2,1,0,1,0,0,0,0,2001
432,Garth Joseph,DEN,4,16,1,2,1,0,1,0,0,0,0,2001
433,Terrance Roberson,CHH,3,12,1,2,1,0,1,0,0,0,0,2001
434,Anthony Miller,PHI,4,11,0,0,0,0,0,0,0,0,0,2001
435,Jason Hart,MIL,1,10,1,3,0,1,0,0,0,0,1,2001
436,Mamadou N'diaye,TOR,3,9,0,0,0,0,0,0,0,0,0,2001
437,David Wingate,SEA,1,9,2,5,1,1,0,1,0,1,0,2001
438,Randy Livingston,GSW,2,7,1,2,1,0,0,0,1,0,0,2001
439,Lari Ketner,IND,3,6,1,2,1,0,1,0,0,0,0,2001
440,Andy Panko,ATL,1,1,0,0,0,0,0,0,0,0,0,2001
