"Name","TeamAbbreviation","GamesPlayed","Minutes","Assists","AssistPoints","TwoPtAssists","ThreePtAssists","AtRimAssists","ShortMidRangeAssists","LongMidRangeAssists","Corner3Assists","Arc3Assists"
"Gilbert Arenas","WAS",80,3384,484,1071,381,103,192,67,122,26,77
"LeBron James","CLE",79,3361,521,1190,373,148,220,41,112,87,61
"Joe Johnson","ATL",82,3340,536,1181,427,109,202,42,183,36,73
"Antawn Jamison","WAS",82,3289,158,360,114,44,58,19,37,9,35
"Kobe Bryant","LAL",80,3277,360,834,246,114,144,42,60,32,82
"Shawn Marion","PHX",81,3263,143,348,81,62,37,7,37,24,38
"Lamar Odom","LAL",80,3221,443,1003,326,117,148,55,123,27,90
"Ricky Davis","MIN",78,3207,394,860,322,72,131,50,141,27,45
"Mike Bibby","SAC",82,3167,444,956,376,68,204,27,145,22,46
"Morris Peterson","TOR",82,3140,190,419,151,39,63,18,70,19,20
"Pau Gasol","MEM",80,3135,371,916,197,174,126,19,52,47,127
"Michael Redd","MIL",80,3130,229,507,180,49,103,17,60,14,35
"Allen Iverson","PHI",72,3103,532,1169,427,105,214,52,161,38,67
"Elton Brand","LAC",79,3099,208,459,165,43,56,48,61,8,35
"Dirk Nowitzki","DAL",81,3089,226,502,176,50,91,37,48,12,38
"Andre Iguodala","PHI",82,3086,255,554,211,44,125,28,58,14,30
"Paul Pierce","BOS",79,3085,375,846,279,96,159,31,89,33,63
"Richard Jefferson","NJN",78,3059,297,666,225,72,76,26,123,29,43
"Ray Allen","SEA",78,3022,286,635,223,63,122,50,51,22,41
"Dwight Howard","ORL",82,3021,125,275,100,25,57,10,33,6,19
"Cuttino Mobley","LAC",79,2979,238,503,211,27,69,71,71,10,17
"Jason Kidd","NJN",80,2976,672,1444,572,100,282,77,213,30,70
"Raja Bell","PHX",79,2959,207,490,131,76,44,15,72,17,59
"Kevin Garnett","MIN",76,2958,308,653,271,37,143,29,99,10,27
"Kirk Hinrich","CHI",81,2955,514,1150,392,122,151,62,179,50,72
"Mehmet Okur","UTA",82,2945,194,416,166,28,76,11,79,4,24
"Carmelo Anthony","DEN",80,2941,216,475,173,43,97,19,57,16,27
"Andre Miller","DEN",82,2937,674,1448,574,100,379,32,163,37,63
"Chauncey Billups","DET",81,2925,699,1552,545,154,213,92,240,51,103
"Mike James","TOR",79,2925,460,1060,320,140,120,48,152,60,80
"Brad Miller","SAC",79,2923,374,854,268,106,140,32,96,28,78
"Stephen Jackson","IND",81,2910,225,506,169,56,103,25,41,25,31
"Vince Carter","NJN",79,2906,338,757,257,81,111,37,109,26,55
"Tayshaun Prince","DET",82,2898,186,432,126,60,55,18,53,16,44
"Chris Webber","PHI",75,2893,256,556,212,44,124,36,52,10,34
"Dwyane Wade","MIA",75,2893,503,1167,342,161,207,39,96,76,85
"Ben Wallace","DET",82,2890,158,349,125,33,65,19,41,17,16
"Jason Richardson","GSW",75,2877,232,539,157,75,79,22,56,28,47
"Rashard Lewis","SEA",78,2876,182,420,126,56,46,26,54,17,39
"Boris Diaw","PHX",81,2874,503,1172,337,166,162,30,145,58,108
"Shane Battier","MEM",81,2839,136,318,90,46,52,12,26,17,29
"Richard Hamilton","DET",80,2825,275,602,223,52,121,23,79,18,34
"Chris Paul","NOK",78,2809,611,1323,510,101,209,50,251,30,71
"Jason Terry","DAL",80,2798,306,667,251,55,84,44,123,11,44
"Steve Nash","PHX",79,2796,826,1874,604,222,286,88,230,91,131
"Tim Duncan","SAS",80,2784,253,571,188,65,107,28,53,21,44
"Al Harrington","ATL",76,2782,238,531,183,55,95,17,71,22,33
"Rasheed Wallace","DET",80,2780,182,403,143,39,73,29,41,20,19
"Smush Parker","LAL",82,2774,302,685,221,81,114,30,77,18,63
"Bruce Bowen","SAS",82,2755,126,285,93,33,35,30,28,13,20
"Chris Bosh","TOR",70,2751,181,428,115,66,62,19,34,23,43
"Wally Szczerbiak","BOS",72,2729,213,482,157,56,68,30,59,22,34
"Tony Parker","SAS",80,2715,460,1065,315,145,145,56,114,91,54
"Caron Butler","WAS",75,2708,186,413,145,41,88,19,38,9,32
"Sam Cassell","LAC",78,2653,491,1045,428,63,145,103,180,15,48
"DeShawn Stevenson","ORL",82,2648,160,349,131,29,67,18,46,10,19
"Luke Ridnour","SEA",79,2625,550,1276,374,176,185,73,116,46,130
"Hedo Turkoglu","ORL",78,2615,216,456,192,24,84,28,80,8,16
"Andrei Kirilenko","UTA",69,2604,299,628,269,30,154,29,86,3,27
"Luol Deng","CHI",78,2604,147,355,86,61,33,9,44,25,36
"Peja Stojakovic","IND",71,2601,136,308,100,36,48,11,41,14,22
"Derek Fisher","GSW",82,2589,352,790,266,86,170,24,72,37,49
"Mike Dunleavy","GSW",81,2577,237,553,158,79,76,29,53,24,55
"Kyle Korver","PHI",82,2563,163,350,139,24,69,29,41,8,16
"Chris Kaman","LAC",78,2561,79,172,65,14,32,11,22,4,10
"Josh Smith","ATL",80,2559,191,428,145,46,108,11,26,26,20
"T.J. Ford","MIL",72,2557,473,1091,328,145,174,40,114,49,96
"Jamal Crawford","NYK",79,2555,301,643,260,41,151,29,80,17,24
"Zach Randolph","POR",74,2545,144,341,91,53,50,10,31,3,50
"Bobby Simmons","MIL",75,2538,172,381,135,37,77,20,38,14,23
"Juwan Howard","HOU",80,2537,112,263,73,39,40,18,15,10,29
"David West","NOK",74,2526,92,205,71,21,29,7,35,8,13
"Troy Murphy","GSW",74,2516,101,243,60,41,39,2,19,14,27
"Trenton Hassell","MIN",77,2514,203,440,169,34,76,25,68,9,25
"Udonis Haslem","MIA",81,2491,95,215,70,25,49,12,9,8,17
"Ben Gordon","CHI",80,2482,240,532,188,52,84,31,73,14,38
"Nenad Krstic","NJN",80,2470,88,208,56,32,22,6,28,9,23
"Jamaal Magloire","MIL",82,2465,56,125,43,13,23,7,13,4,9
"Zaza Pachulia","ATL",78,2452,129,279,108,21,70,8,30,6,15
"Eddie Jones","MEM",75,2437,177,395,136,41,63,32,41,14,27
"Rafer Alston","HOU",63,2431,425,932,343,82,123,66,154,34,48
"Delonte West","BOS",71,2418,329,726,261,68,129,35,97,23,45
"Raymond Felton","CHA",80,2406,446,980,358,88,133,52,173,49,39
"Steve Francis","NYK",70,2394,345,754,281,64,159,42,80,19,45
"P.J. Brown","NOK",75,2380,90,190,80,10,29,15,36,2,8
"David Wesley","HOU",71,2372,204,460,152,52,58,45,49,18,34
"Charlie Villanueva","TOR",81,2361,88,202,62,26,31,3,28,14,12
"Eric Snow","CLE",82,2351,346,768,270,76,153,38,79,32,44
"Brevin Knight","CHA",69,2351,610,1344,486,124,220,63,203,34,90
"Andrew Bogut","MIL",82,2348,192,433,143,49,69,24,50,21,28
"Luther Head","HOU",80,2310,215,485,160,55,71,39,50,16,39
"Deron Williams","UTA",80,2307,359,777,300,59,142,22,136,7,52
"Gary Payton","MIA",81,2305,257,588,183,74,88,32,63,24,50
"Kenny Thomas","SAC",82,2293,168,377,127,41,65,10,52,9,32
"Zydrunas Ilgauskas","CLE",78,2283,91,206,67,24,44,4,19,6,18
"Antonio Daniels","WAS",79,2283,284,653,199,85,95,26,78,24,61
"Mike Miller","MEM",74,2268,200,454,146,54,88,22,36,22,32
"Josh Childress","ATL",74,2249,131,299,94,37,39,10,45,13,24
"Mark Blount","MIN",81,2240,99,209,88,11,48,5,35,1,10
"Andres Nocioni","CHI",82,2239,117,274,77,40,31,14,32,13,27
"Tony Battie","ORL",82,2215,49,109,38,11,20,2,16,0,11
"Metta World Peace","SAC",56,2207,203,478,131,72,60,23,48,21,51
"Antoine Walker","MIA",82,2199,166,361,137,29,99,17,21,14,15
"Stephon Marbury","NYK",60,2194,382,832,314,68,146,40,128,36,32
"Drew Gooden","CLE",79,2174,56,121,47,9,26,4,17,2,7
"Primoz Brezec","CHA",79,2166,45,104,31,14,9,6,16,7,7
"Chris Duhon","CHI",74,2154,373,821,298,75,112,50,136,32,43
"Tyson Chandler","CHI",79,2121,81,178,65,16,37,8,20,1,15
"Flip Murray","CLE",76,2112,197,447,144,53,72,30,42,17,36
"Desmond Mason","NOK",70,2102,66,137,61,5,29,6,26,2,3
"Marko Jaric","MIN",75,2102,293,624,255,38,73,57,125,14,24
"Damon Jones","CLE",82,2088,169,388,119,50,73,20,26,22,28
"Jumaine Jones","CHA",76,2088,63,140,49,14,21,8,20,8,6
"Donyell Marshall","CLE",81,2077,60,140,40,20,28,3,9,7,13
"John Salmons","PHI",82,2059,223,500,169,54,79,32,58,22,32
"Michael Finley","SAS",77,2038,116,262,86,30,38,19,29,17,13
"Raef LaFrentz","BOS",82,2033,115,263,82,33,34,19,29,9,24
"Speedy Claxton","NOK",71,2019,339,749,268,71,116,23,129,18,53
"Jalen Rose","NYK",72,1982,181,421,122,59,73,14,35,29,30
"Anthony Johnson","IND",75,1981,324,727,245,79,123,33,89,21,58
"Kwame Brown","LAL",72,1978,72,161,55,17,20,10,25,2,15
"Vladimir Radmanovic","LAC",77,1974,136,307,101,35,42,31,28,16,19
"Baron Davis","GSW",54,1971,480,1102,338,142,207,41,90,44,98
"Shareef Abdur-Rahim","SAC",72,1961,149,347,100,49,43,9,48,13,36
"Marvin Williams","ATL",79,1952,63,135,54,9,27,5,22,4,5
"Jared Jeffries","WAS",77,1951,148,332,112,36,55,16,41,4,32
"Yao Ming","HOU",57,1949,85,200,55,30,40,0,15,6,24
"Matt Harpring","UTA",71,1944,98,214,80,18,44,12,24,1,17
"Erick Dampier","DAL",82,1934,51,122,31,20,16,3,12,5,15
"Juan Dixon","POR",76,1920,149,316,131,18,69,23,39,5,13
"Josh Howard","DAL",59,1915,111,251,82,29,25,11,46,9,20
"James Posey","MIA",67,1914,89,208,59,30,27,12,20,9,21
"Kevin Martin","SAC",72,1913,97,220,71,26,20,3,48,9,17
"Keith Bogans","HOU",72,1912,128,274,110,18,48,39,23,10,8
"Jason Collins","NJN",71,1895,70,158,52,18,21,5,26,4,14
"Gerald Wallace","CHA",55,1895,96,218,70,26,38,6,26,7,19
"Brendan Haywood","WAS",79,1879,46,108,30,16,12,3,15,4,12
"Rasual Butler","NOK",79,1874,40,86,34,6,15,1,18,2,4
"Jason Williams","MIA",59,1874,287,630,231,56,134,30,67,19,37
"Eddy Curry","NYK",72,1866,19,45,12,7,9,1,2,2,5
"Clifford Robinson","NJN",80,1862,89,206,61,28,30,8,23,8,20
"Marcus Camby","DEN",56,1857,115,240,105,10,56,7,42,3,7
"Fred Jones","IND",68,1836,154,350,112,42,45,20,47,10,32
"Adonal Foyle","GSW",77,1824,33,75,24,9,15,1,8,1,8
"Manu Ginobili","SAS",65,1813,235,536,169,66,78,32,59,45,21
"Shaquille O'Neal","MIA",59,1806,113,271,68,45,57,3,8,5,40
"Jermaine O'Neal","IND",51,1803,133,306,93,40,65,10,18,12,28
"Ruben Patterson","DEN",71,1793,127,276,105,22,69,1,35,4,18
"Jameer Nelson","ORL",62,1784,302,665,241,61,117,21,103,23,38
"Steve Blake","POR",68,1781,306,657,261,45,124,28,109,18,27
"Bobby Jackson","MEM",71,1775,195,443,142,53,74,16,52,15,38
"James Jones","PHX",75,1772,57,145,26,31,9,4,13,11,20
"Marquis Daniels","DAL",62,1766,172,387,129,43,48,21,60,11,32
"Danny Granger","IND",78,1765,90,217,53,37,23,7,23,13,24
"Samuel Dalembert","PHI",66,1761,25,58,17,8,6,2,9,2,6
"Greg Buckner","DEN",73,1758,127,272,109,18,47,9,53,6,12
"Tracy McGrady","HOU",47,1745,225,510,165,60,75,37,53,25,35
"Antonio McDyess","DET",82,1733,90,204,66,24,25,14,27,8,16
"Jarron Collins","UTA",79,1729,97,202,89,8,46,12,31,1,7
"Chucky Atkins","MEM",71,1713,198,450,144,54,62,27,55,25,29
"Devin Brown","UTA",81,1711,104,217,95,9,39,15,41,0,9
"Matt Bonner","TOR",78,1709,56,136,32,24,12,3,17,16,8
"Lorenzen Wright","MEM",78,1689,48,114,30,18,23,3,4,10,8
"Bonzi Wells","SAC",52,1684,144,313,119,25,54,13,52,4,21
"Sebastian Telfair","POR",68,1641,247,549,192,55,85,22,85,21,34
"Jarrett Jack","POR",79,1599,219,482,175,44,76,25,74,19,25
"Leandro Barbosa","PHX",57,1592,158,382,92,66,34,15,43,25,41
"Jeff Foster","IND",63,1581,50,113,37,13,17,5,15,6,7
"Joey Graham","TOR",80,1581,60,142,38,22,20,9,9,13,9
"Francisco Elson","DEN",72,1579,47,104,37,10,17,6,14,4,6
"Earl Watson","SEA",70,1578,289,640,227,62,142,24,61,17,45
"Channing Frye","NYK",65,1572,53,121,38,15,21,11,6,7,8
"Sarunas Jasikevicius","IND",75,1557,227,488,193,34,131,17,45,9,25
"Kenyon Martin","DEN",56,1546,79,173,64,15,38,6,20,4,11
"Nate Robinson","NYK",72,1543,147,313,128,19,81,15,32,10,9
"Earl Boykins","DEN",60,1542,230,502,188,42,87,22,79,16,26
"Devean George","LAL",71,1542,68,155,49,19,23,3,23,5,14
"Chris Mihm","LAL",59,1542,61,136,47,14,19,10,18,0,14
"Brian Cook","LAL",81,1535,74,171,51,23,17,15,19,7,16
"Mo Williams","MIL",58,1531,230,514,176,54,91,30,55,18,36
"Chris Wilcox","SEA",77,1530,52,111,45,7,23,7,15,2,5
"Shaun Livingston","LAC",61,1525,273,597,222,51,90,49,83,16,35
"Jerry Stackhouse","DAL",55,1525,160,367,113,47,57,15,41,15,32
"Damien Wilkins","SEA",82,1525,107,261,60,47,29,14,17,13,34
"Quinton Ross","LAC",67,1515,79,171,66,13,22,16,28,5,8
"Rasho Nesterovic","SAS",80,1515,33,76,23,10,8,3,12,1,9
"DeSagana Diop","DAL",81,1510,23,53,16,7,5,0,11,1,6
"Marcus Banks","MIN",58,1496,220,465,195,25,80,24,91,8,17
"Viktor Khryapa","POR",69,1492,88,190,74,14,43,11,20,8,6
"Jose Calderon","TOR",64,1487,288,679,185,103,80,33,72,35,68
"Eduardo Najera","DEN",64,1449,52,111,45,7,17,4,24,1,6
"Sasha Vujacic","LAL",82,1448,139,322,95,44,32,13,50,11,33
"Nick Collison","SEA",66,1448,74,159,63,11,38,10,15,2,9
"Quentin Richardson","NYK",55,1442,88,191,73,15,41,14,18,6,9
"Eddie House","PHX",81,1421,148,328,116,32,56,16,44,15,17
"Kurt Thomas","PHX",53,1411,57,137,34,23,13,3,18,4,19
"Joel Przybilla","POR",56,1395,43,92,37,6,15,8,14,3,3
"Reggie Evans","DEN",67,1393,38,86,28,10,17,1,10,1,9
"Nazr Mohammed","SAS",80,1389,40,87,33,7,22,2,9,3,4
"Ryan Gomes","BOS",61,1376,58,140,34,24,21,4,9,6,18
"Milt Palacio","UTA",71,1376,190,434,136,54,56,20,60,19,35
"Rashad McCants","MIN",79,1362,63,134,55,8,26,9,20,1,7
"Eddie Griffin","MIN",70,1359,40,85,35,5,22,2,11,0,5
"Melvin Ely","CHA",57,1348,76,176,52,24,26,3,23,12,12
"Stromile Swift","HOU",66,1344,25,53,22,3,18,2,2,2,1
"Luke Walton","LAL",69,1332,156,339,129,27,71,25,33,6,21
"Kendrick Perkins","BOS",68,1332,69,161,46,23,25,2,19,5,18
"Darius Songaila","CHI",62,1329,88,206,58,30,28,7,23,15,15
"Steven Hunter","PHI",69,1312,17,42,9,8,3,2,4,1,7
"Kirk Snyder","NOK",68,1310,102,219,87,15,41,7,39,1,14
"Bernard Robinson","CHA",66,1303,77,176,55,22,26,5,24,10,12
"Alonzo Mourning","MIA",65,1302,11,25,8,3,4,2,2,1,2
"Theo Ratliff","POR",55,1301,28,66,18,10,8,3,7,2,8
"Francisco Garcia","SAC",67,1301,94,205,77,17,41,11,25,4,13
"Darius Miles","POR",40,1286,73,168,51,22,24,9,18,9,13
"Johan Petro","SEA",68,1282,15,34,11,4,4,2,5,1,3
"Charlie Bell","MIL",59,1282,130,298,92,38,38,16,38,13,25
"Larry Hughes","CLE",36,1281,131,295,98,33,59,18,21,22,11
"Matt Carroll","CHA",78,1275,35,76,29,6,8,9,12,2,4
"Devin Harris","DAL",56,1274,177,403,128,49,47,18,63,19,30
"Brent Barry","SAS",74,1258,123,278,91,32,47,16,28,15,17
"Adrian Griffin","DAL",52,1245,89,204,63,26,21,14,28,6,20
"Salim Stoudamire","ATL",61,1236,75,165,60,15,33,4,23,6,9
"Orien Greene","BOS",80,1234,129,284,103,26,63,11,29,11,15
"Jacque Vaughn","NJN",80,1234,123,280,89,34,36,5,48,14,20
"Tyronn Lue","ATL",51,1234,157,355,116,41,58,8,50,12,29
"Keith McLeod","UTA",66,1232,151,324,129,22,48,15,66,6,16
"Michael Sweetney","CHI",66,1222,59,137,40,19,15,7,18,6,13
"Maurice Taylor","NYK",67,1210,53,116,43,10,24,12,7,3,7
"Carlos Arroyo","ORL",77,1194,232,502,194,38,88,16,90,18,20
"Robert Horry","SAS",63,1182,79,175,62,17,36,14,12,8,9
"Mickael Pietrus","GSW",52,1179,44,105,27,17,13,3,11,7,10
"Travis Outlaw","POR",69,1153,34,75,27,7,12,4,11,4,3
"Austin Croshere","IND",50,1148,62,149,37,25,17,12,8,8,17
"Maurice Evans","DET",80,1139,60,141,39,21,10,7,22,7,14
"Keyon Dooling","ORL",50,1137,109,235,92,17,44,12,36,1,16
"David Lee","NYK",67,1128,43,96,33,10,22,6,5,6,4
"Jamaal Tinsley","IND",42,1122,211,475,158,53,78,16,64,16,37
"Etan Thomas","WAS",71,1121,14,30,12,2,7,1,4,1,1
"Malik Rose","NYK",72,1118,67,146,55,12,31,14,10,3,9
"Kareem Rush","CHA",47,1111,50,114,36,14,13,4,19,5,9
"Keith Van Horn","DAL",53,1089,37,85,26,11,7,7,12,4,7
"Martell Webster","POR",61,1070,34,77,25,9,6,7,12,6,3
"Kevin Ollie","PHI",70,1069,101,223,80,21,40,9,31,8,13
"Al Jefferson","BOS",59,1063,30,68,22,8,15,2,5,0,8
"Derek Anderson","MIA",43,1047,101,224,79,22,43,11,25,13,9
"David Harrison","IND",67,1034,14,34,8,6,5,2,1,1,5
"Ike Diogu","GSW",69,1031,29,64,23,6,14,5,4,3,3
"Marc Jackson","NOK",64,1027,44,100,32,12,22,1,9,5,7
"Carlos Boozer","UTA",33,1025,88,187,77,11,38,9,30,0,11
"Toni Kukoc","MIL",65,1018,139,302,115,24,82,18,15,11,13
"Qyntel Woods","NYK",49,1012,47,108,33,14,17,6,10,9,5
"Michael Ruffin","WAS",76,1010,27,60,21,6,11,3,7,0,6
"Andris Biedrins","GSW",68,1000,24,56,16,8,8,1,7,3,5
"Trevor Ariza","ORL",57,999,61,129,54,7,28,10,16,4,3
"Justin Reed","MIN",72,996,41,90,33,8,9,1,23,2,6
"JR Smith","NOK",55,989,58,121,53,5,25,8,20,1,4
"Robert Swift","SEA",47,987,8,21,3,5,0,1,2,1,4
"Nick Van Exel","SAS",65,986,123,280,89,34,51,17,21,12,22
"Tony Allen","BOS",51,978,67,149,52,15,25,7,20,7,8
"Royal Ivey","ATL",73,977,74,164,58,16,27,8,23,4,12
"Daniel Ewing","LAC",66,971,84,180,72,12,28,19,25,2,10
"Dahntay Jones","MEM",71,967,39,92,25,14,16,4,5,8,6
"Gordan Giricek","UTA",37,956,63,135,54,9,23,6,25,3,6
"Dikembe Mutombo","HOU",64,955,4,9,3,1,2,0,1,0,1
"Brian Skinner","POR",65,944,30,70,20,10,12,0,8,2,8
"Corey Maggette","LAC",32,943,66,140,58,8,21,22,15,2,6
"Antonio Davis","TOR",44,940,21,53,10,11,3,5,2,4,7
"Brian Scalabrine","BOS",71,938,51,117,36,15,23,5,8,3,12
"Pat Garrity","ORL",57,937,38,87,27,11,18,2,7,2,9
"DerMarr Johnson","DEN",58,924,55,120,45,10,23,3,19,4,6
"Michael Olowokandi","BOS",48,918,23,53,16,7,6,1,9,3,4
"Joe Smith","MIL",44,887,31,71,22,9,16,2,4,4,5
"Monta Ellis","GSW",49,886,78,174,60,18,31,8,21,7,11
"Dan Gadzuric","MIL",74,885,24,56,16,8,10,2,4,2,6
"Emeka Okafor","CHA",26,874,31,71,22,9,9,2,11,3,6
"Jiri Welsch","MIL",58,866,62,135,51,11,31,8,12,4,7
"Damon Stoudamire","MEM",27,862,128,290,94,34,49,15,30,11,23
"Othella Harrington","CHI",72,824,39,88,29,10,11,5,13,2,8
"Jake Voskuhl","CHA",51,818,39,84,33,6,20,4,9,4,2
"Jason Hart","SAC",66,818,70,156,54,16,18,3,33,5,11
"Sasha Pavlovic","CLE",53,813,25,53,22,3,12,3,7,0,3
"Greg Ostertag","UTA",60,807,58,126,48,10,16,2,30,0,10
"Troy Hudson","MIN",36,800,106,231,87,19,36,18,33,7,12
"Aaron Williams","NOK",47,791,17,37,14,3,4,1,9,2,1
"Scot Pollard","IND",45,771,24,60,12,12,5,1,6,0,12
"Darko Milicic","ORL",55,767,41,88,35,6,22,6,7,3,3
"Anderson Varejao","CLE",48,760,19,42,15,4,12,0,3,1,3
"James Singleton","LAC",59,753,29,63,24,5,9,7,8,1,4
"Jackie Butler","NYK",55,740,25,56,19,6,12,2,5,3,3
"Jake Tsakalidis","MEM",51,732,13,30,9,4,3,3,3,3,1
"Carlos Delfino","DET",68,726,44,97,35,9,15,4,16,0,9
"Hakim Warrick","MEM",68,724,30,70,20,10,11,2,7,3,7
"Scott Padgett","NJN",62,718,41,95,28,13,12,3,13,6,7
"Malik Allen","CHI",54,701,20,44,16,4,3,3,10,1,3
"Mark Madsen","MIN",62,676,11,24,9,2,3,1,5,0,2
"Tim Thomas","PHX",29,665,20,44,16,4,9,3,4,3,1
"Jason Kapono","MIA",51,665,37,85,26,11,7,10,9,2,9
"Ryan Bowen","HOU",68,652,24,53,19,5,9,4,6,2,3
"Jannero Pargo","CHI",57,646,94,209,73,21,29,8,36,9,12
"Shandon Anderson","MIA",48,638,30,69,21,9,17,2,2,5,4
"Matt Barnes","PHI",56,631,28,61,23,5,15,1,7,2,3
"Darrell Armstrong","DAL",62,622,86,198,60,26,20,15,25,9,17
"Kris Humphries","UTA",62,619,30,62,28,2,15,3,10,0,2
"Grant Hill","ORL",21,613,48,101,43,5,29,5,9,2,3
"Rafael Araujo","TOR",52,601,15,33,12,3,5,5,2,1,2
"Zoran Planinic","NJN",56,595,53,120,39,14,15,2,22,3,11
"Pape Sow","TOR",42,590,8,16,8,0,4,0,4,0,0
"Anthony Carter","MIN",45,589,101,216,87,14,32,9,46,5,9
"Beno Udrih","SAS",54,586,92,208,68,24,29,11,28,11,13
"Mikki Moore","SEA",47,583,27,62,19,8,8,2,9,0,8
"Lamond Murray","NJN",57,575,13,31,8,5,5,1,2,2,3
"Antonio Burks","MEM",57,570,76,181,47,29,20,8,19,10,19
"Chris Andersen","NOK",32,570,6,14,4,2,3,1,0,2,0
"Alan Anderson","CHA",36,564,32,72,24,8,13,4,7,6,2
"Chuck Hayes","HOU",40,535,14,33,9,5,5,0,4,2,3
"Alan Henderson","CLE",51,531,10,23,7,3,3,2,2,1,2
"Linton Johnson","NOK",36,524,14,31,11,3,2,3,6,1,2
"Linas Kleiza","DEN",61,519,15,34,11,4,8,1,2,1,3
"Jarvis Hayes","WAS",21,516,27,62,19,8,12,1,6,1,7
"Jim Jackson","LAL",40,512,35,80,25,10,12,4,9,5,5
"Zarko Cabarkapa","GSW",61,505,20,44,16,4,11,1,4,3,1
"Bostjan Nachbar","NJN",36,502,27,63,18,9,4,3,11,3,6
"Esteban Batista","ATL",57,495,7,16,5,2,0,1,4,1,1
"Fabricio Oberto","SAS",59,490,27,62,19,8,7,4,8,1,7
"Shavlik Randolph","PHI",57,487,19,44,13,6,7,2,4,1,5
"Jeff McInnis","NJN",28,486,52,118,38,14,12,7,19,7,7
"Donell Taylor","WAS",51,465,45,105,30,15,19,3,8,4,11
"Voshon Lenard","POR",26,458,41,88,35,6,21,2,12,2,4
"Calbert Cheaney","GSW",42,448,19,42,15,4,6,4,5,1,3
"Josh Powell","DAL",37,429,9,20,7,2,1,1,5,0,2
"Moochie Norris","NOK",45,424,50,112,38,12,12,5,21,4,8
"Wayne Simien","MIA",43,414,7,15,6,1,2,2,2,0,1
"Zeljko Rebraca","LAC",29,412,9,19,8,1,1,3,4,0,1
"Jerome James","NYK",44,406,12,27,9,3,5,1,3,1,2
"Jackson Vroman","NOK",41,406,11,22,11,0,6,2,3,0,0
"Brian Cardinal","MEM",36,402,33,68,31,2,17,6,8,0,2
"Lonny Baxter","CHA",41,400,4,9,3,1,0,0,3,0,1
"Sean May","CHA",23,398,22,51,15,7,10,3,2,3,4
"Howard Eisley","DEN",32,394,69,148,59,10,22,4,33,5,5
"Stacey Augmon","ORL",36,385,23,52,17,6,3,3,11,0,6
"Tony Delk","DET",24,385,33,74,25,8,12,2,11,3,5
"Gerald Green","BOS",32,373,18,38,16,2,9,3,4,1,1
"Michael Doleac","MIA",31,371,8,16,8,0,3,1,4,0,0
"Antoine Wright","NJN",39,370,12,26,10,2,6,2,2,1,1
"Michael Bradley","PHI",46,367,17,43,8,9,3,0,5,3,6
"Corliss Williamson","SAC",37,362,14,32,10,4,3,3,4,3,1
"Bo Outlaw","ORL",32,355,14,30,12,2,7,2,3,0,2
"Ira Newble","CLE",36,353,9,19,8,1,4,0,4,0,1
"Lindsey Hunter","DET",30,353,62,130,56,6,17,4,35,5,1
"Walter McCarty","LAC",36,353,23,49,20,3,10,7,3,0,3
"Vitaly Potapenko","SAC",33,353,9,21,6,3,1,0,5,0,3
"Eric Williams","TOR",28,352,15,33,12,3,5,2,5,2,1
"Mike Wilks","SEA",47,347,32,78,18,14,5,5,8,3,11
"Pat Burke","PHX",42,346,16,39,9,7,0,1,8,3,4
"Sergei Monia","SAC",26,343,19,43,14,5,6,1,7,2,3
"Richie Frahm","HOU",33,342,21,49,14,7,4,3,7,3,4
"Jon Barry","HOU",20,342,26,63,15,11,5,7,3,3,8
"Kevin Burleson","CHA",39,340,48,109,35,13,9,6,20,8,5
"Darrick Martin","TOR",40,339,57,134,37,20,21,7,9,9,11
"Andrew Bynum","LAL",46,338,9,21,6,3,4,1,1,0,3
"Kelvin Cato","DET",27,333,4,9,3,1,2,0,1,1,0
"Loren Woods","TOR",27,324,4,10,2,2,0,0,2,1,1
"Luke Jackson","CLE",36,315,25,55,20,5,16,0,4,0,5
"John Edwards","ATL",40,296,5,12,3,2,0,0,3,0,2
"Andre Barrett","TOR",19,282,52,125,31,21,13,5,13,3,18
"Laron Profit","LAL",25,279,15,35,10,5,5,1,4,2,3
"Danny Fortson","SEA",23,276,2,5,1,1,1,0,0,0,1
"Brandon Bass","NOK",29,268,3,6,3,0,0,0,3,0,0
"Ronald Dupree","MIN",36,265,14,33,9,5,5,1,3,2,3
"Calvin Booth","WAS",33,250,12,26,10,2,4,0,6,0,2
"Brian Grant","PHX",21,248,7,18,3,4,1,1,1,0,4
"Rick Brunson","HOU",27,247,35,76,29,6,15,6,8,5,1
"Travis Diener","ORL",23,246,16,36,12,4,8,0,4,0,4
"Rawle Marshall","DAL",23,241,10,25,5,5,0,2,3,3,2
"Gerald Fitch","MIA",18,239,33,74,25,8,11,2,12,0,8
"Lee Nailon","PHI",22,237,7,16,5,2,5,0,0,2,0
"DJ Mbenga","DAL",43,237,2,5,1,1,0,0,1,1,0
"Dan Dickau","BOS",19,234,40,87,33,7,15,7,11,2,5
"Mateen Cleaves","SEA",27,230,42,102,24,18,12,4,8,5,13
"Eric Piatkowski","CHI",29,228,13,28,11,2,4,1,6,0,2
"Mario Kasun","ORL",28,213,3,6,3,0,1,0,2,0,0
"Robert Whaley","UTA",23,212,17,34,17,0,10,0,7,0,0
"Ha Ha","POR",27,212,1,3,0,1,0,0,0,0,1
"Andre Owens","UTA",23,210,8,19,5,3,3,0,2,2,1
"Charles Smith","DEN",22,210,9,20,7,2,4,1,2,0,2
"CJ Miles","UTA",23,203,16,32,16,0,11,1,4,0,0
"Jermaine Jackson","MIL",30,202,25,58,17,8,8,2,7,1,7
"Terence Morris","ORL",22,192,4,8,4,0,1,1,2,0,0
"Doug Christie","DAL",7,185,14,29,13,1,9,0,4,1,0
"Lawrence Roberts","MEM",33,181,5,12,3,2,3,0,0,0,2
"Sean Marks","SAS",25,181,7,15,6,1,2,3,1,1,0
"Dale Davis","DET",28,178,6,14,4,2,2,1,1,1,1
"Andray Blatche","WAS",29,175,10,21,9,1,8,0,1,0,1
"Stephen Graham","CLE",22,175,7,17,4,3,2,0,2,1,2
"Will Bynum","GSW",15,162,19,41,16,3,12,3,1,2,1
"Ronny Turiaf","LAL",23,161,8,21,3,5,1,1,1,2,3
"Jason Maxiell","DET",26,159,3,6,3,0,2,0,1,0,0
"Willie Green","PHI",10,153,5,13,2,3,2,0,0,1,2
"Boniface Ndong","LAC",23,151,7,16,5,2,3,1,1,1,1
"James Thomas","CHI",22,150,1,2,1,0,1,0,0,0,0
"Ronnie Price","SAC",29,150,11,23,10,1,4,1,5,1,0
"Luke Schenscher","CHI",20,149,7,14,7,0,3,2,2,0,0
"Lou Williams","PHI",30,145,10,22,8,2,5,1,2,0,2
"Chris Taft","GSW",17,144,2,4,2,0,1,0,1,0,0
"Eddie Basden","CHI",19,141,8,19,5,3,2,1,2,1,2
"Bracey Wright","MIN",7,135,5,10,5,0,4,0,1,0,0
"Devin Green","LAL",27,135,7,18,3,4,1,1,1,0,4
"Arvydas Macijauskas","NOK",19,134,5,12,3,2,2,1,0,1,1
"Dorell Wright","MIA",20,132,8,18,6,2,2,1,3,1,1
"Billy Thomas","WAS",17,131,9,20,7,2,3,2,2,0,2
"John Thomas","NJN",16,127,2,5,1,1,1,0,0,0,1
"Donta Smith","ATL",23,127,9,19,8,1,6,0,2,0,1
"Yaroslav Korolev","LAC",24,127,9,19,8,1,3,3,2,1,0
"Eddie Gill","IND",41,122,12,26,10,2,3,3,4,0,2
"Aaron McKie","LAL",14,121,11,25,8,3,6,0,2,0,3
"Aaron Miles","GSW",19,118,24,49,23,1,12,2,9,0,1
"Awvee Storey","WAS",25,116,4,9,3,1,0,1,2,1,0
"Ime Udoka","NYK",8,114,6,13,5,1,2,2,1,0,1
"Melvin Sanders","SAS",16,113,3,6,3,0,0,1,2,0,0
"Anthony Grundy","ATL",12,108,9,18,9,0,6,1,2,0,0
"John Lucas III","HOU",13,107,12,26,10,2,3,2,5,1,1
"Nikoloz Tskitishvili","PHX",17,99,3,6,3,0,1,2,0,0,0
"Anthony Roberson","MEM",16,88,5,11,4,1,0,1,3,0,1
"Dwayne Jones","BOS",14,86,2,5,1,1,1,0,0,0,1
"Vin Baker","LAC",8,85,4,8,4,0,3,0,1,0,0
"Noel Felix","SEA",12,82,2,4,2,0,1,0,1,0,0
"Ervin Johnson","MIL",18,81,2,4,2,0,2,0,0,0,0
"Von Wafer","LAL",16,73,4,9,3,1,2,0,1,1,0
"Anfernee Hardaway","NYK",4,72,8,19,5,3,1,1,3,1,2
"Reece Gaines","MIL",12,54,3,6,3,0,1,1,1,0,0
"Amar'e Stoudemire","PHX",3,50,2,4,2,0,1,1,0,0,0
"Zendon Hamilton","PHI",12,48,0,0,0,0,0,0,0,0,0
"Earl Barron","MIA",8,45,0,0,0,0,0,0,0,0,0
"Dijon Thompson","PHX",10,43,1,2,1,0,0,0,1,0,0
"Marcus Fizer","NOK",3,39,1,2,1,0,1,0,0,0,0
"Amir Johnson","DET",3,39,3,6,3,0,1,1,1,0,0
"Jamal Sampson","SAC",12,39,5,11,4,1,1,0,3,1,0
"Alex Acker","DET",5,35,4,9,3,1,1,0,2,1,0
"Julius Hodge","DEN",14,33,6,13,5,1,4,0,1,0,1
"Derrick Zimmerman","NJN",2,32,7,18,3,4,3,0,0,2,2
"Maciej Lampe","HOU",6,28,2,5,1,1,1,0,0,1,0
"Randy Livingston","CHI",5,22,1,2,1,0,1,0,0,0,0
"Anthony Goldwire","LAC",3,22,2,4,2,0,1,0,1,0,0
"Samaki Walker","IND",7,22,0,0,0,0,0,0,0,0,0
"Jonathan Bender","IND",2,21,2,5,1,1,1,0,0,0,1
"Pavel Podkolzin","DAL",1,18,0,0,0,0,0,0,0,0,0
"Josh Davis","PHX",6,17,1,2,1,0,1,0,0,0,0
"Sharrod Ford","PHX",3,13,0,0,0,0,0,0,0,0,0
"Randy Holcomb","CHI",4,11,0,0,0,0,0,0,0,0,0
"Alvin Williams","TOR",1,10,0,0,0,0,0,0,0,0,0
"Martynas Andriuskevicius","CLE",6,9,0,0,0,0,0,0,0,0,0
"Slava Medvedenko","LAL",2,6,1,2,1,0,0,0,1,0,0
"Deng Gai","PHI",2,5,0,0,0,0,0,0,0,0,0
"Matt Walsh","MIA",2,3,0,0,0,0,0,0,0,0,0
"Bryon Russell","DEN",1,3,1,2,1,0,1,0,0,0,0
"Nene","DEN",1,3,0,0,0,0,0,0,0,0,0
"Alex Scales","SAS",1,0,0,0,0,0,0,0,0,0,0