"Name","TeamAbbreviation","GamesPlayed","Minutes","Assists","AssistPoints","TwoPtAssists","ThreePtAssists","AtRimAssists","ShortMidRangeAssists","LongMidRangeAssists","Corner3Assists","Arc3Assists"
"James Harden","HOU",82,3125,612,1458,378,234,294,65,19,106,128
"Gordon Hayward","UTA",80,2893,296,704,184,112,124,35,25,55,57
"Kemba Walker","CHA",81,2885,421,1037,226,195,135,43,48,35,160
"Trevor Ariza","HOU",81,2859,188,456,108,80,78,18,12,28,52
"Marcus Morris","DET",80,2856,201,473,130,71,76,30,24,29,42
"Khris Middleton","MIL",79,2852,331,704,289,42,208,46,35,19,23
"Kyle Lowry","TOR",77,2851,494,1140,342,152,219,63,60,70,82
"Andrew Wiggins","MIN",81,2845,164,371,121,43,53,21,47,13,30
"Giannis Antetokounmpo","MIL",80,2823,345,754,281,64,161,65,55,23,41
"Paul George","IND",81,2819,329,730,257,72,174,37,46,30,42
"Draymond Green","GSW",81,2808,598,1411,383,215,268,53,62,70,145
"DeMar DeRozan","TOR",78,2804,315,790,155,160,104,28,23,51,109
"Kentavious Caldwell-Pope","DET",76,2789,138,335,79,59,52,20,7,23,36
"John Wall","WAS",77,2784,789,1854,513,276,293,89,131,89,187
"CJ McCollum","POR",80,2780,341,799,224,117,137,37,50,43,74
"Russell Westbrook","OKC",80,2750,834,1828,674,160,403,115,156,53,107
"Monta Ellis","IND",81,2734,383,893,256,127,163,42,51,49,78
"LeBron James","CLE",76,2709,514,1268,274,240,164,53,57,95,145
"Joe Johnson","MIA",81,2704,318,711,243,75,116,67,60,36,39
"Stephen Curry","GSW",79,2700,527,1222,359,168,264,42,53,46,122
"Damian Lillard","POR",75,2676,512,1217,319,193,202,50,67,67,126
"Klay Thompson","GSW",80,2666,166,384,114,52,86,12,16,21,31
"Andre Drummond","DET",81,2666,67,164,37,30,22,7,8,13,17
"Paul Millsap","ATL",81,2647,265,642,153,112,107,12,34,41,71
"Isaiah Thomas","BOS",82,2644,509,1190,337,172,188,47,102,54,118
"Wesley Matthews","DAL",78,2644,151,361,92,59,46,19,27,12,47
"Al Horford","ATL",82,2631,263,627,162,101,105,18,39,35,66
"Karl-Anthony Towns","MIN",82,2627,161,363,120,41,66,17,37,8,33
"DeAndre Jordan","LAC",77,2598,90,207,63,27,33,6,24,11,16
"Kevin Durant","OKC",72,2578,361,827,256,105,140,54,62,66,39
"Evan Fournier","ORL",79,2566,214,470,172,42,75,28,69,14,28
"Jordan Clarkson","LAL",79,2552,192,450,126,66,65,24,37,17,49
"Rodney Hood","UTA",79,2541,213,505,134,79,81,20,33,30,49
"PJ Tucker","PHX",82,2540,177,412,119,58,74,12,33,15,43
"Rajon Rondo","SAC",72,2537,839,1873,644,195,386,109,149,60,135
"Avery Bradley","BOS",76,2536,158,352,122,36,73,26,23,7,29
"Carmelo Anthony","NYK",72,2530,299,704,193,106,98,56,39,33,73
"George Hill","IND",74,2524,259,594,183,76,81,31,71,27,49
"Tobias Harris","DET",76,2513,169,406,101,68,47,26,28,24,44
"Serge Ibaka","OKC",78,2500,66,170,28,38,20,5,3,16,22
"Jimmy Butler","CHI",67,2474,321,745,218,103,83,43,92,31,72
"Brook Lopez","BKN",73,2457,146,331,107,39,72,17,18,10,29
"Nicolas Batum","CHA",70,2448,403,955,254,149,162,59,33,32,117
"Gary Harris","DEN",76,2439,147,334,107,40,65,17,25,10,30
"Kevin Love","CLE",77,2425,185,438,117,68,87,14,16,20,48
"Reggie Jackson","DET",79,2424,492,1150,326,166,205,63,58,52,114
"Chris Paul","LAC",74,2420,738,1710,504,234,295,41,168,60,174
"Jabari Parker","MIL",76,2408,130,287,103,27,73,15,15,10,17
"Thaddeus Young","BKN",73,2408,136,313,95,41,55,29,11,21,20
"Kyle Korver","ATL",80,2401,164,371,121,43,75,22,24,16,27
"Luol Deng","MIA",74,2394,140,328,92,48,61,12,19,23,25
"Kawhi Leonard","SAS",72,2380,186,425,133,53,59,25,49,13,40
"Victor Oladipo","ORL",72,2379,282,642,204,78,92,35,77,24,54
"Rudy Gay","SAC",70,2379,120,281,79,41,54,12,13,13,28
"Arron Afflalo","NYK",71,2371,144,335,97,47,33,25,39,8,39
"Dirk Nowitzki","DAL",75,2364,132,324,72,60,52,9,11,28,32
"Goran Dragic","MIA",72,2363,419,946,311,108,175,39,97,43,65
"JR Smith","CLE",77,2362,130,311,79,51,50,9,20,19,32
"Will Barton","DEN",82,2353,203,455,154,49,100,19,35,13,36
"Al-Farouq Aminu","POR",82,2341,138,335,79,59,49,16,14,19,40
"Marvin Williams","CHA",81,2338,110,270,60,50,30,8,22,11,39
"Courtney Lee","CHA",79,2334,136,315,93,43,34,23,36,16,27
"Ricky Rubio","MIN",76,2323,658,1398,576,82,292,110,174,21,61
"Greg Monroe","MIL",79,2314,178,410,124,54,82,16,26,16,38
"Jae Crowder","BOS",73,2308,135,305,100,35,71,12,17,8,27
"Zach LaVine","MIN",82,2293,251,554,199,52,108,29,62,12,40
"Pau Gasol","CHI",72,2292,294,669,213,81,160,32,21,17,64
"Julius Randle","LAL",81,2286,144,359,73,71,37,12,24,16,55
"Dwight Howard","HOU",71,2280,98,233,61,37,45,8,8,9,28
"Otto Porter Jr.","WAS",75,2276,120,269,91,29,62,13,16,10,19
"Evan Turner","BOS",81,2271,359,817,260,99,183,30,47,24,75
"Tristan Thompson","CLE",82,2269,62,162,24,38,14,3,7,8,30
"LaMarcus Aldridge","SAS",74,2261,110,261,69,41,36,14,19,10,31
"D'Angelo Russell","LAL",80,2259,266,609,189,77,106,35,48,16,61
"Dwyane Wade","MIA",74,2258,344,789,243,101,173,30,40,55,46
"Marcin Gortat","WAS",75,2256,106,245,73,33,39,7,27,7,26
"Jeff Teague","ATL",79,2255,470,1093,317,153,175,44,98,36,117
"Jeff Green","LAC",80,2253,138,328,86,52,42,22,22,25,27
"DeMarcus Cousins","SAC",65,2246,214,500,142,72,107,13,22,24,48
"Ish Smith","PHI",77,2239,502,1177,329,173,210,42,77,38,135
"Justise Winslow","MIA",78,2232,118,266,88,30,52,13,23,15,15
"Gorgui Dieng","MIN",82,2220,143,325,104,39,59,9,36,15,24
"Robin Lopez","NYK",82,2219,114,258,84,30,24,8,52,6,24
"Darren Collison","SAC",74,2219,318,733,221,97,125,58,38,15,82
"Raymond Felton","DAL",80,2192,284,690,162,122,100,14,48,39,83
"Matt Barnes","MEM",76,2190,163,355,134,29,83,24,27,14,15
"Anthony Davis","NOP",61,2164,116,274,74,42,50,9,15,9,33
"Hollis Thompson","PHI",77,2154,99,232,65,34,45,11,9,13,21
"Dion Waiters","OKC",78,2152,154,374,88,66,52,16,20,26,40
"Elfrid Payton","ORL",73,2145,467,1047,354,113,181,55,118,29,84
"Jamal Crawford","LAC",79,2126,183,417,132,51,100,10,22,15,36
"Hassan Whiteside","MIA",73,2126,29,61,26,3,17,3,6,1,2
"Bojan Bogdanovic","BKN",79,2115,99,227,70,29,32,20,18,12,17
"Devin Booker","PHX",76,2108,200,470,130,70,88,17,25,25,45
"Deron Williams","DAL",65,2106,378,905,229,149,115,36,78,30,119
"Allen Crabbe","POR",81,2105,99,234,63,36,38,10,15,8,28
"Jared Dudley","WAS",81,2098,171,394,119,52,79,26,14,18,34
"Derrick Rose","CHI",66,2098,311,713,220,91,93,27,100,37,54
"JJ Redick","LAC",75,2097,106,249,69,37,49,5,15,15,22
"Mason Plumlee","POR",82,2084,226,543,135,91,77,16,42,24,67
"Kent Bazemore","ATL",75,2083,171,380,133,38,85,20,28,8,30
"Emmanuel Mudiay","DEN",68,2068,372,841,275,97,182,48,45,26,71
"Jerami Grant","PHI",77,2066,135,333,72,63,43,13,16,19,44
"Danny Green","SAS",79,2061,141,315,108,33,48,25,35,15,18
"Jeremy Lin","CHA",78,2048,235,562,143,92,92,24,27,23,69
"Kristaps Porzingis","NYK",72,2046,94,224,58,36,30,11,17,12,24
"Cory Joseph","TOR",80,2046,250,602,148,102,80,36,32,30,72
"Harrison Barnes","GSW",66,2041,117,295,56,61,33,4,19,16,45
"Patrick Beverley","HOU",71,2041,239,566,151,88,104,35,12,33,55
"Nikola Vucevic","ORL",65,2037,179,444,93,86,69,6,18,18,68
"Langston Galloway","NYK",82,2033,207,480,141,66,67,20,54,20,46
"Jose Calderon","NYK",72,2024,298,694,200,98,80,51,69,33,65
"Patrick Patterson","TOR",79,2020,94,224,58,36,30,7,21,11,25
"Zach Randolph","MEM",68,2017,142,341,85,57,52,12,21,5,52
"Steven Adams","OKC",80,2015,62,146,40,22,17,6,17,7,15
"Ryan Anderson","NOP",66,2008,73,174,45,28,26,9,10,11,17
"Zaza Pachulia","DAL",76,2004,128,301,83,45,44,4,35,7,38
"Derrick Favors","UTA",62,1983,94,231,51,43,32,7,12,16,27
"Tony Parker","SAS",72,1981,379,841,296,83,105,60,131,22,61
"Dante Cunningham","NOP",80,1971,77,178,53,24,21,10,22,4,20
"Isaiah Canaan","PHI",77,1966,137,324,87,50,55,16,16,9,41
"Nerlens Noel","PHI",67,1965,122,283,83,39,62,13,8,9,30
"Garrett Temple","WAS",80,1951,140,320,100,40,48,21,31,11,29
"Taj Gibson","CHI",73,1936,106,244,74,32,33,14,27,4,28
"Rudy Gobert","UTA",61,1932,91,216,57,34,30,9,18,5,29
"Jared Sullinger","BOS",81,1915,187,440,121,66,67,24,30,16,50
"Lou Williams","LAL",67,1907,167,377,124,43,79,18,27,16,27
"Robert Covington","PHI",67,1903,97,225,66,31,54,8,4,10,21
"Ersan Ilyasova","ORL",74,1880,67,158,43,24,20,15,8,9,15
"Omri Casspi","SAC",69,1880,95,210,75,20,50,16,9,4,16
"Roy Hibbert","LAL",81,1878,95,216,69,26,27,14,28,7,19
"Brandon Knight","PHX",52,1870,263,636,153,110,99,30,24,35,75
"Matthew Dellavedova","CLE",76,1867,337,788,223,114,168,30,25,36,78
"Kobe Bryant","LAL",66,1863,184,416,136,48,79,26,31,9,39
"Aaron Gordon","ORL",78,1863,128,283,101,27,59,11,31,7,20
"Doug McDermott","CHI",81,1860,59,140,37,22,19,4,14,3,19
"Danilo Gallinari","DEN",53,1839,135,303,102,33,69,19,14,9,24
"Jrue Holiday","NOP",65,1831,391,901,272,119,155,46,71,29,90
"Alex Len","PHX",78,1821,97,231,60,37,33,12,15,10,27
"Ian Mahinmi","IND",71,1816,104,252,60,44,27,9,24,15,29
"Nik Stauskas","PHI",73,1809,138,315,99,39,66,15,18,17,22
"Bismack Biyombo","TOR",82,1808,29,72,15,14,9,2,4,2,12
"Amir Johnson","BOS",79,1800,138,322,92,46,43,15,34,8,38
"Chandler Parsons","DAL",61,1799,169,411,96,73,56,14,26,32,41
"Marc Gasol","MEM",52,1791,196,449,139,57,74,24,41,11,46
"Chris Bosh","MIA",53,1778,128,292,92,36,50,12,30,13,23
"Cody Zeller","CHA",73,1774,71,173,40,31,19,5,16,11,20
"Mike Conley","MEM",56,1761,342,756,270,72,111,60,99,19,53
"Thabo Sefolosha","ATL",75,1758,107,252,69,38,49,9,11,8,30
"Shane Larkin","BKN",78,1751,342,771,255,87,116,72,67,36,51
"Terrence Ross","TOR",73,1747,56,133,35,21,28,3,4,10,11
"Nikola Jokic","DEN",80,1733,189,438,129,60,93,11,25,20,40
"Andre Iguodala","GSW",65,1732,219,528,129,90,96,14,19,24,66
"Enes Kanter","OKC",82,1721,33,82,17,16,7,4,6,0,16
"Bradley Beal","WAS",55,1708,162,376,110,52,62,26,22,15,37
"Frank Kaminsky","CHA",81,1708,98,247,47,51,25,8,14,10,41
"Kenneth Faried","DEN",67,1695,79,188,49,30,33,3,13,4,26
"Stanley Johnson","DET",73,1687,118,282,72,46,46,20,6,18,28
"Mirza Teletovic","PHX",79,1685,89,211,56,33,43,5,8,8,25
"Ed Davis","POR",81,1684,88,208,56,32,25,5,26,10,22
"Shabazz Muhammad","MIN",82,1682,52,117,39,13,27,1,11,5,8
"Marco Belinelli","SAC",68,1672,127,298,83,44,51,14,18,16,28
"Corey Brewer","HOU",82,1669,109,257,70,39,56,10,4,16,23
"Kyrie Irving","CLE",53,1667,250,600,150,100,79,34,37,35,65
"Ramon Sessions","WAS",82,1667,239,538,179,60,91,36,52,10,50
"J.J. Barea","DAL",74,1667,302,692,214,88,126,36,52,24,64
"Marcus Smart","BOS",61,1667,185,428,127,58,92,15,20,19,39
"Wesley Johnson","LAC",80,1666,49,117,30,19,24,3,3,3,16
"Patty Mills","SAS",81,1662,226,498,180,46,79,35,66,15,31
"Michael Carter-Williams","MIL",54,1649,281,626,217,64,133,34,50,19,45
"Nikola Mirotic","CHI",66,1646,100,226,74,26,52,7,15,9,17
"Randy Foye","OKC",81,1641,161,375,108,53,62,16,30,13,40
"Luis Scola","TOR",76,1636,66,161,37,29,25,3,9,9,20
"Trevor Booker","UTA",79,1632,83,208,41,42,23,11,7,17,25
"Alonzo Gee","NOP",73,1632,72,172,44,28,24,7,13,5,23
"Markieff Morris","WAS",64,1629,124,293,79,45,52,15,12,14,31
"Dennis Schroder","ATL",80,1621,349,834,213,136,133,28,52,21,115
"Tony Allen","MEM",64,1620,70,151,59,11,27,19,13,2,9
"Tyson Chandler","PHX",66,1618,64,149,43,21,26,7,10,6,15
"Wayne Ellington","BKN",76,1615,83,189,60,23,34,13,13,7,16
"T.J. McConnell","PHI",81,1606,367,888,213,154,150,30,33,52,102
"Lavoy Allen","IND",79,1599,76,183,45,31,25,8,12,9,22
"Jahlil Okafor","PHI",53,1591,65,152,43,22,27,8,8,4,18
"Jonas Valanciunas","TOR",60,1557,42,106,20,22,14,3,3,6,16
"Gerald Green","MIA",69,1557,56,124,44,12,24,7,13,7,5
"Andre Roberson","OKC",70,1553,47,111,30,17,15,4,11,4,13
"Tim Duncan","SAS",61,1537,163,354,135,28,83,21,31,9,19
"Shaun Livingston","GSW",78,1519,237,547,164,73,87,26,51,20,53
"Darrell Arthur","DEN",70,1516,96,217,71,25,45,16,10,3,22
"Jordan Hill","IND",73,1513,87,204,57,30,30,8,19,9,21
"Jerryd Bayless","MIL",52,1505,163,367,122,41,59,18,45,13,28
"Raul Neto","UTA",81,1499,174,398,124,50,91,19,14,31,19
"Kosta Koufos","SAC",78,1482,33,80,19,14,10,2,7,5,9
"Eric Gordon","NOP",45,1481,121,271,92,29,46,20,26,13,16
"Clint Capela","HOU",77,1471,47,108,33,14,24,5,4,3,11
"CJ Miles","IND",64,1464,63,150,39,24,27,4,8,9,15
"Austin Rivers","LAC",67,1463,99,245,52,47,24,10,18,21,26
"Tayshaun Prince","MIN",77,1461,74,165,57,17,23,17,17,2,15
"Maurice Harkless","POR",78,1457,67,161,40,27,25,6,9,8,19
"Andrew Bogut","GSW",70,1451,162,392,94,68,58,11,25,14,54
"JaMychal Green","MEM",78,1446,67,151,50,17,29,11,10,3,14
"Ben McLemore","SAC",68,1443,79,182,55,24,41,11,3,8,16
"Derrick Williams","NYK",80,1435,75,172,53,22,23,11,19,2,20
"Gerald Henderson","POR",72,1431,75,181,44,31,30,6,8,8,23
"Mario Hezonja","ORL",79,1413,109,237,90,19,46,18,26,8,11
"Willie Cauley-Stein","SAC",66,1411,37,85,26,11,19,3,4,0,11
"Ty Lawson","IND",66,1411,237,557,154,83,106,25,23,33,50
"David West","SAS",78,1404,143,326,103,40,72,15,16,18,22
"Kelly Olynyk","BOS",69,1395,105,243,72,33,46,6,20,12,21
"Boris Diaw","SAS",76,1386,176,410,118,58,63,26,29,14,44
"Trey Lyles","UTA",80,1382,59,154,23,36,14,3,6,12,24
"Mario Chalmers","MEM",61,1373,230,525,165,65,87,28,50,27,38
"Lance Stephenson","MEM",69,1372,133,299,100,33,67,11,22,11,22
"Myles Turner","IND",60,1367,41,98,25,16,13,6,6,3,13
"Trey Burke","UTA",64,1366,148,342,102,46,67,15,20,22,24
"Brandon Bass","LAL",66,1342,74,175,47,27,22,12,13,7,20
"Anthony Tolliver","DET",72,1341,52,124,32,20,16,13,3,6,14
"Meyers Leonard","POR",61,1332,92,226,50,42,25,8,17,11,31
"Timofey Mozgov","CLE",76,1326,33,79,20,13,8,3,9,4,9
"Richard Jefferson","CLE",74,1325,59,139,38,21,18,9,11,7,14
"Donald Sloan","BKN",61,1318,268,598,206,62,105,43,58,18,44
"Iman Shumpert","CLE",54,1316,92,231,45,47,32,8,5,9,38
"Lance Thomas","NYK",59,1313,53,119,40,13,12,13,15,1,12
"PJ Hairston","MEM",66,1313,38,90,24,14,12,3,9,2,12
"Tony Snell","CHI",64,1301,63,138,51,12,20,6,25,7,5
"Devin Harris","DAL",64,1280,118,268,86,32,54,11,21,11,21
"Rodney Stuckey","IND",58,1275,142,335,91,51,56,16,19,19,32
"Luc Mbah a Moute","LAC",74,1274,30,74,16,14,8,1,7,3,11
"Larry Nance Jr.","LAL",63,1266,44,105,27,17,11,5,11,5,12
"Jerian Grant","NYK",76,1265,177,418,113,64,58,29,26,24,40
"E'Twaun Moore","CHI",59,1263,99,225,72,27,38,12,22,7,20
"Toney Douglas","NOP",61,1262,157,363,108,49,63,18,27,16,33
"Jason Terry","HOU",72,1258,103,249,60,43,49,6,5,13,30
"Jon Leuer","PHX",67,1255,72,172,44,28,29,7,8,5,23
"Kyle Anderson","SAS",78,1245,123,277,92,31,58,11,23,10,21
"Joe Ingles","UTA",81,1241,96,219,69,27,54,9,6,9,18
"Aron Baynes","DET",81,1233,51,124,29,22,16,5,8,6,16
"Paul Pierce","LAC",68,1230,71,167,46,25,34,7,5,12,13
"Jeremy Lamb","CHA",66,1227,77,182,49,28,30,8,11,9,19
"Ronnie Price","PHX",62,1211,147,341,100,47,53,16,31,10,37
"Channing Frye","CLE",70,1199,71,164,49,22,27,15,7,4,18
"Norris Cole","NOP",45,1198,167,370,131,36,67,28,36,8,28
"Jason Smith","ORL",76,1181,62,144,42,20,21,4,17,5,15
"Omer Asik","NOP",68,1178,26,60,18,8,9,1,8,1,7
"D.J. Augustin","DEN",62,1178,198,445,149,49,94,22,33,22,27
"Jonas Jerebko","BOS",78,1177,62,142,44,18,24,6,14,2,16
"Noah Vonleh","POR",78,1174,30,77,13,17,7,0,6,6,11
"Blake Griffin","LAC",35,1170,170,411,99,71,45,12,42,22,49
"JaKarr Sampson","DEN",73,1160,46,115,23,23,14,5,4,6,17
"Mike Scott","ATL",75,1146,78,183,51,27,38,4,9,10,17
"Manu Ginobili","SAS",58,1134,177,396,135,42,76,27,32,14,28
"Archie Goodwin","PHX",57,1114,118,277,77,41,39,16,22,12,29
"Marcus Thornton","WAS",61,1108,84,192,60,24,53,6,1,9,15
"Aaron Brooks","CHI",69,1108,180,429,111,69,55,21,35,19,50
"Josh Richardson","MIA",52,1107,73,166,53,20,22,12,19,7,13
"Bobby Portis","CHI",62,1102,52,128,28,24,16,3,9,3,21
"Al Jefferson","CHA",47,1097,70,164,46,24,30,1,15,2,22
"Kevin Martin","SAS",55,1095,58,133,41,17,15,11,15,3,14
"Nene","WAS",57,1094,97,214,77,20,50,11,16,10,10
"O.J. Mayo","MIL",41,1090,118,254,100,18,61,23,16,2,16
"Leandro Barbosa","GSW",68,1079,82,191,55,27,35,7,13,10,17
"Nemanja Bjelica","MIN",60,1075,82,182,64,18,40,10,14,7,11
"TJ Warren","PHX",47,1070,44,105,27,17,11,6,10,3,14
"Eric Bledsoe","PHX",31,1059,190,447,123,67,80,14,29,19,48
"Shelvin Mack","UTA",52,1058,187,432,129,58,75,28,26,24,34
"Brandon Rush","GSW",72,1055,57,137,34,23,17,12,5,8,15
"Terrence Jones","HOU",50,1044,41,104,19,22,17,1,1,7,15
"Joffrey Lauvergne","DEN",59,1041,56,134,34,22,23,3,8,4,18
"Jameer Nelson","DEN",39,1036,190,437,133,57,68,29,36,16,41
"Spencer Hawes","CHA",57,1035,109,253,74,35,44,7,23,8,27
"Nick Young","LAL",54,1033,34,78,24,10,16,2,6,1,9
"Jarrett Jack","BKN",32,1027,236,509,199,37,88,71,40,13,24
"Vince Carter","MEM",60,1005,56,127,41,15,23,9,9,7,8
"Rashad Vaughn","MIL",70,1001,39,86,31,8,18,5,8,3,5
"Dwight Powell","DAL",69,992,44,108,24,20,13,4,7,1,19
"Steve Blake","DET",58,986,200,477,123,77,74,30,19,24,53
"Markel Brown","BKN",62,982,91,202,71,20,45,11,15,7,13
"Kyle Singler","OKC",68,977,24,55,17,7,13,1,3,3,4
"John Henson","MIL",57,959,54,121,41,13,26,7,8,3,10
"Chase Budinger","PHX",66,930,64,144,48,16,32,6,10,3,13
"Anthony Morrow","OKC",68,926,24,57,15,9,13,0,2,3,6
"James Johnson","TOR",57,926,67,156,45,22,32,7,6,12,10
"Thomas Robinson","BKN",71,916,46,102,36,10,25,5,6,4,6
"Sasha Vujacic","NYK",61,908,84,196,56,28,23,12,21,12,16
"David Lee","DAL",55,903,84,203,49,35,23,7,19,15,20
"Josh Smith","HOU",55,880,90,208,62,28,43,9,10,18,10
"Quincy Acy","SAC",59,876,27,62,19,8,9,4,6,3,5
"Miles Plumlee","MIL",61,870,16,34,14,2,4,4,6,1,1
"Marcelo Huertas","LAL",53,869,182,415,131,51,87,20,24,14,37
"Brandon Jennings","ORL",48,868,170,392,118,52,68,18,32,14,38
"Solomon Hill","IND",59,866,57,130,41,16,23,6,12,8,8
"Tim Hardaway Jr.","ATL",51,864,51,121,32,19,17,4,11,5,14
"Tyler Johnson","MIA",36,863,79,182,55,24,26,12,17,10,14
"Alexis Ajinca","NOP",59,861,31,75,18,13,12,2,4,1,12
"Johnny O'Bryant III","MIL",66,857,32,73,23,9,10,6,7,2,7
"Chris Johnson","UTA",70,857,45,103,32,13,23,4,5,6,7
"Luke Babbitt","NOP",47,845,53,124,35,18,20,5,10,3,15
"Kris Humphries","ATL",53,835,36,82,26,10,13,3,10,4,6
"Marreese Speights","GSW",72,832,61,144,39,22,21,6,12,5,17
"Andrew Nicholson","ORL",56,823,25,65,10,15,3,3,4,7,8
"Pablo Prigioni","LAC",59,823,130,308,82,48,47,13,22,21,27
"Jonathon Simmons","SAS",55,813,58,142,32,26,14,7,11,6,20
"Gary Neal","WAS",40,807,47,112,29,18,12,5,12,6,12
"Cole Aldrich","LAC",60,800,50,125,25,25,11,7,7,11,14
"Alec Burks","UTA",31,797,63,146,43,20,32,2,9,9,11
"DeMarre Carroll","TOR",26,786,27,69,12,15,8,1,3,6,9
"Justin Holiday","CHI",53,772,56,126,42,14,26,7,9,3,11
"Festus Ezeli","GSW",46,770,32,83,13,19,3,1,9,7,12
"Tyreke Evans","NOP",25,765,164,390,102,62,53,10,39,15,47
"Kyle O'Quinn","NYK",65,764,72,156,60,12,36,5,19,2,10
"Amar'e Stoudemire","MIA",52,762,27,60,21,6,7,6,8,5,1
"Mo Williams","CLE",41,748,98,223,71,27,52,7,12,8,19
"Tim Frazier","NOP",51,741,162,372,114,48,66,20,28,13,35
"Norman Powell","TOR",49,725,47,117,24,23,12,6,6,9,14
"James Anderson","SAC",51,721,41,98,25,16,15,5,5,11,5
"Tyler Zeller","BOS",60,710,29,64,23,6,11,1,11,2,4
"Beno Udrih","MIA",44,708,116,264,84,32,36,18,30,8,24
"Dewayne Dedmon","ORL",58,705,13,31,8,5,5,0,3,0,5
"Mike Dunleavy","CHI",31,703,39,89,28,11,14,4,10,5,6
"Richaun Holmes","PHI",51,702,33,78,21,12,15,3,3,4,8
"Nick Collison","OKC",59,699,52,112,44,8,26,11,7,1,7
"Cameron Payne","OKC",57,698,108,251,73,35,40,13,20,10,25
"Seth Curry","SAC",44,692,67,153,48,19,28,13,7,6,13
"Kelly Oubre Jr.","WAS",63,671,13,29,10,3,7,2,1,1,2
"Charlie Villanueva","DAL",62,665,24,52,20,4,15,1,4,2,2
"Jeff Withey","UTA",51,658,20,53,7,13,3,0,4,2,11
"C.J. Watson","ORL",33,656,88,202,62,26,24,6,32,9,17
"Tyler Ennis","MIL",46,654,95,212,73,22,43,13,17,8,14
"Justin Anderson","DAL",55,647,29,70,17,12,11,1,5,2,10
"Joakim Noah","CHI",29,635,110,257,73,37,38,12,23,4,33
"Andrea Bargnani","BKN",46,634,18,43,11,7,5,1,5,3,4
"Kirk Hinrich","ATL",46,631,73,171,48,25,21,11,16,6,19
"Sean Kilpatrick","BKN",31,616,29,70,17,12,11,1,5,3,9
"Rondae Hollis-Jefferson","BKN",29,615,43,93,36,7,18,8,10,4,3
"Shabazz Napier","ORL",55,600,97,231,60,37,26,8,26,10,27
"Anthony Brown","LAL",29,599,19,45,12,7,5,2,5,3,4
"Josh McRoberts","MIA",42,595,81,179,64,17,38,8,18,3,14
"Metta World Peace","LAL",35,590,27,60,21,6,9,4,8,2,4
"Tiago Splitter","ATL",36,580,30,67,23,7,14,3,6,2,5
"Ian Clark","GSW",66,578,64,155,37,27,15,7,15,2,25
"Tyus Jones","MIN",37,573,108,243,81,27,56,10,15,15,12
"Carl Landry","PHI",36,569,32,81,15,17,8,1,6,4,13
"Mike Muscala","ATL",60,565,34,79,23,11,15,5,3,5,6
"Kevin Garnett","MIN",38,556,62,135,51,11,19,9,23,1,10
"Jusuf Nurkic","DEN",32,547,40,92,28,12,20,3,5,4,8
"Donatas Motiejunas","HOU",37,547,41,96,27,14,23,1,3,4,10
"Kendrick Perkins","NOP",37,542,31,70,23,8,12,4,7,4,4
"Kevin Seraphin","NYK",48,526,47,100,41,6,18,9,14,2,4
"Glenn Robinson III","IND",45,508,26,57,21,5,12,2,7,3,2
"Boban Marjanovic","SAS",54,508,21,47,16,5,9,1,6,2,3
"Sonny Weems","PHI",43,498,49,114,33,16,24,5,4,2,14
"Tarik Black","LAL",39,496,16,39,9,7,4,1,4,0,7
"Anderson Varejao","GSW",53,496,35,86,19,16,11,3,5,3,13
"Adreian Payne","MIN",52,486,29,65,22,7,10,4,8,0,7
"John Jenkins","PHX",43,480,35,83,22,13,10,7,5,4,9
"Troy Daniels","CHA",43,476,21,48,15,6,6,4,5,3,3
"Ray McCallum","MEM",41,474,60,132,48,12,10,10,28,5,7
"Jason Thompson","TOR",47,471,29,66,21,8,11,5,5,3,5
"Brian Roberts","POR",51,470,54,129,33,21,13,9,11,8,13
"Ryan Kelly","LAL",36,470,20,47,13,7,9,2,2,1,6
"James Jones","CLE",48,463,14,34,8,6,5,1,2,3,3
"Andre Miller","SAS",39,461,87,198,63,24,38,3,22,3,21
"Greivis Vasquez","MIL",23,460,91,206,67,24,43,13,11,7,17
"Ryan Hollins","MEM",37,460,10,22,8,2,6,0,2,1,1
"JJ Hickson","WAS",35,436,23,54,15,8,7,2,6,3,5
"Rasual Butler","SAS",46,431,24,58,14,10,9,1,4,5,5
"Reggie Bullock","DET",37,429,27,64,17,10,9,4,4,4,6
"Willie Reed","BKN",39,426,10,23,7,3,5,2,0,1,2
"Jared Cunningham","MIL",44,410,20,46,14,6,7,3,4,1,5
"Chris Andersen","MEM",27,403,12,28,8,4,6,0,2,1,3
"Kendall Marshall","PHI",30,400,73,169,50,23,32,9,9,8,15
"Sergey Karasev","BKN",40,399,35,81,24,11,14,5,5,6,5
"Salah Mejri","DAL",34,397,10,24,6,4,3,0,3,1,3
"Lamar Patterson","ATL",35,395,39,91,26,13,18,6,2,3,10
"Joe Young","IND",41,383,65,141,54,11,21,10,23,5,6
"Darrun Hilliard","DET",38,383,27,66,15,12,5,7,3,3,9
"Jarell Martin","MEM",27,380,15,35,10,5,6,2,2,1,4
"Montrezl Harrell","HOU",39,379,17,43,8,9,8,0,0,2,7
"Mike Miller","DEN",46,373,40,93,27,13,21,4,2,1,12
"JaVale McGee","DAL",34,370,3,6,3,0,1,0,2,0,0
"Michael Beasley","HOU",20,363,16,36,12,4,7,4,1,2,2
"Chris McCullough","BKN",24,362,9,20,7,2,3,0,4,2,0
"Tyler Hansbrough","CHA",44,343,8,20,4,4,3,1,0,1,3
"James Ennis III","NOP",22,328,21,42,21,0,14,4,3,0,0
"Cristiano Felicio","CHI",31,321,26,64,14,12,11,1,2,2,10
"Robert Sacre","LAL",25,320,14,34,8,6,2,2,4,1,5
"RJ Hunter","BOS",36,314,13,27,12,1,7,0,5,0,1
"Terry Rozier","BOS",39,311,37,92,19,18,10,2,7,3,15
"Axel Toupane","DEN",21,305,15,35,10,5,3,5,2,4,1
"Drew Gooden","WAS",30,305,13,31,8,5,2,3,3,1,4
"Jordan Hamilton","NOP",11,304,25,59,16,9,10,1,5,2,7
"Kostas Papanikolaou","DEN",26,294,16,38,10,6,7,1,2,1,5
"Jordan Farmar","MEM",12,291,37,83,28,9,16,4,8,4,5
"Phil Pressey","PHX",23,283,75,184,41,34,29,6,6,6,28
"Bryce Dejean-Jones","NOP",14,279,15,34,11,4,8,2,1,0,4
"Damjan Rudez","MIN",33,277,11,24,9,2,4,4,1,2,0
"Henry Sims","BKN",14,263,9,19,8,1,5,2,1,1,0
"James Michael McAdoo","GSW",41,262,17,41,10,7,4,4,2,0,7
"Udonis Haslem","MIA",37,260,14,31,11,3,6,2,3,0,3
"Jeremy Evans","DAL",30,251,2,4,2,0,1,0,1,0,0
"Devyn Marble","ORL",28,249,12,30,6,6,4,1,1,3,3
"Xavier Munford","MEM",14,244,22,47,19,3,13,0,6,0,3
"KJ McDaniels","HOU",37,235,10,22,8,2,4,1,3,1,1
"Delon Wright","TOR",27,229,31,75,18,13,10,3,5,6,7
"Elton Brand","PHI",17,225,18,47,7,11,5,0,2,3,8
"Lucas Nogueira","TOR",29,225,7,16,5,2,4,1,0,0,2
"DeJuan Blair","WAS",29,218,11,27,6,5,4,1,1,0,5
"Brandan Wright","MEM",12,212,6,14,4,2,2,0,2,1,1
"Matt Bonner","SAS",30,206,9,22,5,4,4,1,0,1,3
"Michael Kidd-Gilchrist","CHA",7,205,9,24,3,6,2,0,1,2,4
"Lou Amundson","NYK",29,204,12,25,11,1,3,1,7,1,0
"James Young","BOS",29,199,9,23,4,5,3,0,1,1,4
"Jordan McRae","CLE",22,196,25,59,16,9,13,3,0,6,3
"Alan Anderson","WAS",13,192,14,31,11,3,8,2,1,2,1
"Greg Smith","MIN",18,192,6,13,5,1,1,0,4,0,1
"Caron Butler","SAC",17,176,10,24,6,4,4,1,1,3,1
"Elijah Millsap","UTA",20,173,19,47,10,9,4,3,3,4,5
"Briante Weber","MIA",7,169,21,48,15,6,12,1,2,1,5
"CJ Wilcox","LAC",23,167,10,22,8,2,2,1,5,0,2
"Spencer Dinwiddie","DET",12,159,22,50,16,6,8,5,3,1,5
"Damien Inglis","MIL",20,156,10,22,8,2,5,1,2,1,1
"Nikola Pekovic","MIN",12,156,11,27,6,5,1,2,3,2,3
"Chris Copeland","MIL",24,156,11,26,7,4,5,1,1,1,3
"Cleanthony Early","NYK",17,154,6,14,4,2,3,0,1,0,2
"Jarell Eddie","WAS",26,147,5,11,4,1,4,0,0,0,1
"Christian Wood","PHI",17,145,3,7,2,1,2,0,0,0,1
"Tony Wroten","PHI",8,144,20,46,14,6,11,2,1,4,2
"Pat Connaughton","POR",34,143,10,25,5,5,3,0,2,1,4
"Chris Kaman","POR",16,112,11,25,8,3,4,0,4,1,2
"Jeff Ayres","LAC",17,107,5,11,4,1,4,0,0,0,1
"Cameron Bairstow","CHI",18,103,6,13,5,1,5,0,0,1,0
"Orlando Johnson","NOP",7,102,2,4,2,0,1,1,0,0,0
"Joel Anthony","DET",19,96,1,2,1,0,1,0,0,0,0
"Sasha Kaun","CLE",25,95,3,7,2,1,1,0,1,0,1
"Aaron Harrison","CHA",21,93,2,4,2,0,1,1,0,0,0
"Anthony Bennett","TOR",19,84,0,0,0,0,0,0,0,0,0
"Tibor Pleiss","UTA",12,82,2,5,1,1,1,0,0,0,1
"Edy Tavares","ATL",11,73,3,7,2,1,2,0,0,0,1
"Mitch McGary","OKC",20,72,3,7,2,1,0,0,2,1,0
"Alex Stepheson","MEM",8,72,2,5,1,1,1,0,0,0,1
"Alan Williams","PHX",10,68,5,12,3,2,3,0,0,0,2
"Russ Smith","MEM",15,66,11,26,7,4,3,2,2,2,2
"Jorge Gutierrez","CHA",12,63,17,42,9,8,2,2,5,3,5
"Lorenzo Brown","PHX",8,61,11,25,8,3,6,1,1,1,2
"Jordan Mickey","BOS",16,57,1,3,0,1,0,0,0,0,1
"Josh Huestis","OKC",5,55,0,0,0,0,0,0,0,0,0
"Cory Jefferson","PHX",7,50,0,0,0,0,0,0,0,0,0
"Andrew Goudelock","HOU",8,50,4,9,3,1,3,0,0,0,1
"Eric Moreland","SAC",8,48,1,3,0,1,0,0,0,0,1
"Elliot Williams","MEM",5,45,4,9,3,1,1,1,1,0,1
"Steve Novak","MIL",10,44,0,0,0,0,0,0,0,0,0
"Jodie Meeks","DET",3,43,3,7,2,1,2,0,0,1,0
"Bruno Caboclo","TOR",6,43,1,3,0,1,0,0,0,0,1
"Dahntay Jones","CLE",1,42,2,5,1,1,1,0,0,0,1
"Erick Green","UTA",9,42,3,9,0,3,0,0,0,1,2
"Luis Montero","POR",12,42,1,2,1,0,1,0,0,0,0
"Shayne Whittington","IND",7,41,3,7,2,1,1,1,0,0,1
"Bryce Cotton","MEM",8,39,3,7,2,1,0,0,2,0,1
"Cliff Alexander","POR",8,36,0,0,0,0,0,0,0,0,0
"Justin Harper","DET",5,35,0,0,0,0,0,0,0,0,0
"Branden Dawson","LAC",6,29,0,0,0,0,0,0,0,0,0
"Keith Appling","ORL",5,27,1,3,0,1,0,0,0,0,1
"Duje Dukan","SAC",1,24,1,2,1,0,1,0,0,0,0
"Chuck Hayes","HOU",2,24,2,4,2,0,2,0,0,0,0
"Nate Robinson","NOP",2,23,4,9,3,1,0,2,1,0,1
"Kevon Looney","GSW",5,21,0,0,0,0,0,0,0,0,0
"Nazr Mohammed","OKC",5,19,0,0,0,0,0,0,0,0,0
"Jarnell Stokes","MIA",7,19,1,3,0,1,0,0,0,0,1
"Jimmer Fredette","NYK",6,18,1,3,0,1,0,0,0,0,1
"Joe Harris","CLE",5,15,2,5,1,1,0,1,0,0,1
"Jordan Adams","MEM",2,15,3,6,3,0,2,0,1,0,0
"JJ O'Brien","UTA",2,6,0,0,0,0,0,0,0,0,0
"Thanasis Antetokounmpo","NYK",2,6,0,0,0,0,0,0,0,0,0
"Sam Dekker","HOU",3,6,0,0,0,0,0,0,0,0,0
"Rakeem Christmas","IND",1,6,0,0,0,0,0,0,0,0,0
"Coty Clarke","BOS",3,6,0,0,0,0,0,0,0,0,0