"Name","TeamAbbreviation","GamesPlayed","Minutes","Assists","AssistPoints","TwoPtAssists","ThreePtAssists","AtRimAssists","ShortMidRangeAssists","LongMidRangeAssists","Corner3Assists","Arc3Assists"
"LeBron James","CLE",82,3026,747,1838,403,344,285,55,63,130,214
"Khris Middleton","MIL",82,2982,328,758,226,102,174,31,21,38,64
"Andrew Wiggins","MIN",82,2979,160,381,99,61,56,22,21,23,38
"Bradley Beal","WAS",82,2977,373,878,241,132,121,75,45,37,95
"Jrue Holiday","NOP",81,2927,486,1140,318,168,208,70,40,49,119
"CJ McCollum","POR",81,2923,272,649,167,105,108,29,30,32,73
"Karl-Anthony Towns","MIN",82,2918,199,456,141,58,81,31,29,18,40
"Russell Westbrook","OKC",80,2914,820,1950,510,310,371,83,56,86,224
"Paul George","OKC",79,2891,263,626,163,100,112,29,22,40,60
"Giannis Antetokounmpo","MIL",75,2756,361,894,189,172,122,34,33,59,113
"Kemba Walker","CHA",80,2736,444,1035,297,147,171,66,60,33,114
"Ben Simmons","PHI",81,2732,661,1624,359,302,250,52,57,46,256
"Anthony Davis","NOP",75,2727,174,423,99,75,59,27,13,23,52
"Taj Gibson","MIN",82,2727,99,237,60,39,35,10,15,9,30
"DeMar DeRozan","TOR",80,2712,417,1035,216,201,136,54,26,56,145
"Josh Richardson","MIA",81,2689,231,550,143,88,96,28,19,26,62
"Will Barton","DEN",81,2683,331,782,211,120,151,39,21,26,94
"Damian Lillard","POR",73,2670,481,1110,333,148,219,75,39,40,108
"Tobias Harris","LAC",80,2668,192,473,103,89,76,16,11,30,59
"Donovan Mitchell","UTA",79,2638,291,712,161,130,123,19,19,53,77
"Harrison Barnes","DAL",77,2634,152,391,65,87,38,12,15,23,64
"Andre Drummond","DET",78,2625,237,526,185,52,94,44,47,12,40
"Thaddeus Young","IND",81,2607,152,367,89,63,59,11,19,25,38
"Lou Williams","LAC",79,2589,417,929,322,95,264,41,17,34,61
"E'Twaun Moore","NOP",82,2586,187,430,131,56,80,34,17,16,40
"Joe Ingles","UTA",82,2579,392,886,290,102,210,44,36,41,61
"Jamal Murray","DEN",81,2565,274,653,169,105,91,44,34,17,88
"Victor Oladipo","IND",75,2552,323,751,218,105,140,31,47,33,72
"James Harden","HOU",72,2551,630,1501,389,241,359,16,14,76,165
"Robert Covington","PHI",80,2531,156,367,101,55,73,15,13,14,41
"Kyle Lowry","TOR",78,2510,537,1209,402,135,268,76,58,46,89
"LaMarcus Aldridge","SAS",75,2509,152,373,83,69,35,19,29,17,52
"Klay Thompson","GSW",73,2504,185,412,143,42,105,23,15,12,30
"Carmelo Anthony","OKC",78,2501,103,262,47,56,33,4,10,21,35
"Steven Adams","OKC",76,2487,88,213,51,37,32,6,13,11,26
"Bojan Bogdanovic","IND",80,2464,119,278,79,40,47,13,19,13,27
"Taurean Prince","ATL",82,2464,214,504,138,76,94,20,24,43,33
"Dwight Howard","CHA",81,2463,105,250,65,40,33,11,21,6,34
"Kentavious Caldwell-Pope","LAL",74,2458,162,378,108,54,83,17,8,11,43
"Jayson Tatum","BOS",80,2443,128,317,67,61,37,19,11,17,44
"Nikola Jokic","DEN",75,2443,458,1062,312,146,221,67,24,30,116
"Otto Porter Jr.","WAS",77,2432,157,365,106,51,50,41,15,11,40
"DeAndre Jordan","LAC",77,2424,117,270,81,36,46,11,24,10,26
"Marc Gasol","MEM",73,2408,305,741,174,131,126,16,32,33,98
"Kyle Kuzma","LAL",77,2401,141,331,92,49,79,7,6,13,36
"Goran Dragic","MIA",75,2378,359,845,232,127,155,50,27,52,75
"Dillon Brooks","MEM",82,2350,135,313,92,43,50,14,28,11,32
"Wilson Chandler","DEN",74,2346,159,401,76,83,47,20,9,33,50
"Kevin Durant","GSW",68,2325,366,863,235,131,166,32,37,27,104
"Eric Bledsoe","MIL",74,2322,370,840,270,100,183,47,40,36,64
"Jeff Teague","MIN",70,2311,492,1101,375,117,212,96,67,40,77
"Dario Saric","PHI",78,2310,202,476,130,72,91,23,16,10,62
"Courtney Lee","NYK",76,2310,180,413,127,53,68,31,28,9,44
"Spencer Dinwiddie","BKN",80,2306,524,1275,297,227,209,70,18,68,159
"Gary Harris","DEN",67,2304,194,469,113,81,77,25,11,14,67
"Draymond Green","GSW",70,2287,508,1165,359,149,203,55,101,33,116
"Yogi Ferrell","DAL",82,2281,201,492,111,90,58,26,27,25,65
"PJ Tucker","HOU",82,2281,77,190,41,36,36,2,3,11,25
"Al Horford","BOS",72,2277,339,824,193,146,117,30,46,43,103
"Trevor Ariza","HOU",67,2269,105,269,46,59,39,5,2,30,29
"Justin Holiday","CHI",72,2265,153,351,108,45,60,28,20,11,34
"Ricky Rubio","UTA",77,2254,410,978,252,158,190,36,26,72,86
"JR Smith","CLE",80,2244,141,345,78,63,61,6,11,28,35
"Kelly Oubre Jr.","WAS",81,2231,98,229,65,33,35,15,15,5,28
"Cory Joseph","IND",82,2210,260,610,170,90,84,35,51,23,67
"Allen Crabbe","BKN",75,2192,117,277,74,43,53,16,5,11,32
"Julius Randle","LAL",82,2190,210,519,111,99,76,17,18,22,77
"DeMarre Carroll","BKN",73,2180,147,362,79,68,50,20,9,18,50
"Bogdan Bogdanovic","SAC",78,2175,258,600,174,84,109,34,31,18,66
"Jimmy Butler","MIN",59,2164,288,650,214,74,118,47,49,22,52
"Eric Gordon","HOU",69,2154,154,384,78,76,64,7,7,38,38
"Derrick Favors","UTA",77,2153,102,254,52,50,36,6,10,16,34
"Jaylen Brown","BOS",70,2152,114,268,74,40,38,16,20,16,24
"T.J. Warren","PHX",65,2142,85,208,47,38,28,15,4,8,30
"Wesley Matthews","DAL",63,2131,172,429,87,85,57,9,21,16,69
"JJ Redick","PHI",70,2116,210,494,136,74,106,21,9,10,64
"Patty Mills","SAS",82,2107,229,533,154,75,69,41,44,24,51
"Denzel Valentine","CHI",77,2095,244,581,151,93,101,24,26,25,68
"Serge Ibaka","TOR",76,2093,62,153,33,29,21,5,7,11,18
"Jae Crowder","UTA",80,2090,99,243,54,45,40,7,7,11,34
"Jusuf Nurkic","POR",79,2088,143,338,91,52,64,10,17,14,38
"Dennis Schroder","ATL",67,2078,417,1004,247,170,153,50,44,55,115
"Marcin Gortat","WAS",82,2075,151,361,92,59,47,15,30,13,46
"Al-Farouq Aminu","POR",69,2072,84,197,55,29,35,5,15,5,24
"Dragan Bender","PHX",82,2069,130,299,91,39,47,23,21,9,30
"Terry Rozier","BOS",80,2068,232,565,131,101,71,26,34,25,76
"Austin Rivers","LAC",61,2057,242,587,139,103,97,28,14,26,77
"Tony Snell","MIL",75,2053,98,230,64,34,36,13,15,7,27
"Tyler Johnson","MIA",72,2052,165,410,85,80,59,11,15,24,56
"Dennis Smith Jr.","DAL",69,2049,358,891,183,175,104,27,52,52,123
"Willie Cauley-Stein","SAC",73,2044,172,386,130,42,78,25,27,11,31
"Ish Smith","DET",82,2043,360,909,171,189,116,28,27,49,140
"Wayne Ellington","MIA",77,2041,79,188,49,30,36,9,4,12,18
"Clint Capela","HOU",74,2034,68,174,30,38,25,1,4,19,19
"Evan Turner","POR",79,2034,173,412,107,66,66,18,23,11,55
"Jonathon Simmons","ORL",69,2029,171,430,83,88,45,19,19,17,71
"De'Aaron Fox","SAC",73,2026,320,755,205,115,111,53,41,33,82
"Buddy Hield","SAC",80,2024,155,359,106,49,61,24,21,13,36
"Lauri Markkanen","CHI",68,2020,79,196,41,38,22,14,5,10,28
"Darren Collison","IND",69,2018,368,847,257,111,118,50,89,23,88
"Marvin Williams","CHA",78,2006,96,221,67,29,38,12,17,4,25
"Nicolas Batum","CHA",64,1981,349,805,242,107,150,46,46,11,96
"Kyle Anderson","SAS",74,1978,202,481,125,77,81,22,22,15,62
"Brandon Ingram","LAL",59,1975,230,559,131,99,97,23,11,24,75
"Joe Harris","BKN",78,1975,128,311,73,55,51,19,3,15,40
"Blake Griffin","DET",58,1970,334,809,193,141,114,39,40,30,111
"John Henson","MIL",76,1970,114,261,81,33,45,11,25,11,22
"Markieff Morris","WAS",73,1968,142,330,96,46,51,26,19,12,34
"Jeremy Lamb","CHA",80,1967,186,442,116,70,75,28,13,13,57
"Josh Jackson","PHX",77,1959,119,282,75,44,64,8,3,24,20
"Marco Belinelli","PHI",80,1947,148,350,94,54,51,15,28,22,32
"Darius Miller","NOP",82,1944,111,261,72,39,46,15,11,11,28
"James Johnson","MIA",73,1943,280,706,134,146,101,19,14,37,109
"Kyrie Irving","BOS",60,1931,306,739,179,127,104,42,33,36,91
"Rondae Hollis-Jefferson","BKN",68,1921,167,440,61,106,42,10,9,23,83
"Joel Embiid","PHI",63,1912,199,471,126,73,71,16,39,18,55
"Aaron Gordon","ORL",58,1909,136,312,96,40,70,16,10,11,29
"Dirk Nowitzki","DAL",77,1900,120,283,77,43,48,19,10,15,28
"Stanley Johnson","DET",69,1894,112,277,59,53,48,6,5,15,38
"Jordan Clarkson","CLE",81,1887,221,519,144,77,108,19,17,14,63
"Tim Hardaway Jr.","NYK",57,1885,155,367,98,57,52,24,22,19,38
"Devin Booker","PHX",54,1865,253,594,165,88,133,21,11,29,59
"Caris LeVert","BKN",71,1864,299,716,181,118,131,37,13,32,86
"Michael Kidd-Gilchrist","CHA",74,1850,71,176,37,34,19,9,9,7,27
"Lance Stephenson","IND",82,1850,235,521,184,51,110,31,43,14,37
"Chris Paul","HOU",58,1847,457,1178,193,264,163,21,9,69,195
"Evan Fournier","ORL",57,1837,165,392,103,62,66,18,19,23,39
"Myles Turner","IND",65,1836,87,212,49,38,34,5,10,18,20
"Frank Kaminsky","CHA",79,1835,129,308,79,50,45,12,22,16,34
"Enes Kanter","NYK",71,1830,105,241,74,31,30,18,26,2,29
"Jeff Green","CLE",78,1828,99,242,55,44,40,3,12,7,37
"Rudy Gobert","UTA",56,1816,80,190,50,30,26,4,20,5,25
"George Hill","CLE",67,1812,186,446,112,74,57,29,26,19,55
"Pau Gasol","SAS",77,1812,238,526,188,50,117,30,41,6,44
"Domantas Sabonis","IND",74,1810,151,371,82,69,37,8,37,20,49
"Elfrid Payton","PHX",63,1809,393,933,246,147,159,47,40,31,116
"Danny Green","SAS",70,1791,110,247,83,27,34,22,27,14,13
"Kent Bazemore","ATL",65,1789,228,519,165,63,123,20,22,23,40
"John Collins","ATL",74,1785,98,238,56,42,33,3,20,9,33
"Lonzo Ball","LAL",52,1780,376,870,258,118,180,47,31,30,88
"Kelly Olynyk","MIA",76,1779,207,519,102,105,72,11,19,33,72
"Doug McDermott","DAL",81,1768,79,189,48,31,22,14,12,7,24
"D.J. Augustin","ORL",75,1760,287,666,195,92,107,51,37,27,65
"Anthony Tolliver","DET",79,1757,90,205,65,25,39,11,15,7,18
"Dejounte Murray","SAS",81,1743,231,540,153,78,70,44,39,26,52
"DeMarcus Cousins","NOP",48,1737,257,598,173,84,111,36,26,42,42
"Brook Lopez","LAL",74,1735,126,288,90,36,55,16,19,9,27
"Reggie Bullock","DET",62,1732,95,229,56,39,35,14,7,12,27
"Ersan Ilyasova","PHI",69,1730,90,212,58,32,28,10,20,13,19
"Jonas Valanciunas","TOR",77,1727,81,202,41,40,27,8,6,8,32
"Ryan Anderson","HOU",66,1725,60,155,25,35,22,1,2,8,27
"T.J. McConnell","PHI",76,1706,303,727,182,121,130,22,30,29,92
"Frank Ntilikina","NYK",78,1706,250,583,167,83,100,37,30,13,70
"Rajon Rondo","NOP",65,1705,533,1209,390,143,248,88,54,35,108
"Robin Lopez","CHI",64,1690,124,300,72,52,37,12,23,7,45
"Jerian Grant","CHI",74,1686,342,824,202,140,106,50,46,34,106
"Nikola Vucevic","ORL",57,1683,191,456,117,74,83,16,18,15,59
"Justise Winslow","MIA",68,1680,148,351,93,55,66,15,12,18,37
"Pascal Siakam","TOR",81,1679,159,387,90,69,75,11,4,20,49
"Dwight Powell","DAL",79,1672,91,225,48,43,31,8,9,4,39
"Jarell Martin","MEM",73,1661,73,173,46,27,26,7,13,7,20
"Tyler Ulis","PHX",71,1658,311,737,196,115,157,20,19,28,87
"Mario Hezonja","ORL",75,1657,106,241,77,29,57,14,6,6,23
"Michael Beasley","NYK",74,1653,123,285,84,39,52,8,24,16,23
"Jamal Crawford","MIN",80,1653,185,408,147,38,102,22,23,6,32
"Kevin Love","CLE",59,1651,103,242,67,36,56,6,5,12,24
"Jerami Grant","OKC",81,1647,57,153,18,39,13,2,3,13,26
"David Nwaba","CHI",70,1646,104,246,66,38,46,10,10,6,32
"Tomas Satoransky","WAS",73,1643,286,660,198,88,86,60,52,21,67
"Bobby Portis","CHI",73,1642,123,304,65,58,37,15,13,10,48
"Stephen Curry","GSW",51,1631,310,713,217,93,152,31,34,21,72
"Andre Iguodala","GSW",64,1622,210,485,145,65,81,28,36,11,54
"Troy Daniels","PHX",79,1622,48,111,33,15,19,11,3,4,11
"Rodney Hood","CLE",60,1615,95,235,50,45,36,11,3,23,22
"Garrett Temple","SAC",65,1615,124,281,91,33,59,21,11,14,19
"Marcus Smart","BOS",54,1614,259,611,166,93,112,20,34,30,63
"Tyreke Evans","MEM",52,1607,269,630,177,92,124,25,28,23,69
"James Ennis III","DET",72,1604,71,162,51,20,35,11,5,7,13
"J.J. Barea","DAL",69,1603,434,995,307,127,194,41,72,26,101
"Kyle Korver","CLE",73,1574,88,196,68,20,54,8,6,7,13
"Luc Mbah a Moute","HOU",61,1564,55,139,26,29,20,5,1,14,15
"Dante Cunningham","BKN",73,1562,48,124,20,28,17,3,0,6,22
"Kristaps Porzingis","NYK",48,1553,57,140,31,26,14,7,10,6,20
"Jarrett Jack","NYK",62,1548,348,794,250,98,142,59,49,34,64
"Dewayne Dedmon","ATL",62,1542,90,223,47,43,24,5,18,9,34
"JaMychal Green","MEM",55,1542,79,180,57,22,36,10,11,4,18
"Dwyane Wade","MIA",67,1536,228,540,144,84,110,11,23,24,60
"Shabazz Napier","POR",74,1535,150,366,84,66,56,12,16,15,51
"Marquese Chriss","PHX",72,1527,83,193,56,27,22,14,20,6,21
"Kris Dunn","CHI",52,1525,310,740,190,120,106,40,44,27,93
"Jakob Poeltl","TOR",82,1524,57,147,24,33,15,5,4,11,22
"Fred VanVleet","TOR",76,1520,243,573,156,87,115,31,10,37,50
"Bryn Forbes","SAS",80,1517,80,191,49,31,25,12,12,11,20
"Zach Randolph","SAC",59,1508,127,291,90,37,50,22,18,9,28
"Justin Jackson","SAC",68,1506,74,182,40,34,23,11,6,14,20
"Bismack Biyombo","ORL",82,1495,66,148,50,16,23,8,19,3,13
"Nikola Mirotic","NOP",55,1494,80,181,59,21,35,9,15,4,17
"Pat Connaughton","POR",82,1488,91,225,48,43,22,16,10,10,33
"Wesley Johnson","LAC",74,1486,61,147,36,25,31,3,2,6,19
"Aron Baynes","BOS",81,1485,93,226,53,40,27,11,15,8,32
"OG Anunoby","TOR",74,1482,55,135,30,25,17,9,4,9,16
"Ed Davis","POR",78,1471,40,104,16,24,8,3,5,8,16
"Tyus Jones","MIN",82,1467,232,545,151,81,82,35,34,26,55
"Luke Kennard","DET",73,1463,124,304,68,56,45,15,8,18,38
"Josh Hart","LAL",63,1460,80,196,44,36,32,10,2,7,29
"Ian Clark","NOP",74,1454,110,255,75,35,55,9,11,6,29
"Marcus Morris","BOS",54,1442,72,174,42,30,27,9,6,11,19
"Jarrett Allen","BKN",72,1441,49,122,25,24,16,6,3,6,18
"Mason Plumlee","DEN",74,1440,142,336,90,52,69,14,7,16,36
"Malcolm Brogdon","MIL",48,1436,152,348,108,44,61,21,26,11,33
"Avery Bradley","LAC",46,1433,94,226,56,38,38,13,5,9,29
"Delon Wright","TOR",69,1433,200,497,103,97,76,19,8,35,62
"Mario Chalmers","MEM",66,1421,197,454,137,60,102,15,20,8,52
"Larry Nance Jr.","CLE",66,1421,82,196,50,32,33,8,9,7,25
"John Wall","WAS",41,1410,393,930,249,144,149,49,51,32,112
"Mike Scott","WAS",76,1406,80,192,48,32,30,10,8,8,24
"Alex Len","PHX",69,1395,82,196,50,32,25,8,17,10,22
"Nick Young","GSW",80,1393,36,87,21,15,9,8,4,4,11
"Kosta Koufos","SAC",71,1391,87,209,52,35,13,10,29,6,29
"Trey Lyles","DEN",73,1391,91,221,52,39,37,10,5,4,35
"Kyle O'Quinn","NYK",77,1387,158,340,134,24,95,16,23,5,19
"Nemanja Bjelica","MIN",67,1371,86,195,63,23,35,16,12,10,13
"Bam Adebayo","MIA",69,1368,101,260,43,58,19,5,19,14,44
"Shelvin Mack","ORL",69,1365,272,648,168,104,101,37,30,17,87
"Raymond Felton","OKC",82,1365,203,493,116,87,84,14,18,28,59
"Hassan Whiteside","MIA",54,1364,54,130,32,22,14,11,7,2,20
"Quincy Acy","BKN",70,1359,57,145,26,31,16,4,6,6,25
"Lance Thomas","NYK",73,1353,44,103,29,15,12,8,9,5,10
"Devin Harris","DEN",71,1340,152,357,99,53,63,17,19,12,41
"CJ Miles","TOR",70,1336,55,121,44,11,36,2,6,5,6
"Gorgui Dieng","MIN",79,1333,71,175,38,33,22,8,8,7,26
"Andrew Harrison","MEM",56,1326,177,415,116,61,57,18,41,14,47
"Manu Ginobili","SAS",65,1299,163,373,116,47,78,23,15,14,33
"Montrezl Harrell","LAC",76,1293,74,170,52,22,30,11,11,6,16
"Patrick Patterson","OKC",82,1270,57,151,20,37,15,1,4,7,30
"Maurice Harkless","POR",59,1264,53,131,28,25,16,6,6,7,18
"Emmanuel Mudiay","NYK",64,1244,206,485,133,73,81,27,25,23,50
"Skal Labissiere","SAC",60,1240,72,177,39,33,16,5,18,8,25
"Thon Maker","MIL",74,1238,46,104,34,12,28,0,6,4,8
"D'Angelo Russell","BKN",48,1234,249,595,152,97,122,19,11,19,78
"Rudy Gay","SAS",57,1231,73,174,45,28,32,9,4,8,20
"Corey Brewer","OKC",72,1208,65,151,44,21,33,4,7,3,18
"Maxi Kleber","DAL",72,1206,51,133,20,31,8,4,8,5,26
"Joe Johnson","HOU",55,1205,83,210,39,44,32,2,5,20,24
"Reggie Jackson","DET",45,1201,238,582,132,106,88,22,22,32,74
"Amir Johnson","PHI",74,1170,118,269,85,33,44,9,32,2,31
"Isaiah Taylor","ATL",67,1167,206,522,96,110,58,18,20,28,82
"Trevor Booker","IND",68,1158,82,210,36,46,18,8,10,9,37
"Sindarius Thornwell","LAC",73,1156,68,149,55,13,43,4,8,2,11
"Tyson Chandler","PHX",46,1151,53,114,45,8,17,12,16,1,7
"Semi Ojeleye","BOS",73,1150,20,47,13,7,7,1,5,0,7
"Royce O'Neale","UTA",69,1149,95,228,57,38,38,9,10,19,19
"Ian Mahinmi","WAS",77,1145,53,120,39,14,21,7,11,2,12
"Paul Millsap","DEN",38,1144,105,260,55,50,36,11,8,11,39
"Milos Teodosic","LAC",45,1134,209,479,148,61,117,21,10,16,45
"Alex Abrines","OKC",75,1134,28,66,18,10,11,5,2,3,7
"Jonas Jerebko","UTA",74,1134,42,104,22,20,12,6,4,2,18
"Shaun Livingston","GSW",71,1129,140,323,97,43,47,21,29,8,35
"Jodie Meeks","WAS",77,1119,70,158,52,18,22,16,14,4,14
"Tyler Zeller","MIL",66,1113,47,118,23,24,14,6,3,5,19
"Ben McLemore","MEM",56,1091,51,119,34,17,15,10,9,3,14
"Davis Bertans","SAS",77,1086,74,176,46,28,27,10,9,12,16
"Tristan Thompson","CLE",53,1072,33,77,22,11,9,6,7,3,8
"Tony Parker","SAS",55,1071,195,463,122,73,56,25,41,26,47
"Norman Powell","TOR",70,1061,89,218,49,40,33,7,9,14,26
"Mike Muscala","ATL",53,1060,51,130,23,28,14,4,5,7,21
"Alec Burks","UTA",64,1059,67,160,41,26,28,4,9,11,15
"Treveon Graham","CHA",63,1049,59,139,38,21,20,11,7,8,13
"Zach Collins","POR",66,1046,52,125,31,21,15,10,6,6,15
"Greg Monroe","BOS",51,1041,114,266,76,38,55,8,13,8,30
"Andre Roberson","OKC",39,1037,46,107,31,15,19,6,6,5,10
"Vince Carter","SAC",58,1026,69,162,45,24,29,9,7,5,19
"Wes Iwundu","ORL",62,1020,57,138,33,24,23,4,6,2,22
"Malcolm Delaney","ATL",54,1014,163,394,95,68,49,23,23,33,35
"Jameer Nelson","DET",50,1013,179,433,104,75,66,19,19,21,54
"David West","GSW",73,999,138,307,107,31,64,24,19,10,21
"Frank Mason","SAC",52,984,147,346,95,52,47,22,26,21,31
"Josh Huestis","OKC",69,981,20,52,8,12,5,1,2,3,9
"Cristiano Felicio","CHI",55,977,55,134,31,24,19,6,6,5,19
"Tyler Dorsey","ATL",56,974,79,190,47,32,18,17,12,10,22
"Zaza Pachulia","GSW",69,972,109,264,63,46,34,10,19,7,39
"Patrick McCaw","GSW",57,961,81,194,49,32,23,11,15,7,25
"Deyonta Davis","MEM",62,943,40,100,20,20,10,2,8,2,18
"Daniel Theis","BOS",63,936,56,141,27,29,15,7,5,5,24
"Gerald Green","HOU",41,929,25,62,13,12,11,2,0,4,8
"Jerryd Bayless","PHI",39,925,54,128,34,20,15,9,10,4,16
"Dion Waiters","MIA",30,918,113,284,55,58,40,6,9,19,39
"Miles Plumlee","ATL",55,918,45,105,30,15,10,6,14,4,11
"Jose Calderon","CLE",57,914,117,278,73,44,55,12,6,13,31
"Kevon Looney","GSW",66,910,42,100,26,16,15,4,7,3,13
"Sam Dekker","LAC",73,883,38,84,30,8,23,5,2,3,5
"Noah Vonleh","CHI",54,876,34,82,20,14,11,4,5,0,14
"Langston Galloway","DET",58,863,58,144,30,28,19,6,5,5,23
"Isaiah Thomas","LAL",32,862,153,360,99,54,77,13,9,17,37
"Malik Monk","CHA",63,853,91,201,72,19,40,22,10,5,14
"Tyrone Wallace","LAC",30,851,71,159,54,17,41,10,3,6,11
"Tim Frazier","WAS",59,838,194,457,125,69,55,29,41,14,55
"Michael Carter-Williams","CHA",52,835,116,276,72,44,39,16,17,10,34
"Paul Zipser","CHI",54,824,46,115,23,23,13,5,5,12,11
"Jason Terry","MIL",51,814,59,136,41,18,26,9,6,7,11
"Ekpe Udoh","UTA",63,810,53,133,26,27,15,4,7,9,18
"Jordan Bell","GSW",57,809,102,230,76,26,40,15,21,2,24
"Timothe Luwawu-Cabarrot","PHI",52,807,54,122,40,14,29,7,4,3,11
"Thabo Sefolosha","UTA",38,806,33,79,20,13,18,1,1,6,7
"Eric Moreland","DET",67,805,78,186,48,30,21,11,16,4,26
"Trey Burke","NYK",36,785,170,394,116,54,77,23,16,17,37
"Jawun Evans","LAC",48,778,100,224,76,24,56,11,9,8,16
"Sterling Brown","MIL",54,776,25,64,11,14,8,0,3,5,9
"Shane Larkin","BOS",54,775,98,233,61,37,29,11,21,6,31
"Terrance Ferguson","OKC",61,763,19,46,11,8,7,2,2,3,5
"Nene","HOU",52,758,45,118,17,28,16,1,0,8,20
"Richaun Holmes","PHI",48,746,61,143,40,21,18,4,18,1,20
"Jabari Parker","MIL",31,743,59,133,44,15,30,6,8,4,11
"Omri Casspi","GSW",53,742,51,115,38,13,19,8,11,1,12
"Quinn Cook","GSW",33,740,89,207,60,29,28,15,17,5,24
"Salah Mejri","DAL",61,729,35,89,16,19,5,2,9,3,16
"DeAndre Liggins","NOP",57,723,48,114,30,18,20,2,8,5,13
"Luke Babbitt","MIA",50,715,31,80,13,18,7,3,3,7,11
"Dwayne Bacon","CHA",53,713,38,99,15,23,12,2,1,4,19
"Matthew Dellavedova","MIL",38,712,145,331,104,41,77,16,11,13,28
"C.J. Williams","LAC",38,706,43,97,32,11,20,6,6,3,8
"Channing Frye","LAL",53,695,38,96,18,20,16,1,1,5,15
"Chandler Parsons","MEM",36,691,69,160,47,22,33,7,7,3,19
"Wayne Selden","MEM",35,691,66,147,51,15,33,6,12,4,11
"Mike James","NOP",36,686,126,303,75,51,52,12,11,14,37
"Jared Dudley","PHX",48,686,78,182,52,26,37,7,8,7,19
"Tyler Ennis","LAL",54,683,105,249,66,39,39,12,15,10,29
"Arron Afflalo","ORL",53,682,30,76,14,16,9,2,3,5,11
"Marreese Speights","ORL",52,675,40,93,27,13,20,3,4,4,9
"Cedi Osman","CLE",61,672,41,100,23,18,17,4,2,6,12
"Danilo Gallinari","LAC",21,671,41,94,29,12,21,4,4,5,7
"Zach LaVine","CHI",24,656,72,169,47,25,28,16,3,8,17
"Kobi Simmons","MEM",32,643,68,161,43,25,25,5,13,7,18
"Sean Kilpatrick","CHI",52,640,46,116,22,24,13,5,4,10,14
"Torrey Craig","DEN",39,629,25,59,16,9,10,4,2,1,8
"Cody Zeller","CHA",33,627,31,75,18,13,8,5,5,2,11
"JaVale McGee","GSW",65,616,33,77,22,11,9,4,9,2,9
"Terrence Ross","ORL",24,600,38,89,25,13,15,7,3,3,10
"Malik Beasley","DEN",62,583,31,79,14,17,13,1,0,4,13
"Cameron Payne","CHI",25,582,113,278,61,52,47,6,8,9,43
"Cheick Diallo","NOP",52,581,19,45,12,7,7,4,1,1,6
"Khem Birch","ORL",42,578,34,82,20,14,8,7,5,0,14
"Brandon Paul","SAS",64,576,37,88,23,14,13,4,6,6,8
"Alex Caruso","LAL",37,562,75,175,50,25,40,7,3,4,21
"Joe Young","IND",53,558,39,91,26,13,16,8,2,6,7
"Tarik Black","HOU",51,536,13,32,7,6,4,2,1,1,5
"Jonathan Isaac","ORL",27,535,18,44,10,8,3,5,2,2,6
"Joffrey Lauvergne","SAS",55,534,41,93,30,11,18,7,5,5,6
"Nik Stauskas","BKN",41,523,39,95,22,17,13,5,4,7,10
"Abdel Nader","BOS",48,522,26,63,15,11,8,3,4,4,7
"Justin Anderson","PHI",38,519,25,58,17,8,13,1,3,1,7
"Tyler Cavanaugh","ATL",39,518,27,69,12,15,4,1,7,3,12
"Ivan Rabb","MEM",36,516,32,71,25,7,16,1,8,1,6
"Raul Neto","UTA",41,498,75,185,40,35,26,6,8,13,22
"Willy Hernangomez","CHA",48,494,33,81,18,15,7,5,6,4,11
"Al Jefferson","IND",36,484,30,68,22,8,9,5,8,4,4
"Kyle Collinsworth","DAL",32,480,56,132,36,20,23,6,7,6,14
"Damyean Dotson","NYK",44,474,31,72,21,10,16,4,1,1,9
"Nerlens Noel","DAL",29,472,20,46,14,6,7,4,3,1,5
"Kenneth Faried","DEN",32,461,18,42,12,6,7,3,2,1,5
"TJ Leaf","IND",53,459,9,22,5,4,1,2,2,1,3
"DeAndre' Bembry","ATL",26,455,49,115,32,17,20,7,5,8,9
"Dorian Finney-Smith","DAL",21,448,26,66,12,14,6,4,2,5,9
"Willie Reed","DET",42,428,10,22,8,2,4,1,3,2,0
"Dwight Buycks","DET",29,427,59,144,33,26,16,12,5,9,17
"Isaiah Canaan","PHX",20,422,76,187,41,35,32,6,3,16,19
"Derrick Rose","MIN",25,419,37,87,24,13,14,5,5,5,8
"Shabazz Muhammad","MIL",43,418,14,34,8,6,4,2,2,0,6
"Lucas Nogueira","TOR",49,418,22,56,10,12,8,0,2,4,8
"Ivica Zubac","LAL",43,410,25,58,17,8,7,5,5,0,8
"Damion Lee","ATL",15,404,29,71,16,13,11,5,0,1,12
"Danuel House Jr.","PHX",23,403,25,61,14,11,11,1,2,1,10
"Ramon Sessions","WAS",28,392,77,181,50,27,23,20,7,6,21
"Ron Baker","NYK",29,385,47,104,37,10,27,7,3,2,8
"Shaquille Harrison","PHX",23,384,55,134,31,24,22,5,4,4,20
"Brandan Wright","HOU",28,381,13,31,8,5,3,2,3,1,4
"Johnny O'Bryant III","CHA",36,379,14,35,7,7,5,1,1,2,5
"Myke Henry","MEM",20,378,22,51,15,7,7,5,3,3,4
"Mike Conley","MEM",12,373,49,120,27,22,17,6,4,6,16
"Timofey Mozgov","BKN",31,359,11,27,6,5,2,4,0,2,3
"Emeka Okafor","NOP",26,353,8,22,2,6,0,1,1,0,6
"Jahlil Okafor","BKN",28,353,12,33,3,9,2,0,1,1,8
"JaKarr Sampson","SAC",22,344,9,22,5,4,1,3,1,0,4
"Boban Marjanovic","LAC",37,338,22,47,19,3,13,3,3,1,2
"Glenn Robinson III","IND",23,338,17,37,14,3,8,4,2,0,3
"Patrick Beverley","LAC",11,334,32,73,23,9,12,5,6,3,6
"Henry Ellenson","DET",38,329,20,54,6,14,4,1,1,3,11
"Luke Kornet","NYK",20,326,26,60,18,8,11,2,5,0,8
"Malachi Richardson","TOR",26,323,13,30,9,4,7,0,2,2,2
"Antonio Blakeney","CHI",19,314,20,49,11,9,8,0,3,2,7
"Troy Williams","NYK",21,307,16,37,11,5,5,0,6,1,4
"Ryan Arcidiacono","CHI",24,304,35,85,20,15,17,1,2,2,13
"Rodney McGruder","MIA",18,299,17,42,9,8,6,1,2,2,6
"Rodney Purvis","ORL",16,290,17,40,11,6,9,2,0,2,4
"Jason Smith","WAS",33,285,14,35,7,7,5,0,2,1,6
"Jordan Mickey","MIA",23,284,9,22,5,4,1,1,3,0,4
"Jamel Artis","ORL",15,279,18,47,7,11,5,2,0,3,8
"Juancho Hernangomez","DEN",25,277,12,31,5,7,4,1,0,4,3
"Iman Shumpert","CLE",14,276,17,42,9,8,5,1,3,0,8
"Jamil Wilson","LAC",15,274,10,24,6,4,5,1,0,1,3
"Tony Allen","NOP",22,272,9,20,7,2,6,1,0,2,0
"Meyers Leonard","POR",33,254,17,45,6,11,4,0,2,3,8
"Markelle Fultz","PHI",14,253,53,129,30,23,20,6,4,7,16
"Derrick Jones Jr.","MIA",20,245,9,22,5,4,3,0,2,3,1
"Davon Reed","PHX",21,242,13,31,8,5,6,1,1,0,5
"Isaiah Hicks","NYK",18,239,16,42,6,10,1,3,2,2,8
"Briante Weber","MEM",18,237,22,56,10,12,7,1,2,3,9
"Guerschon Yabusele","BOS",33,235,16,41,7,9,5,2,0,3,6
"Dante Exum","UTA",14,235,43,100,29,14,18,6,5,2,12
"Aaron Harrison","DAL",9,233,11,29,4,7,2,2,0,1,6
"Travis Wear","LAL",17,228,7,19,2,5,1,1,0,0,5
"Alec Peters","PHX",20,225,12,29,7,5,5,2,0,1,4
"Marcus Georges-Hunt","MIN",42,224,7,18,3,4,2,0,1,2,2
"Gary Payton II","LAL",23,221,21,51,12,9,5,4,3,2,7
"Andrew Bogut","LAL",23,216,15,35,10,5,7,2,1,0,5
"Josh Magette","ATL",18,216,57,136,35,22,25,5,5,5,17
"Ante Zizic","CLE",32,214,5,12,3,2,1,0,2,1,1
"Rashad Vaughn","ORL",28,212,13,30,9,4,5,3,1,1,3
"Kawhi Leonard","SAS",9,210,21,49,14,7,5,5,4,4,3
"Andrew White III","ATL",15,209,6,16,2,4,1,0,1,2,2
"Brandon Jennings","MIL",14,205,44,93,39,5,24,12,3,2,3
"Quincy Pondexter","CHI",23,196,9,23,4,5,3,0,1,3,2
"MarShon Brooks","MEM",7,193,25,59,16,9,11,2,3,6,3
"Aaron Brooks","MIN",32,189,20,48,12,8,4,4,4,1,7
"Caleb Swanigan","POR",27,189,14,35,7,7,7,0,0,1,6
"Solomon Hill","NOP",12,187,22,53,13,9,7,6,0,4,5
"Omer Asik","CHI",18,182,3,6,3,0,0,1,2,0,0
"Jalen Jones","DAL",15,181,4,10,2,2,2,0,0,1,1
"Isaiah Whitehead","BKN",16,180,20,45,15,5,13,2,0,1,4
"Johnathan Motley","DAL",11,176,7,16,5,2,3,2,0,0,2
"Julyan Stone","CHA",23,175,26,62,16,10,11,2,3,2,8
"John Holland","CLE",24,174,5,10,5,0,4,1,0,0,0
"Richard Jefferson","DEN",20,163,15,39,6,9,6,0,0,3,6
"Dakari Johnson","OKC",31,161,8,21,3,5,2,0,1,2,3
"Jake Layman","POR",34,160,11,28,5,6,1,1,3,2,4
"Mirza Teletovic","MIL",10,159,10,25,5,5,4,1,0,3,2
"Damien Wilkins","IND",19,152,9,22,5,4,3,1,1,3,1
"Derrick Walton Jr.","MIA",16,147,16,39,9,7,4,3,2,1,6
"Darrell Arthur","DEN",19,141,9,23,4,5,4,0,0,0,5
"Kay Felder","DET",16,140,20,47,13,7,9,3,1,3,4
"Derrick White","SAS",17,139,9,20,7,2,6,1,0,0,2
"Lorenzo Brown","TOR",14,139,13,35,4,9,3,1,0,2,7
"Jon Leuer","DET",8,136,5,10,5,0,2,2,1,0,0
"Malcolm Miller","TOR",15,126,3,7,2,1,1,1,0,0,1
"Milton Doyle","BKN",10,125,10,24,6,4,6,0,0,0,4
"Zhou Qi","HOU",18,124,2,5,1,1,1,0,0,1,0
"Antonius Cleveland","ATL",17,122,2,5,1,1,1,0,0,0,1
"Nigel Hayes","SAC",9,122,6,17,1,5,0,0,1,0,5
"Georgios Papagiannis","POR",17,122,9,23,4,5,1,1,2,0,5
"James Webb III","BKN",10,120,4,11,1,3,1,0,0,2,1
"Xavier Rathan-Mayes","MEM",5,118,18,43,11,7,5,4,2,2,5
"Bobby Brown","HOU",20,115,11,30,3,8,3,0,0,3,5
"Jabari Bird","BOS",13,115,8,19,5,3,3,1,1,2,1
"Kadeem Allen","BOS",18,107,12,27,9,3,6,1,2,2,1
"Bruno Caboclo","SAC",12,106,4,9,3,1,2,1,0,0,1
"Alex Poythress","IND",25,104,2,5,1,1,0,1,0,0,1
"Jaylen Morris","ATL",6,98,7,16,5,2,3,1,1,0,2
"Brice Johnson","MEM",18,98,2,5,1,1,1,0,0,0,1
"Darrun Hilliard","SAS",14,95,11,27,6,5,4,2,0,1,4
"Chris McCullough","WAS",19,90,4,9,3,1,2,0,1,0,1
"Damian Jones","GSW",15,89,2,4,2,0,2,0,0,0,0
"Jack Cooley","SAC",7,87,6,13,5,1,2,2,1,0,1
"Josh Gray","PHX",5,86,12,30,6,6,4,0,2,1,5
"Wade Baldwin IV","POR",7,80,5,11,4,1,2,1,1,0,1
"Demetrius Jackson","PHI",15,80,9,21,6,3,3,2,1,0,3
"Furkan Korkmaz","PHI",14,80,4,8,4,0,4,0,0,0,0
"Okaro White","MIA",6,80,2,5,1,1,0,0,1,0,1
"Omari Johnson","MEM",4,75,7,17,4,3,1,0,3,1,2
"Nick Collison","OKC",15,75,4,9,3,1,1,0,2,0,1
"Marquis Teague","MEM",3,74,13,31,8,5,1,4,3,0,5
"Thomas Bryant","LAL",15,72,6,14,4,2,3,1,0,1,1
"Udonis Haslem","MIA",14,72,5,12,3,2,1,1,1,0,2
"D.J. Wilson","MIL",22,71,3,6,3,0,2,0,1,0,0
"Alan Williams","PHX",5,70,8,23,1,7,1,0,0,3,4
"Larry Drew II","NOP",10,70,10,23,7,3,4,2,1,2,1
"London Perrantes","CLE",14,66,5,13,2,3,2,0,0,2,1
"Andre Ingram","LAL",2,64,7,18,3,4,1,2,0,1,3
"Gian Clavell","DAL",7,64,3,9,0,3,0,0,0,0,3
"James Young","PHI",6,61,2,5,1,1,0,0,1,0,1
"Kyle Singler","OKC",12,59,2,6,0,2,0,0,0,1,1
"Alfonzo McKinnie","TOR",14,53,1,3,0,1,0,0,0,0,1
"Jordan Crawford","NOP",5,53,13,33,6,7,4,0,2,2,5
"Marshall Plumlee","MIL",8,52,2,5,1,1,0,0,1,1,0
"Cole Aldrich","MIN",21,49,3,7,2,1,1,0,1,1,0
"RJ Hunter","HOU",5,45,3,7,2,1,2,0,0,1,0
"Vander Blue","LAL",5,45,3,8,1,2,0,1,0,1,1
"Adreian Payne","ORL",5,43,0,0,0,0,0,0,0,0,0
"Joakim Noah","NYK",7,40,4,10,2,2,1,0,1,0,2
"Jonathan Gibson","BOS",4,40,4,9,3,1,2,0,1,1,0
"Jeff Withey","DAL",9,39,0,0,0,0,0,0,0,0,0
"Charles Cooke","NOP",13,38,1,3,0,1,0,0,0,0,1
"Joel Bolomboy","MIL",6,38,0,0,0,0,0,0,0,0,0
"Walter Lemon Jr.","NOP",5,35,5,12,3,2,2,1,0,1,1
"Aaron Jackson","HOU",1,34,1,3,0,1,0,0,0,1,0
"Jacob Wiley","BKN",5,33,2,4,2,0,1,0,1,0,0
"Matt Costello","SAS",4,32,2,6,0,2,0,0,0,0,2
"Georges Niang","UTA",9,32,3,6,3,0,2,1,0,0,0
"Markel Brown","HOU",4,31,2,4,2,0,2,0,0,0,0
"Ike Anigbogu","IND",11,30,0,0,0,0,0,0,0,0,0
"Tony Bradley","UTA",9,29,1,2,1,0,1,0,0,0,0