"Name","TeamAbbreviation","GamesPlayed","Minutes","Assists","AssistPoints","TwoPtAssists","ThreePtAssists","AtRimAssists","ShortMidRangeAssists","LongMidRangeAssists","Corner3Assists","Arc3Assists"
"Kevin Durant","OKC",82,3239,231,513,180,51,102,24,54,19,32
"Andre Iguodala","PHI",82,3193,472,1031,385,87,216,72,97,32,55
"Rudy Gay","MEM",80,3175,153,336,123,30,69,27,27,14,16
"Stephen Jackson","CHA",81,3129,300,647,253,47,200,23,30,17,30
"Gerald Wallace","CHA",76,3120,161,363,120,41,81,16,23,6,35
"O.J. Mayo","MEM",82,3114,242,531,195,47,132,26,37,19,28
"Zach Randolph","MEM",81,3051,149,341,106,43,78,19,9,9,34
"Jeff Green","OKC",82,3043,134,306,96,38,36,20,40,14,24
"Dirk Nowitzki","DAL",81,3039,218,521,133,85,70,27,36,19,66
"Brook Lopez","NJN",82,3027,187,409,152,35,95,15,42,8,27
"David Lee","NYK",81,3019,295,738,147,148,87,14,46,27,121
"LeBron James","CLE",76,2966,651,1496,457,194,315,50,92,104,90
"Rajon Rondo","BOS",81,2963,794,1773,609,185,362,70,177,49,136
"David West","NOH",81,2949,239,562,155,84,94,28,33,20,64
"LaMarcus Aldridge","POR",78,2922,160,370,110,50,63,9,38,10,40
"Aaron Brooks","HOU",82,2919,434,985,317,117,187,44,86,52,65
"Boris Diaw","CHA",82,2906,325,738,237,88,125,28,84,34,54
"Stephen Curry","GSW",80,2896,472,1054,362,110,215,34,113,34,76
"Joe Johnson","ATL",76,2886,369,847,260,109,111,38,111,44,65
"Jason Kidd","DAL",80,2881,724,1567,605,119,267,97,241,33,86
"Derrick Rose","CHI",78,2871,469,1043,364,105,153,31,180,48,57
"Josh Smith","ATL",81,2871,342,790,236,106,156,27,53,54,52
"Al Horford","ATL",81,2845,189,434,133,56,84,5,44,16,40
"Dwight Howard","ORL",82,2843,144,362,70,74,53,5,12,14,60
"Amar'e Stoudemire","PHX",82,2838,82,201,45,37,34,2,9,14,23
"Kobe Bryant","LAL",73,2836,365,831,264,101,166,39,59,40,61
"John Salmons","MIL",81,2825,223,510,159,64,68,30,61,21,43
"Ray Allen","BOS",80,2819,210,452,178,32,120,24,34,11,21
"Russell Westbrook","OKC",82,2813,652,1442,514,138,262,65,187,31,107
"Deron Williams","UTA",76,2802,798,1750,644,154,374,83,187,48,106
"Andrea Bargnani","TOR",80,2799,93,214,65,28,39,8,18,13,15
"Dwyane Wade","MIA",77,2793,501,1148,355,146,175,63,117,62,84
"Caron Butler","DAL",74,2784,156,357,111,45,52,20,39,15,30
"Nene","DEN",82,2755,203,467,142,61,76,20,46,16,45
"Danilo Gallinari","NYK",81,2747,135,306,99,36,44,12,43,15,21
"Rasual Butler","LAC",82,2702,116,250,98,18,45,25,28,8,10
"Tyreke Evans","SAC",72,2677,414,960,282,132,123,40,119,30,102
"Carlos Boozer","UTA",78,2673,247,535,206,41,123,14,69,4,37
"Luis Scola","HOU",82,2672,169,415,92,77,61,11,20,18,59
"Brandon Jennings","MIL",82,2671,470,1075,335,135,191,51,93,45,90
"Steve Nash","PHX",81,2660,892,2001,675,217,403,127,145,65,152
"Luol Deng","CHI",70,2651,143,316,113,30,61,14,38,12,18
"Monta Ellis","GSW",64,2647,340,777,243,97,154,25,64,36,61
"Raymond Felton","CHA",80,2643,446,1010,328,118,230,29,69,48,70
"Carmelo Anthony","DEN",69,2634,222,504,162,60,119,16,27,22,38
"Trevor Ariza","HOU",72,2629,276,614,214,62,116,33,65,28,34
"Chris Kaman","LAC",76,2609,120,274,86,34,62,10,14,5,29
"Metta World Peace","LAL",77,2605,234,515,187,47,102,41,44,20,27
"Lamar Odom","LAL",82,2585,267,594,207,60,110,44,53,16,44
"Mike Conley","MEM",80,2569,425,925,350,75,198,61,91,17,58
"Jason Terry","DAL",77,2540,292,672,204,88,100,29,75,22,66
"Chris Bosh","TOR",70,2526,166,388,110,56,58,27,25,10,46
"Baron Davis","LAC",75,2523,598,1306,488,110,274,86,128,32,78
"Richard Jefferson","SAS",81,2520,158,356,118,40,58,22,38,14,26
"Andre Miller","POR",82,2500,445,1003,332,113,180,36,116,46,67
"Rodney Stuckey","DET",73,2499,348,767,277,71,122,50,105,33,38
"Brandon Rush","IND",82,2491,112,269,67,45,24,7,36,5,40
"Chauncey Billups","DEN",73,2490,409,912,315,94,169,41,105,36,58
"Jason Richardson","PHX",79,2485,143,330,99,44,50,21,28,25,19
"Corey Brewer","MIN",82,2482,193,419,160,33,58,61,41,13,20
"Kirk Hinrich","CHI",74,2481,330,698,292,38,122,33,137,18,20
"Beno Udrih","SAC",79,2477,372,824,292,80,139,44,109,33,47
"Carl Landry","SAC",80,2469,66,161,37,29,12,8,17,1,28
"Marc Gasol","MEM",69,2469,165,378,117,48,68,22,27,16,32
"Marvin Williams","ATL",81,2468,93,209,70,23,30,15,25,8,15
"Al Jefferson","MIN",76,2463,137,306,105,32,45,13,47,3,29
"Jamal Crawford","ATL",79,2460,238,519,195,43,100,44,51,18,25
"Tim Duncan","SAS",78,2438,246,541,197,49,124,25,48,17,32
"Grant Hill","PHX",81,2430,193,446,133,60,80,20,33,16,44
"Brandon Roy","POR",65,2419,305,706,209,96,89,18,102,50,46
"Paul Pierce","BOS",71,2411,218,471,183,35,83,32,68,10,25
"Antawn Jamison","CLE",66,2406,84,193,59,25,40,4,15,10,15
"Pau Gasol","LAL",65,2403,218,500,154,64,84,27,43,14,50
"Shawn Marion","DAL",75,2385,107,251,70,37,29,5,36,7,30
"Courtney Lee","NJN",71,2375,121,268,95,26,40,16,39,9,17
"Emeka Okafor","NOH",82,2370,55,127,38,17,22,4,12,1,16
"Rashard Lewis","ORL",72,2369,107,257,64,43,44,12,8,12,31
"Mo Williams","CLE",69,2359,368,799,305,63,225,30,50,25,38
"Jason Thompson","SAC",75,2358,124,281,91,33,48,9,34,13,20
"Brendan Haywood","DAL",77,2355,43,96,33,10,8,3,22,2,8
"Thabo Sefolosha","OKC",82,2348,145,314,121,24,52,26,43,6,18
"Troy Murphy","IND",72,2344,150,354,96,54,49,15,32,6,48
"Jonny Flynn","MIN",81,2340,356,808,260,96,129,46,85,25,71
"Michael Beasley","MIA",78,2328,100,231,69,31,31,9,29,13,18
"Earl Watson","IND",79,2322,399,949,248,151,146,30,72,34,117
"Wilson Chandler","NYK",65,2320,138,334,80,58,46,6,28,17,41
"Marcus Camby","POR",74,2315,186,393,165,21,94,27,44,4,17
"Vince Carter","ORL",75,2311,236,585,123,113,77,26,20,60,53
"Elton Brand","PHI",76,2297,109,258,69,40,29,9,31,5,35
"Anthony Parker","CLE",81,2289,157,349,122,35,69,20,33,13,22
"Carlos Delfino","MIL",75,2279,202,455,151,51,75,20,56,17,34
"Danny Granger","IND",62,2278,171,407,106,65,54,20,32,20,45
"Paul Millsap","UTA",82,2277,131,287,106,25,56,12,38,8,17
"George Hill","SAS",78,2276,226,517,161,65,55,43,63,20,45
"Hedo Turkoglu","TOR",74,2272,304,696,216,88,101,35,80,35,53
"Andray Blatche","WAS",81,2256,170,386,124,46,87,12,25,15,31
"Jarrett Jack","TOR",82,2243,413,911,328,85,162,50,116,27,58
"Jonas Jerebko","DET",80,2233,58,125,49,9,23,10,16,3,6
"Andrew Bogut","MIL",69,2230,127,302,79,48,60,9,10,17,31
"Eric Gordon","LAC",62,2229,186,401,157,29,87,23,47,16,13
"Derek Fisher","LAL",82,2228,201,434,169,32,90,43,36,9,23
"Arron Afflalo","DEN",82,2221,138,297,117,21,62,12,43,2,19
"Devin Harris","NJN",64,2221,423,921,348,75,210,39,99,38,37
"Ryan Gomes","MIN",76,2210,124,279,93,31,44,22,27,9,22
"Taj Gibson","CHI",82,2204,70,157,53,17,18,9,26,5,12
"Al Harrington","NYK",72,2195,110,251,79,31,38,14,27,14,17
"Mike Bibby","ATL",80,2195,310,663,267,43,149,47,71,27,16
"Channing Frye","PHX",81,2190,113,279,60,53,28,10,22,25,28
"Udonis Haslem","MIA",78,2177,52,123,33,19,15,4,14,4,15
"Shane Battier","HOU",67,2168,164,372,120,44,69,18,33,15,29
"Anderson Varejao","CLE",76,2166,87,199,62,25,44,6,12,7,18
"Steve Blake","LAC",80,2159,380,862,278,102,148,45,85,34,68
"Kendrick Perkins","BOS",78,2154,80,180,60,20,36,8,16,4,16
"Manu Ginobili","SAS",75,2150,370,817,293,77,173,45,75,39,38
"Mehmet Okur","UTA",73,2149,119,259,98,21,46,12,40,11,10
"Thaddeus Young","PHI",67,2145,97,226,65,32,33,14,18,8,24
"Samuel Dalembert","PHI",82,2124,64,143,49,15,28,8,13,5,10
"Darren Collison","NOH",76,2109,432,971,325,107,171,45,109,27,80
"Matt Barnes","ORL",81,2097,134,323,79,55,53,15,11,24,31
"JR Smith","DEN",75,2082,183,403,146,37,96,15,35,12,25
"Quentin Richardson","MIA",76,2082,93,202,77,16,36,15,26,5,11
"Corey Maggette","GSW",70,2081,172,401,115,57,67,14,34,22,35
"Al Thornton","WAS",75,2079,90,209,61,29,26,16,19,9,20
"Chris Duhon","NYK",67,2072,378,878,256,122,150,19,87,30,92
"Kevin Garnett","BOS",69,2060,185,409,146,39,116,14,16,8,31
"Roy Hibbert","IND",81,2035,158,355,119,39,75,11,33,5,34
"Wesley Matthews","UTA",82,2025,124,273,99,25,54,12,33,7,18
"Anthony Morrow","GSW",69,2018,104,248,64,40,30,7,27,15,25
"Martell Webster","POR",82,2005,62,143,43,19,20,10,13,10,9
"Jermaine O'Neal","MIA",70,1992,92,211,65,27,34,10,21,8,19
"Jared Dudley","PHX",82,1991,115,261,84,31,47,11,26,14,17
"Kenyon Martin","DEN",58,1986,109,252,75,34,45,10,20,7,27
"Andrew Bynum","LAL",65,1977,68,157,47,21,22,7,18,1,20
"Ben Wallace","DET",69,1976,105,224,91,14,49,13,29,6,8
"Brad Miller","CHI",82,1950,154,328,134,20,63,16,55,10,10
"Peja Stojakovic","NOH",62,1947,92,202,74,18,35,18,21,5,13
"Omri Casspi","SAC",77,1931,95,206,79,16,46,13,20,1,15
"Joakim Noah","CHI",64,1925,132,286,110,22,52,14,44,11,11
"Lou Williams","PHI",64,1912,268,595,209,59,129,25,55,24,35
"Spencer Hawes","SAC",72,1904,158,347,127,31,77,16,34,13,18
"Ersan Ilyasova","MIL",81,1898,84,198,54,30,24,11,19,18,12
"Dahntay Jones","IND",76,1892,150,357,93,57,51,12,30,9,48
"Marcus Thornton","NOH",73,1872,114,247,95,19,46,16,33,6,13
"Luc Mbah a Moute","MIL",73,1866,81,192,51,30,21,11,19,9,21
"Jameer Nelson","ORL",65,1860,353,850,209,144,146,26,37,56,88
"Charlie Villanueva","DET",78,1847,53,116,43,10,25,6,12,4,6
"Jose Calderon","TOR",68,1817,404,899,313,91,167,51,95,15,76
"JJ Redick","ORL",82,1808,158,392,82,76,50,18,14,30,46
"Mario Chalmers","MIA",73,1807,246,544,194,52,88,18,88,22,30
"Mike Miller","WAS",54,1805,212,456,180,32,77,43,60,13,19
"Jared Jeffries","HOU",70,1793,101,241,62,39,38,8,16,4,35
"C.J. Watson","GSW",65,1788,180,423,117,63,68,9,40,22,41
"Rasheed Wallace","BOS",79,1780,80,178,62,18,34,10,18,3,15
"Chuck Hayes","HOU",82,1773,139,317,100,39,61,9,30,9,30
"Jrue Holiday","PHI",73,1767,280,614,226,54,120,39,67,19,35
"Terrence Williams","NJN",78,1763,223,514,155,68,78,20,57,27,41
"Luke Ridnour","MIL",82,1758,324,744,228,96,98,34,96,40,56
"Drew Gooden","LAC",70,1756,47,109,32,15,20,2,10,4,11
"Ronnie Brewer","MEM",58,1742,154,334,128,26,78,12,38,9,17
"Nenad Krstic","OKC",76,1741,52,120,36,16,19,7,10,2,14
"James Harden","OKC",76,1738,137,299,112,25,63,20,29,8,17
"Ramon Sessions","MIN",82,1732,258,582,192,66,106,30,56,13,53
"James Posey","NOH",77,1731,117,261,90,27,53,11,26,10,17
"Chris Douglas-Roberts","NJN",67,1730,93,214,65,28,27,11,27,13,15
"Ben Gordon","DET",62,1730,166,375,123,43,60,27,36,16,27
"Tony Parker","SAS",56,1728,317,741,210,107,109,27,74,52,55
"Kevin Love","MIN",60,1714,136,284,124,12,68,27,29,4,8
"Chris Paul","NOH",45,1712,480,1092,348,132,173,48,127,42,90
"Jason Williams","ORL",82,1703,298,719,175,123,121,17,37,41,82
"Shannon Brown","LAL",82,1700,108,255,69,39,30,19,20,12,27
"Chris Andersen","DEN",76,1695,33,74,25,8,15,4,6,0,8
"JJ Hickson","CLE",81,1691,40,95,25,15,15,3,7,5,10
"Mickael Pietrus","ORL",75,1687,49,122,25,24,14,9,2,9,15
"Andrei Kirilenko","UTA",58,1681,158,328,146,12,91,17,38,1,11
"Flip Murray","CHI",75,1673,135,304,101,34,76,8,17,13,21
"Randy Foye","WAS",70,1667,228,511,173,55,75,27,71,22,33
"Will Bynum","DET",63,1666,283,640,209,74,96,28,85,30,44
"Tayshaun Prince","DET",49,1664,161,361,122,39,35,25,62,13,26
"DeMar DeRozan","TOR",77,1664,53,119,40,13,15,6,19,4,9
"Yi Jianlian","NJN",52,1655,47,108,33,14,17,6,10,3,11
"Kyle Lowry","HOU",68,1651,305,713,202,103,133,26,43,32,71
"Kevin Martin","HOU",46,1633,111,265,68,43,32,13,23,10,33
"Juwan Howard","POR",73,1632,61,139,44,17,28,4,12,4,13
"Donte Greene","SAC",76,1630,71,156,57,14,35,8,14,8,6
"Antonio McDyess","SAS",77,1617,83,193,56,27,24,16,16,12,15
"Charlie Bell","MIL",71,1611,104,240,72,32,29,16,27,15,17
"Damien Wilkins","MIN",80,1585,135,302,103,32,43,27,33,10,22
"Carlos Arroyo","MIA",72,1585,225,510,165,60,62,19,84,18,42
"Keith Bogans","SAS",79,1559,95,212,73,22,42,13,18,12,10
"Hakim Warrick","CHI",76,1557,52,123,33,19,16,8,9,9,10
"Nick Collison","OKC",75,1557,38,86,28,10,17,5,6,2,8
"Willie Green","PHI",73,1553,152,359,97,55,36,15,46,18,37
"Richard Hamilton","DET",46,1552,202,436,170,32,108,20,42,10,22
"Jason Maxiell","DET",76,1550,39,90,27,12,17,3,7,3,9
"J.J. Barea","DAL",78,1545,258,579,195,63,83,33,79,27,36
"Roger Mason Jr.","SAS",79,1514,137,311,100,37,51,14,35,16,21
"Delonte West","CLE",60,1500,196,429,159,37,86,26,47,12,25
"CJ Miles","UTA",63,1497,105,227,88,17,53,14,21,7,10
"Dorell Wright","MIA",72,1496,91,194,79,12,30,7,42,7,5
"DeJuan Blair","SAS",82,1494,65,149,46,19,27,4,15,11,8
"Chase Budinger","HOU",74,1488,88,201,63,25,33,11,19,6,19
"Mike Dunleavy","IND",67,1486,103,236,73,30,44,13,16,8,22
"Andres Nocioni","SAC",75,1477,75,169,56,19,28,4,24,7,12
"Jordan Farmar","LAL",82,1474,127,289,92,35,45,25,22,10,25
"D.J. Augustin","CHA",80,1472,193,428,151,42,80,16,55,14,28
"Amir Johnson","TOR",82,1453,48,107,37,11,15,11,11,3,8
"Goran Dragic","PHX",80,1442,241,578,145,96,90,15,40,32,64
"Rudy Fernandez","POR",62,1441,127,275,106,21,58,13,35,10,11
"Anthony Tolliver","GSW",46,1428,87,201,60,27,31,7,22,11,16
"Nick Young","WAS",74,1421,48,101,43,5,15,8,20,0,5
"Rafer Alston","MIA",52,1421,176,384,144,32,61,25,58,13,19
"Darius Songaila","NOH",75,1410,70,160,50,20,42,3,5,3,17
"Antoine Wright","TOR",67,1392,71,156,57,14,26,9,22,5,9
"Wayne Ellington","MIN",76,1384,74,158,64,10,29,13,22,2,8
"Sonny Weems","TOR",69,1368,101,226,77,24,41,11,25,3,21
"Zydrunas Ilgauskas","CLE",64,1339,48,108,36,12,27,2,7,5,7
"Serge Ibaka","OKC",73,1323,10,23,7,3,4,0,3,2,1
"Joel Anthony","MIA",80,1322,12,29,7,5,1,1,5,2,3
"Sam Young","MEM",80,1321,52,113,43,9,27,7,9,2,7
"Ty Lawson","DEN",65,1317,203,453,156,47,85,22,49,15,32
"Maurice Evans","ATL",79,1317,48,105,39,9,19,0,20,3,6
"Jerryd Bayless","POR",74,1304,172,391,125,47,40,16,69,21,26
"Erick Dampier","DAL",55,1280,31,75,18,13,3,3,12,3,10
"Eric Maynor","OKC",81,1269,266,594,204,62,105,34,65,13,49
"Shaquille O'Neal","CLE",53,1240,80,182,58,22,44,3,11,8,14
"Craig Smith","LAC",75,1232,84,196,56,28,26,5,25,4,24
"Ryan Hollins","MIN",73,1223,51,107,46,5,16,8,22,1,4
"Kris Humphries","NJN",69,1221,32,67,29,3,11,6,12,0,3
"Tyrus Thomas","CHA",54,1220,56,120,48,8,37,3,8,4,4
"Eddie House","NYK",68,1217,85,200,55,30,36,5,14,10,20
"T.J. Ford","IND",47,1189,180,421,119,61,72,13,34,19,42
"Gilbert Arenas","WAS",32,1169,230,498,192,38,100,29,63,11,27
"Lou Amundson","PHX",79,1168,31,69,24,7,14,4,6,1,6
"Tyson Chandler","CHA",51,1163,16,33,15,1,6,3,6,0,1
"Matt Bonner","SAS",65,1161,68,166,38,30,15,11,12,13,17
"DeAndre Jordan","LAC",70,1137,21,51,12,9,7,1,4,2,7
"Marco Belinelli","TOR",66,1121,89,195,72,17,40,7,25,8,9
"Earl Boykins","WAS",67,1117,171,390,123,48,54,18,51,17,31
"Nate Robinson","BOS",56,1116,163,374,115,48,55,13,47,11,37
"Larry Hughes","CHA",45,1114,137,305,106,31,78,10,18,11,20
"Trenton Hassell","NJN",52,1106,50,114,36,14,20,5,11,4,10
"Zaza Pachulia","ATL",78,1089,42,95,31,11,23,1,7,9,2
"Marcin Gortat","ORL",81,1088,17,41,10,7,5,0,5,1,6
"Toney Douglas","NYK",56,1087,112,276,60,52,32,9,19,19,33
"Daniel Gibson","CLE",56,1068,70,153,57,13,36,11,10,7,6
"Devin Brown","CHI",50,1060,65,140,55,10,27,13,15,4,6
"Jamario Moon","CLE",61,1052,49,112,35,14,19,6,10,4,10
"Kurt Thomas","MIL",70,1049,47,112,29,18,9,5,15,5,13
"Sergio Rodriguez","NYK",66,1048,212,488,148,64,96,13,39,26,38
"Josh Boone","NJN",62,1045,29,64,23,6,14,2,7,1,5
"Jarvis Hayes","NJN",45,1032,40,87,33,7,14,12,7,5,2
"Marreese Speights","PHI",62,1016,36,81,27,9,16,4,7,1,8
"Robin Lopez","PHX",51,986,7,15,6,1,2,2,2,0,1
"Nazr Mohammed","CHA",58,984,28,61,23,5,14,1,8,0,5
"James Singleton","WAS",57,978,31,70,23,8,12,3,8,1,7
"Jason Kapono","PHI",57,976,39,85,32,7,15,8,9,3,4
"Morris Peterson","NOH",46,973,41,89,34,7,16,7,11,3,4
"Keyon Dooling","NJN",53,970,135,300,105,30,49,15,41,18,12
"JaVale McGee","WAS",59,968,14,30,12,2,6,4,2,0,2
"Kyle Korver","UTA",52,952,89,189,78,11,49,16,13,8,3
"Ime Udoka","SAC",69,944,58,127,47,11,27,6,14,5,6
"Marquis Daniels","BOS",51,937,66,159,39,27,19,5,15,4,23
"Glen Davis","BOS",54,933,35,91,14,21,7,4,3,4,17
"Josh Howard","WAS",35,918,48,111,33,15,20,2,11,2,13
"Nicolas Batum","POR",37,918,44,98,34,10,16,3,15,0,10
"Austin Daye","DET",69,915,34,73,29,5,18,8,3,3,2
"Ryan Anderson","ORL",63,910,37,86,25,12,13,6,6,4,8
"Vladimir Radmanovic","GSW",41,891,45,102,33,12,23,3,7,4,8
"David Andersen","HOU",63,891,44,100,32,12,14,4,14,2,10
"Tony Allen","BOS",54,889,72,155,61,11,26,12,23,3,8
"Hasheem Thabeet","MEM",68,883,11,24,9,2,5,3,1,0,2
"DeShawn Stevenson","DAL",64,883,56,126,42,14,18,5,19,2,12
"Sasha Pavlovic","MIN",71,877,58,122,52,6,18,16,18,2,4
"Marcus Williams","MEM",62,872,161,334,149,12,77,22,50,4,8
"Ronny Turiaf","GSW",42,872,90,204,66,24,31,9,26,4,20
"Julian Wright","NOH",68,871,41,87,36,5,19,4,13,3,2
"AJ Price","IND",56,865,106,257,61,45,31,11,19,12,33
"Allen Iverson","PHI",28,864,113,254,85,28,39,16,30,12,16
"Anthony Carter","DEN",54,859,160,356,124,36,82,11,31,9,27
"Rodney Carney","PHI",68,857,37,81,30,7,16,6,8,2,5
"Jerry Stackhouse","MIL",42,855,70,159,51,19,22,8,21,7,12
"Jannero Pargo","CHI",63,828,89,198,69,20,46,4,19,8,12
"Luther Head","IND",47,813,72,167,49,23,26,5,18,7,16
"Theo Ratliff","CHA",49,806,25,53,22,3,9,1,12,0,3
"Ronnie Price","UTA",60,806,123,268,101,22,56,6,39,5,17
"Stephen Graham","CHA",70,804,23,54,15,8,8,1,6,5,3
"Shaun Livingston","WAS",36,795,130,279,111,19,54,18,39,6,13
"DeMarre Carroll","MEM",71,795,33,73,26,7,14,4,8,4,3
"Leandro Barbosa","PHX",44,786,64,157,35,29,18,6,11,11,18
"Chris Hunter","GSW",60,783,37,84,27,10,10,1,16,0,10
"Reggie Williams","GSW",24,781,66,158,40,26,20,11,9,10,16
"Henry Walker","NYK",35,768,40,95,25,15,16,4,5,4,11
"Andris Biedrins","GSW",33,763,57,132,39,18,14,6,19,3,15
"Devean George","GSW",45,761,32,82,14,18,8,2,4,8,10
"Joey Graham","DEN",62,759,22,52,14,8,9,2,3,4,4
"James Johnson","CHI",65,757,48,107,37,11,17,6,14,2,9
"Anthony Randolph","GSW",33,749,42,90,36,6,20,5,11,1,5
"Jawad Williams","CLE",54,742,34,82,20,14,8,5,7,8,6
"Travis Outlaw","LAC",34,730,34,83,19,15,11,1,7,6,9
"Jodie Meeks","PHI",60,719,39,90,27,12,11,3,13,4,8
"Jeff Teague","ATL",71,718,122,271,95,27,36,16,43,16,11
"Michael Finley","BOS",46,709,43,100,29,14,18,4,7,8,6
"Dante Cunningham","POR",63,707,14,33,9,5,6,1,2,1,4
"Rodrigue Beaubois","DAL",56,700,74,167,55,19,26,6,23,3,16
"Daequan Cook","MIA",45,691,43,96,33,10,7,4,22,2,8
"Darko Milicic","MIN",32,685,47,107,34,13,28,1,5,5,8
"Eduardo Najera","DAL",46,685,29,69,18,11,8,2,8,4,7
"Joel Przybilla","POR",30,681,8,19,5,3,4,0,1,2,1
"Solomon Jones","IND",52,675,32,74,22,10,11,1,10,1,9
"Tracy McGrady","NYK",30,672,99,225,72,27,47,5,20,6,21
"Kwame Brown","DET",48,660,22,48,18,4,13,1,4,1,3
"Sebastian Telfair","CLE",43,659,126,278,100,26,51,13,36,5,21
"Jason Smith","PHI",56,658,33,76,23,10,7,3,13,5,5
"Jon Brockman","SAC",52,654,22,53,13,9,5,3,5,4,5
"Fabricio Oberto","WAS",57,650,51,112,41,10,23,4,14,3,7
"Brandon Bass","ORL",50,648,19,45,12,7,6,3,3,3,4
"Chucky Atkins","DET",40,644,91,196,77,14,42,13,22,4,10
"Jordan Hill","HOU",47,624,20,50,10,10,7,2,1,2,8
"Shelden Williams","BOS",54,597,21,49,14,7,7,2,5,2,5
"Joe Smith","ATL",64,592,21,47,16,5,10,1,5,3,2
"Jamaal Tinsley","MEM",38,589,108,230,94,14,60,9,25,3,11
"Josh Powell","LAL",63,581,35,79,26,9,10,6,10,3,6
"Francisco Garcia","SAC",25,575,45,94,41,4,12,8,21,3,1
"Sasha Vujacic","LAL",67,575,41,95,28,13,15,3,10,4,9
"Quinton Ross","WAS",52,562,12,25,11,1,5,1,5,0,1
"Derrick Brown","CHA",57,535,19,47,10,9,5,0,5,1,8
"Josh McRoberts","IND",42,524,44,102,30,14,17,5,8,3,11
"Bobby Brown","LAC",45,519,88,209,55,33,33,6,16,4,29
"Tyler Hansbrough","IND",29,511,28,62,22,6,12,1,9,0,6
"James Jones","MIA",36,503,17,38,13,4,4,1,8,2,2
"Greg Oden","POR",21,502,19,44,13,6,9,2,2,1,5
"Ricky Davis","LAC",36,499,39,85,32,7,18,3,11,4,3
"Michael Redd","MIL",18,492,39,92,25,14,5,8,12,7,7
"Brian Scalabrine","BOS",52,472,27,63,18,9,7,4,7,0,9
"Mardy Collins","LAC",43,470,44,95,37,7,13,6,18,3,4
"Darrell Arthur","MEM",32,457,15,35,10,5,3,1,6,2,3
"Malik Allen","DEN",51,456,16,40,8,8,3,0,5,4,4
"Oleksiy Pecherov","MIN",44,447,11,22,11,0,3,1,7,0,0
"Chris Wilcox","DET",34,441,13,27,12,1,10,1,1,0,1
"Johan Petro","DEN",36,436,14,31,11,3,9,1,1,1,2
"Rasho Nesterovic","TOR",42,413,25,53,22,3,14,2,6,1,2
"Nathan Jawai","MIN",39,412,24,54,18,6,8,4,6,2,4
"Kyrylo Fesenko","UTA",49,408,15,30,15,0,8,0,7,0,0
"Anthony Johnson","ORL",31,406,63,152,37,26,18,7,12,9,17
"Mikki Moore","GSW",23,406,36,86,22,14,9,1,12,6,8
"Jeff Ayres","POR",39,405,1,3,0,1,0,0,0,0,1
"DaJuan Summers","DET",44,405,16,37,11,5,6,2,3,1,4
"Bobby Simmons","NJN",23,395,15,31,14,1,7,6,1,0,1
"Cartier Martin","WAS",18,390,16,36,12,4,4,2,6,1,3
"Earl Clark","PHX",51,383,21,50,13,8,6,2,5,0,8
"Steve Novak","LAC",54,362,6,16,2,4,2,0,0,1,3
"Jamaal Magloire","MIA",36,359,1,3,0,1,0,0,0,1,0
"DJ Mbenga","LAL",49,355,8,17,7,1,3,1,3,0,1
"Gerald Henderson","CHA",43,355,13,28,11,2,5,1,5,1,1
"Hilton Armstrong","HOU",33,335,21,47,16,5,11,0,5,1,4
"Garrett Temple","SAS",27,334,21,48,15,6,9,2,4,3,3
"Sean May","SAC",37,331,17,37,14,3,8,1,5,0,3
"Royal Ivey","MIL",44,327,27,61,20,7,10,5,5,1,6
"Etan Thomas","OKC",23,321,1,3,0,1,0,0,0,0,1
"Malik Hairston","SAS",47,317,16,38,10,6,5,1,4,3,3
"Dan Gadzuric","MIL",32,314,12,29,7,5,2,1,4,2,3
"Kenny Thomas","SAC",26,313,15,32,13,2,7,2,4,2,0
"Aaron Gray","NOH",32,311,22,46,20,2,12,4,4,0,2
"Reggie Evans","TOR",28,311,8,17,7,1,3,0,4,1,0
"Dominic McGuire","SAC",51,307,11,23,10,1,7,0,3,1,0
"Jermaine Taylor","HOU",31,303,16,33,15,1,10,1,4,0,1
"Jonathan Bender","NYK",25,292,16,36,12,4,6,1,5,0,4
"Tim Thomas","DAL",18,285,14,31,11,3,4,1,6,0,3
"Luke Walton","LAL",29,272,40,86,34,6,18,4,12,2,4
"Brian Cardinal","MIN",29,267,24,50,22,2,15,2,5,0,2
"Kevin Ollie","OKC",25,263,20,45,15,5,3,4,8,0,5
"DeSagana Diop","CHA",27,262,5,11,4,1,3,0,1,0,1
"Jarron Collins","PHX",34,260,6,14,4,2,2,0,2,0,2
"Jeff Foster","IND",16,255,21,51,12,9,2,2,8,1,8
"Marcus Banks","TOR",22,244,26,55,23,3,12,3,8,1,2
"Adam Morrison","LAL",31,241,18,40,14,4,9,2,3,0,4
"Hamed Haddadi","MEM",36,240,10,20,10,0,9,1,0,0,0
"J.R. Giddens","NYK",32,239,13,32,7,6,4,1,2,0,6
"Leon Powe","CLE",20,236,0,0,0,0,0,0,0,0,0
"Acie Law","CHI",26,234,26,58,20,6,14,1,5,2,4
"Earl Barron","NYK",7,232,8,21,3,5,1,0,2,1,4
"Kelenna Azubuike","GSW",9,231,10,22,8,2,5,0,3,1,1
"Sean Williams","NJN",20,227,1,2,1,0,0,1,0,0,0
"Chris Richard","CHI",18,224,7,17,4,3,1,0,3,0,3
"Chris Quinn","NJN",25,223,29,63,24,5,10,3,11,2,3
"Sundiata Gaines","UTA",32,217,39,82,35,4,20,4,11,2,2
"Alonzo Gee","WAS",11,182,7,16,5,2,1,2,2,0,2
"Raja Bell","GSW",6,181,13,27,12,1,5,3,4,1,0
"Kosta Koufos","UTA",36,172,6,13,5,1,3,0,2,0,1
"Ian Mahinmi","SAS",26,165,2,4,2,0,1,1,0,0,0
"Steven Hunter","MEM",21,158,0,0,0,0,0,0,0,0,0
"Kyle Weaver","OKC",12,144,11,24,9,2,3,2,4,1,1
"Mario West","ATL",38,142,9,18,9,0,3,1,5,0,0
"Tony Battie","NJN",15,134,3,6,3,0,0,1,2,0,0
"Lester Hudson","MEM",25,131,13,29,10,3,7,0,3,0,3
"Randolph Morris","ATL",28,124,2,5,1,1,1,0,0,0,1
"Brian Skinner","LAC",16,123,0,0,0,0,0,0,0,0,0
"Darnell Jackson","MIL",28,122,4,11,1,3,0,0,1,0,3
"Lindsey Hunter","CHI",13,122,9,20,7,2,4,1,2,1,1
"Matt Carroll","DAL",25,121,6,12,6,0,2,0,4,0,0
"Pops Mensah-Bonsu","TOR",20,120,3,7,2,1,1,1,0,0,1
"Danny Green","CLE",20,115,5,11,4,1,3,0,1,0,1
"Jason Collins","ATL",24,115,4,9,3,1,3,0,0,0,1
"Coby Karl","GSW",7,113,15,35,10,5,4,1,5,1,4
"Marcus Landry","BOS",18,111,0,0,0,0,0,0,0,0,0
"Joey Dorsey","SAC",15,107,2,6,0,2,0,0,0,0,2
"DJ White","OKC",12,102,4,9,3,1,2,0,1,0,1
"Roko Ukic","MIL",13,97,12,28,8,4,2,1,5,0,4
"Mike Harris","HOU",13,96,3,7,2,1,1,0,1,0,1
"Alando Tucker","MIN",15,95,4,8,4,0,2,0,2,0,0
"Primoz Brezec","MIL",21,95,1,2,1,0,0,0,1,0,0
"Renaldo Balkman","DEN",13,91,7,17,4,3,2,0,2,1,2
"Sean Marks","NOH",14,75,2,4,2,0,0,2,0,0,0
"Cedric Jackson","WAS",12,75,14,32,10,4,5,2,3,1,3
"Othyus Jeffers","UTA",14,72,1,2,1,0,1,0,0,0,0
"Francisco Elson","PHI",12,66,2,5,1,1,0,0,1,1,0
"Desmond Mason","SAC",5,65,2,5,1,1,1,0,0,0,1
"Eddy Curry","NYK",7,62,0,0,0,0,0,0,0,0,0
"Mike Wilks","OKC",4,59,4,9,3,1,1,0,2,0,1
"Kareem Rush","LAC",7,58,4,8,4,0,1,2,1,0,0
"Byron Mullens","OKC",13,54,1,3,0,1,0,0,0,0,1
"Shavlik Randolph","MIA",6,53,1,2,1,0,1,0,0,0,0
"Travis Diener","POR",9,51,8,17,7,1,4,1,2,0,1
"Patrick O'Bryant","TOR",11,51,1,3,0,1,0,0,0,0,1
"Mike James","WAS",4,46,5,12,3,2,1,1,1,1,1
"Brian Cook","HOU",14,44,1,2,1,0,1,0,0,0,0
"Yakhouba Diawara","MIA",6,44,3,6,3,0,1,1,1,0,0
"Marcus Haislip","SAS",10,44,0,0,0,0,0,0,0,0,0
"Patty Mills","POR",10,38,5,12,3,2,3,0,0,1,1
"Will Conroy","HOU",5,36,7,17,4,3,0,2,2,1,2
"Othello Hunter","ATL",7,33,0,0,0,0,0,0,0,0,0
"Taylor Griffin","PHX",8,32,1,2,1,0,1,0,0,0,0
"Alexis Ajinca","CHA",6,30,0,0,0,0,0,0,0,0,0
"Joe Alexander","CHI",8,29,2,4,2,0,2,0,0,0,0
"Jason Hart","NOH",5,22,6,13,5,1,1,0,4,0,1
"Oliver Lafayette","BOS",1,22,2,4,2,0,2,0,0,0,0
"Antonio Anderson","OKC",1,15,0,0,0,0,0,0,0,0,0
"Paul Davis","WAS",2,8,3,7,2,1,1,0,1,0,1
"Ryan Bowen","OKC",1,8,0,0,0,0,0,0,0,0,0
"Dwayne Jones","PHX",2,7,0,0,0,0,0,0,0,0,0
"Trey Gilder","MEM",2,5,0,0,0,0,0,0,0,0,0
"JamesOn Curry","LAC",1,0,0,0,0,0,0,0,0,0,0