"Name","TeamAbbreviation","GamesPlayed","Minutes","Assists","AssistPoints","TwoPtAssists","ThreePtAssists","AtRimAssists","ShortMidRangeAssists","LongMidRangeAssists","Corner3Assists","Arc3Assists"
"Julius Randle","NYK",71,2667,427,1092,189,238,108,42,39,91,147
"RJ Barrett","NYK",72,2511,217,520,131,86,94,24,13,38,48
"Nikola Jokic","DEN",72,2488,599,1410,387,212,263,75,49,81,131
"Buddy Hield","SAC",71,2433,257,579,192,65,121,52,19,26,39
"Damian Lillard","POR",67,2398,505,1256,259,246,200,36,23,66,180
"Terry Rozier","CHA",69,2383,293,720,159,134,110,38,11,45,89
"Russell Westbrook","WAS",65,2369,763,1767,522,241,286,175,61,77,164
"Andrew Wiggins","GSW",71,2364,167,428,73,94,43,23,7,25,69
"Nikola Vucevic","CHI",70,2348,269,661,146,123,87,32,27,37,86
"Mikal Bridges","PHX",72,2348,152,361,95,57,60,24,11,22,35
"Anthony Edwards","MIN",72,2314,211,528,105,106,79,17,9,25,81
"Jayson Tatum","BOS",64,2290,276,696,132,144,73,43,16,43,101
"Devin Booker","PHX",67,2270,289,716,151,138,105,33,13,65,73
"Khris Middleton","MIL",68,2269,370,873,237,133,180,47,10,40,93
"Duncan Robinson","MIA",72,2262,127,294,87,40,64,20,3,11,29
"Luka Doncic","DAL",66,2254,567,1375,326,241,244,49,33,82,159
"Robert Covington","POR",70,2243,117,299,52,65,42,8,2,13,52
"Royce O'Neale","UTA",71,2241,181,478,65,116,52,13,0,42,74
"Domantas Sabonis","IND",62,2232,415,1008,237,178,163,44,30,33,145
"Bojan Bogdanovic","UTA",72,2216,136,352,56,80,43,11,2,35,45
"Norman Powell","POR",69,2205,129,325,62,67,47,11,4,15,52
"Chris Paul","PHX",70,2199,622,1484,382,240,220,113,49,73,167
"Rudy Gobert","UTA",71,2187,89,233,34,55,19,12,3,23,32
"Justin Holiday","IND",72,2183,119,283,74,45,51,19,4,14,31
"Isaac Okoro","CLE",67,2173,128,318,66,62,39,21,6,18,44
"Coby White","CHI",69,2156,328,806,178,150,97,54,27,49,101
"Stephen Curry","GSW",63,2152,363,843,246,117,187,45,14,64,53
"Bradley Beal","WAS",60,2147,265,617,178,87,94,65,19,24,63
"Bam Adebayo","MIA",64,2143,346,873,165,181,129,25,11,30,151
"Joe Harris","BKN",69,2141,130,319,71,59,52,14,5,28,31
"Dejounte Murray","SAS",67,2139,363,847,242,121,128,66,48,37,84
"Kevin Huerter","ATL",69,2126,241,575,148,93,98,40,10,30,63
"Trae Young","ATL",63,2125,594,1403,379,215,289,67,23,70,145
"Collin Sexton","CLE",60,2115,262,623,163,99,109,47,7,19,80
"Deandre Ayton","PHX",69,2115,99,238,59,40,27,23,9,12,28
"Eric Bledsoe","NOP",71,2111,268,629,175,93,127,37,11,32,61
"Harrison Barnes","SAC",58,2102,201,497,106,95,48,41,17,41,54
"Brandon Ingram","NOP",61,2093,296,701,187,109,148,31,8,33,76
"DeMar DeRozan","SAS",61,2056,422,1044,222,200,131,56,35,53,147
"Ja Morant","MEM",63,2053,465,1106,289,176,174,97,18,66,110
"Jae'Sean Tate","HOU",70,2043,178,460,74,104,60,10,4,26,78
"De'Aaron Fox","SAC",58,2036,417,1003,248,169,157,79,12,41,128
"Zach LaVine","CHI",58,2034,282,677,169,113,98,58,13,42,71
"Zion Williamson","NOP",61,2026,226,569,109,117,61,23,25,40,77
"Tobias Harris","PHI",62,2014,220,539,121,99,74,32,15,31,68
"Giannis Antetokounmpo","MIL",61,2013,357,926,145,212,88,30,27,56,156
"Pascal Siakam","TOR",56,2006,250,647,103,147,68,24,11,40,107
"Jaylen Brown","BOS",58,1999,195,464,121,74,77,32,12,27,47
"Kelly Olynyk","HOU",70,1997,203,486,123,80,101,18,4,28,52
"Dillon Brooks","MEM",67,1997,157,358,113,44,66,46,1,17,27
"Tim Hardaway Jr.","DAL",70,1989,126,309,69,57,44,12,13,14,43
"Patrick Williams","CHI",71,1983,99,245,52,47,36,9,7,17,30
"Draymond Green","GSW",63,1982,558,1330,344,214,257,62,25,49,165
"Keldon Johnson","SAS",69,1968,121,280,83,38,51,17,15,9,29
"Dennis Schroder","LAL",61,1956,351,853,200,151,129,50,21,33,118
"Kyle Kuzma","LAL",68,1954,127,304,77,50,55,15,7,12,38
"P.J. Washington","CHA",64,1954,161,401,82,79,53,12,17,18,61
"Reggie Bullock","NYK",65,1949,99,238,59,40,39,11,9,10,30
"Danny Green","PHI",69,1934,118,273,81,37,51,21,9,15,22
"Miles Bridges","CHA",66,1932,147,363,78,69,58,12,8,26,43
"Malcolm Brogdon","IND",56,1930,329,791,196,133,153,35,8,39,94
"Dorian Finney-Smith","DAL",60,1915,102,251,55,47,34,11,10,11,36
"Michael Porter Jr.","DEN",61,1912,70,168,42,28,17,21,4,6,22
"Saddiq Bey","DET",70,1909,95,236,49,46,33,10,6,12,34
"Jrue Holiday","MIL",59,1907,357,856,215,142,131,53,31,39,103
"Kentavious Caldwell-Pope","LAL",67,1902,127,305,76,51,62,11,3,16,35
"Brook Lopez","MIL",70,1902,50,125,25,25,14,5,6,3,22
"Fred VanVleet","TOR",52,1899,328,825,159,169,107,35,17,58,111
"Clint Capela","ATL",63,1898,49,119,28,21,13,11,4,10,11
"Kyle Anderson","MEM",69,1887,250,575,175,75,114,51,10,22,53
"Kyrie Irving","BKN",54,1886,324,780,192,132,140,36,16,38,94
"Ben Simmons","PHI",58,1877,401,1010,193,208,93,62,38,69,139
"Joe Ingles","UTA",67,1867,318,777,177,141,135,38,4,58,83
"Jarrett Allen","CLE",63,1864,106,256,62,44,37,15,10,11,33
"Dwayne Bacon","ORL",72,1853,93,232,47,46,23,8,16,9,37
"John Collins","ATL",63,1848,78,188,46,32,26,14,6,9,23
"Jakob Poeltl","SAS",69,1845,134,304,98,36,45,29,24,8,28
"Jeff Green","BKN",68,1835,108,280,44,64,28,9,7,14,50
"Nicolas Batum","LAC",67,1835,148,354,90,58,46,29,15,25,33
"Jerami Grant","DET",54,1829,152,362,94,58,67,19,8,20,38
"Paul George","LAC",54,1821,280,693,147,133,99,27,21,43,90
"Jordan Clarkson","UTA",68,1818,168,418,86,82,60,20,6,28,54
"Donte DiVincenzo","MIL",66,1814,203,472,137,66,96,25,16,24,42
"Gary Trent Jr.","TOR",58,1802,80,200,40,40,21,12,7,9,31
"Rui Hachimura","WAS",57,1797,82,203,43,39,20,14,9,8,31
"T.J. McConnell","IND",69,1796,456,1093,275,181,221,44,10,51,130
"Josh Richardson","DAL",59,1795,153,391,68,85,43,16,9,24,61
"Darius Garland","CLE",54,1790,329,747,240,89,184,46,10,27,62
"Richaun Holmes","SAC",61,1782,101,240,63,38,44,14,5,15,23
"Theo Maledon","OKC",65,1778,227,560,121,106,87,25,9,31,75
"Kawhi Leonard","LAC",52,1773,269,695,112,157,62,29,21,55,102
"Ricky Rubio","MIN",68,1772,433,1033,266,167,202,50,14,42,125
"Donovan Mitchell","UTA",53,1771,277,699,132,145,102,29,1,49,96
"Enes Kanter","POR",72,1758,84,213,39,45,21,5,13,7,38
"Jonas Valanciunas","MEM",62,1755,112,255,81,31,34,30,17,3,28
"Delon Wright","SAC",63,1748,278,703,131,147,83,36,12,44,103
"Lonzo Ball","NOP",55,1747,316,717,231,85,170,38,23,22,63
"Tyrese Haliburton","SAC",58,1746,309,721,206,103,128,62,16,31,72
"Jimmy Butler","MIA",52,1745,369,893,214,155,153,46,15,43,112
"Will Barton","DEN",56,1736,181,424,119,62,58,47,14,16,46
"Darius Bazley","OKC",55,1714,99,245,52,47,39,6,7,14,33
"Jamal Murray","DEN",48,1704,231,553,140,91,79,41,20,17,74
"Jalen Brunson","DAL",68,1697,239,602,115,124,64,26,25,35,89
"Carmelo Anthony","POR",69,1690,104,261,51,53,36,6,9,16,37
"Karl-Anthony Towns","MIN",50,1689,225,548,127,98,95,20,12,34,64
"Kelly Oubre Jr.","GSW",55,1687,73,173,46,27,23,13,10,8,19
"Patty Mills","SAS",68,1685,162,373,113,49,65,28,20,7,42
"Devonte' Graham","CHA",55,1659,295,713,172,123,129,33,10,41,82
"Thaddeus Young","CHI",68,1652,291,685,188,103,124,36,28,37,66
"Kendrick Nunn","MIA",56,1650,148,344,100,48,71,21,8,10,38
"Jae Crowder","PHX",60,1648,127,297,84,43,55,20,9,23,20
"Seth Curry","PHI",57,1638,155,366,99,56,58,27,14,22,34
"Tyler Herro","MIA",54,1635,184,451,101,83,79,18,4,25,58
"Doug McDermott","IND",66,1619,85,201,54,31,28,20,6,14,17
"James Harden","BKN",44,1609,475,1113,312,163,234,55,23,49,114
"Ivica Zubac","LAC",72,1609,90,219,51,39,23,12,16,13,26
"Steven Adams","NOP",58,1605,111,256,77,34,39,12,26,3,31
"Kyle Lowry","TOR",46,1601,338,816,198,140,150,35,13,42,98
"Daniel Theis","CHI",65,1601,108,257,67,41,39,20,8,9,32
"CJ McCollum","POR",47,1600,223,562,107,116,75,19,13,27,89
"Joel Embiid","PHI",51,1585,145,350,85,60,38,28,19,20,40
"Marcus Smart","BOS",48,1581,273,658,161,112,112,30,19,27,85
"Montrezl Harrell","LAL",69,1580,73,174,45,28,24,11,10,5,23
"Pat Connaughton","MIL",69,1575,81,195,48,33,34,10,4,12,21
"Josh Jackson","DET",62,1560,143,331,98,45,83,11,4,12,33
"Nerlens Noel","NYK",64,1547,46,106,32,14,18,4,10,3,11
"Reggie Jackson","LAC",67,1544,205,513,102,103,53,27,22,41,62
"Luguentz Dort","OKC",52,1543,88,218,46,42,33,11,2,5,37
"Khem Birch","TOR",67,1529,89,225,42,47,14,15,13,11,36
"Garrett Temple","CHI",56,1528,124,292,80,44,48,25,7,11,33
"Lonnie Walker IV","SAS",60,1522,101,239,64,37,43,11,10,11,26
"Desmond Bane","MEM",68,1519,118,287,67,51,40,20,7,18,33
"Solomon Hill","ATL",71,1513,75,183,42,33,25,13,4,10,23
"Jaden McDaniels","MIN",63,1511,71,178,35,36,26,7,2,4,32
"Cedi Osman","CLE",59,1511,174,415,107,67,80,25,2,24,43
"LeBron James","LAL",45,1504,350,837,213,137,163,37,13,53,84
"Marcus Morris Sr.","LAC",57,1502,58,146,28,30,23,4,1,11,19
"Mason Plumlee","DET",56,1499,202,500,106,96,73,19,14,22,74
"Mike Conley","UTA",51,1498,305,768,147,158,118,24,5,51,107
"Gordon Hayward","CHA",44,1496,181,443,100,81,74,23,3,22,59
"Caris LeVert","IND",47,1485,245,584,151,94,112,27,12,15,79
"Elfrid Payton","NYK",63,1484,203,486,123,80,85,17,21,27,53
"LaMelo Ball","CHA",51,1469,313,733,206,107,159,31,16,23,84
"Davis Bertans","WAS",57,1464,49,110,37,12,21,7,9,5,7
"Shake Milton","PHI",63,1461,193,478,101,92,57,36,8,37,55
"Myles Turner","IND",47,1455,48,112,32,16,24,6,2,6,10
"Isaiah Stewart","DET",68,1455,59,142,35,24,16,8,11,3,21
"Chris Boucher","TOR",60,1453,63,157,32,31,25,3,4,5,26
"Bruce Brown","BKN",65,1451,104,265,47,57,34,8,5,22,35
"Cory Joseph","DET",63,1446,213,512,127,86,64,49,14,29,57
"Cameron Johnson","PHX",60,1437,86,210,48,38,24,19,5,20,18
"OG Anunoby","TOR",43,1433,94,236,46,48,35,9,2,11,37
"Kenrich Williams","OKC",66,1426,152,367,89,63,54,27,8,20,43
"Isaiah Roby","OKC",61,1425,107,253,68,39,44,15,9,9,30
"Facundo Campazzo","DEN",65,1425,232,575,121,111,74,30,17,27,84
"Lou Williams","ATL",66,1423,225,540,135,90,105,18,12,37,53
"Brandon Clarke","MEM",59,1415,95,221,64,31,30,27,7,8,23
"Raul Neto","WAS",64,1403,146,345,93,53,57,26,10,10,43
"Landry Shamet","BKN",61,1403,99,240,57,42,40,15,2,14,28
"Aaron Gordon","DEN",50,1384,161,382,101,60,55,25,21,17,43
"Wendell Carter Jr.","ORL",54,1375,104,252,60,44,23,15,22,6,38
"Bobby Portis","MIL",66,1372,71,183,30,41,21,5,4,10,31
"Kemba Walker","BOS",43,1369,212,514,122,90,67,39,16,29,61
"Rudy Gay","SAS",63,1358,88,208,56,32,32,14,10,10,22
"P.J. Tucker","MIL",52,1356,61,157,26,35,21,3,2,5,30
"Bryn Forbes","MIL",70,1354,45,115,20,25,13,4,3,11,14
"Robin Lopez","WAS",71,1354,55,135,30,25,15,11,4,4,21
"Josh Hart","NOP",47,1349,109,264,63,46,45,12,6,18,28
"Bismack Biyombo","CHA",66,1349,81,187,56,25,21,23,12,7,18
"Naz Reid","MIN",70,1347,72,177,39,33,24,12,3,11,22
"Terrence Ross","ORL",46,1347,108,257,67,41,32,23,12,11,30
"Maxi Kleber","DAL",50,1341,68,172,32,36,15,12,5,8,28
"Andre Iguodala","MIA",63,1339,142,349,77,65,60,12,5,20,45
"Goran Dragic","MIA",50,1337,219,535,122,97,85,25,12,37,60
"Kent Bazemore","GSW",67,1334,108,261,63,45,41,12,10,10,35
"Kristaps Porzingis","DAL",43,1327,68,172,32,36,20,6,6,9,27
"Christian Wood","HOU",41,1326,71,178,35,36,28,6,1,11,25
"Svi Mykhailiuk","OKC",66,1324,110,268,62,48,46,11,5,15,33
"Derrick Jones Jr.","POR",58,1318,47,120,21,26,12,3,6,6,20
"Lauri Markkanen","CHI",51,1317,45,110,25,20,14,8,3,7,13
"Tomas Satoransky","CHI",58,1307,271,642,171,100,123,37,11,28,72
"Bogdan Bogdanovic","ATL",44,1305,147,357,84,63,59,23,2,15,48
"Talen Horton-Tucker","LAL",65,1304,181,419,124,57,85,24,15,22,35
"Matisse Thybulle","PHI",65,1298,63,151,38,25,20,11,7,5,20
"John Wall","HOU",40,1288,275,686,139,136,108,25,6,49,87
"Tristan Thompson","BOS",54,1287,67,165,36,31,16,11,9,3,28
"Derrick Rose","NYK",50,1279,209,520,107,102,69,24,14,39,63
"Cole Anthony","ORL",47,1273,192,457,119,73,50,42,27,8,65
"Payton Pritchard","BOS",66,1268,120,286,74,46,41,23,10,10,36
"Terance Mann","LAC",67,1263,104,262,50,54,32,13,5,20,34
"Grayson Allen","MEM",50,1259,108,258,66,42,38,20,8,17,25
"Evan Fournier","BOS",42,1259,144,352,80,64,36,27,17,13,51
"Deni Avdija","WAS",54,1257,63,145,44,19,19,18,7,4,15
"Alec Burks","NYK",49,1255,107,260,61,46,43,10,8,19,27
"DeAndre Jordan","BKN",57,1246,93,217,62,31,29,21,12,4,27
"Immanuel Quickley","NYK",64,1243,127,310,71,56,49,13,9,18,38
"Andre Drummond","LAL",46,1242,94,217,65,29,41,20,4,12,17
"Luke Kennard","LAC",63,1232,104,264,48,56,33,13,2,21,35
"Sterling Brown","HOU",51,1229,72,178,38,34,33,4,1,14,20
"Hamidou Diallo","DET",52,1226,101,248,55,46,37,10,8,9,37
"Tyus Jones","MEM",70,1222,259,618,159,100,77,73,9,37,63
"Danilo Gallinari","ATL",51,1222,76,188,40,36,21,14,5,11,25
"Alex Caruso","LAL",58,1216,160,383,97,63,75,14,8,18,45
"Malik Beasley","MIN",37,1214,88,212,52,36,37,9,6,13,23
"Dean Wade","CLE",63,1212,74,176,46,28,29,11,6,5,23
"Markieff Morris","LAL",61,1200,73,179,40,33,29,8,3,10,23
"Josh Okogie","MIN",59,1197,63,149,40,23,31,5,4,7,16
"D'Angelo Russell","MIN",42,1196,244,584,148,96,119,24,5,18,78
"Monte Morris","DEN",47,1196,150,376,74,76,38,24,12,16,60
"Dwight Howard","PHI",69,1196,61,138,45,16,20,11,14,3,13
"Blake Griffin","BKN",46,1187,140,353,67,73,46,10,11,9,64
"Shai Gilgeous-Alexander","OKC",35,1180,207,523,98,109,76,13,9,34,75
"Aaron Holiday","IND",66,1176,123,293,76,47,52,15,9,19,28
"Paul Millsap","DEN",56,1162,98,240,54,44,33,13,8,13,31
"Anthony Davis","LAL",36,1162,110,266,64,46,43,11,10,15,31
"Kevon Looney","GSW",61,1161,119,299,58,61,26,17,15,13,48
"Kevin Durant","BKN",35,1157,195,459,126,69,91,30,5,18,51
"Georges Niang","UTA",72,1154,59,139,38,21,28,6,4,5,16
"Jarred Vanderbilt","MIN",64,1139,76,188,40,36,30,6,4,10,26
"Grant Williams","BOS",63,1138,64,166,26,38,22,4,0,6,32
"Chuma Okeke","ORL",45,1133,101,243,60,41,30,18,12,10,31
"Wesley Matthews","LAL",58,1130,54,129,33,21,18,12,3,4,17
"D.J. Augustin","HOU",57,1129,188,444,120,68,83,19,18,20,48
"JaMychal Green","DEN",58,1120,53,133,26,27,18,5,3,9,18
"Marvin Bagley III","SAC",43,1112,43,106,23,20,15,6,2,6,14
"Juan Toscano-Anderson","GSW",53,1107,150,367,83,67,63,13,7,17,50
"Anfernee Simons","POR",64,1104,89,232,35,54,14,8,13,12,42
"Larry Nance Jr.","CLE",35,1091,107,256,65,42,45,16,4,18,24
"Aleksej Pokusevski","OKC",45,1090,97,232,59,38,38,15,6,12,26
"PJ Dozier","DEN",50,1088,92,222,54,38,34,13,7,17,21
"Xavier Tillman","MEM",59,1085,75,183,42,33,13,18,11,8,25
"Gary Harris","ORL",39,1080,78,194,40,38,27,7,6,12,26
"Victor Oladipo","MIA",33,1080,151,373,80,71,65,14,1,12,59
"Cameron Payne","PHX",60,1080,217,534,117,100,71,34,12,30,70
"Damion Lee","GSW",57,1079,73,178,41,32,23,14,4,13,19
"Terence Davis","SAC",61,1074,83,202,47,36,31,12,4,13,23
"Kenyon Martin Jr.","HOU",45,1068,48,125,19,29,15,1,3,7,22
"Derrick White","SAS",36,1064,127,289,92,35,53,24,15,7,28
"Furkan Korkmaz","PHI",55,1062,82,195,51,31,35,9,7,12,19
"Devin Vassell","SAS",62,1056,56,138,30,26,19,7,4,4,22
"Brad Wanamaker","CHA",61,1053,174,431,91,83,58,23,10,22,61
"Timothe Luwawu-Cabarrot","BKN",58,1050,69,165,42,27,28,11,3,14,13
"James Johnson","NOP",51,1048,98,238,56,42,31,19,6,9,33
"De'Anthony Melton","MEM",52,1045,132,307,89,43,49,32,8,14,29
"Derrick Favors","UTA",68,1039,44,124,8,36,2,5,1,10,26
"Garrison Mathews","WAS",64,1038,26,65,13,13,8,4,1,5,8
"Denzel Valentine","CHI",62,1036,105,257,58,47,42,11,5,17,30
"Wayne Ellington","DET",46,1012,67,158,43,24,34,4,5,11,13
"Nickeil Alexander-Walker","NOP",46,1007,102,233,73,29,62,8,3,3,26
"Stanley Johnson","TOR",61,1006,89,220,47,42,32,14,1,9,33
"Cody Zeller","CHA",48,1005,86,212,46,40,26,9,11,15,25
"Marc Gasol","LAL",52,993,109,252,75,34,57,13,5,13,21
"Tony Snell","ATL",47,992,59,147,30,29,16,10,4,7,22
"Jordan Poole","GSW",51,988,99,241,56,43,40,11,5,6,37
"James Ennis III","ORL",41,986,62,142,44,18,27,8,9,5,13
"Robert Williams III","BOS",52,985,94,233,49,45,24,15,10,9,36
"Aron Baynes","TOR",53,980,47,116,25,22,13,3,9,6,16
"Alex Len","WAS",64,979,49,123,24,25,9,9,6,4,21
"DeAndre' Bembry","TOR",51,972,107,266,55,52,39,13,3,16,36
"Dwight Powell","DAL",58,966,63,152,37,26,15,8,14,5,21
"Jaxson Hayes","NOP",60,964,35,85,20,15,11,3,6,2,13
"Serge Ibaka","LAC",41,955,74,185,37,37,17,12,8,16,21
"Jeff Teague","MIL",55,950,132,311,85,47,39,29,17,9,38
"Semi Ojeleye","BOS",56,950,37,86,25,12,14,9,2,2,10
"Rodney Hood","TOR",55,943,53,140,19,34,10,6,3,3,31
"Jordan McLaughlin","MIN",51,938,193,461,118,75,88,21,9,21,54
"Taj Gibson","NYK",45,936,36,86,22,14,11,6,5,5,9
"Tyrese Maxey","PHI",61,935,120,291,69,51,48,12,9,12,39
"Danuel House Jr.","HOU",36,932,69,180,27,42,22,4,1,21,21
"Malachi Flynn","TOR",47,928,137,336,75,62,48,21,6,16,46
"Ish Smith","WAS",44,924,172,416,100,72,69,23,8,18,54
"Moses Brown","OKC",43,920,10,23,7,3,1,3,3,0,3
"Trey Burke","DAL",62,914,81,203,40,41,29,6,5,12,29
"Damyean Dotson","CLE",46,907,91,215,58,33,46,10,2,8,25
"Willie Cauley-Stein","DAL",53,906,35,86,19,16,9,5,5,1,15
"Taurean Prince","CLE",41,905,76,173,55,21,42,6,7,8,13
"Ben McLemore","LAL",53,905,39,93,24,15,19,2,3,3,12
"Kira Lewis Jr.","NOP",54,904,124,292,80,44,61,16,3,15,29
"Jalen McDaniels","CHA",47,904,53,135,24,29,15,6,3,9,20
"Juancho Hernangomez","MIN",52,900,35,88,17,18,11,5,1,5,13
"R.J. Hampton","ORL",51,888,87,210,51,36,34,13,4,10,26
"Jusuf Nurkic","POR",37,880,125,302,73,52,46,15,12,15,37
"Malik Monk","CHA",42,878,87,207,54,33,42,9,3,11,22
"Dario Saric","PHX",50,871,65,156,39,26,21,10,8,9,17
"Sekou Doumbouya","DET",56,869,47,112,29,18,22,4,3,1,17
"Edmond Sumner","IND",53,861,49,123,24,25,16,5,3,10,15
"Mitchell Robinson","NYK",31,853,17,38,13,4,3,3,7,0,4
"Mike Scott","PHI",51,852,40,100,20,20,10,5,5,10,10
"Cody Martin","CHA",52,849,86,207,51,35,36,10,5,11,24
"Willy Hernangomez","NOP",47,846,50,120,30,20,13,8,9,4,16
"Austin Rivers","DEN",36,845,81,197,46,35,23,14,9,10,25
"Trevor Ariza","MIA",30,841,55,133,32,23,22,7,3,8,15
"Chasson Randle","ORL",41,837,74,175,47,27,24,16,7,5,22
"James Wiseman","GSW",39,836,26,65,13,13,5,6,2,2,11
"Kevin Porter Jr.","HOU",26,835,164,386,106,58,84,18,4,8,50
"Patrick Beverley","LAC",37,832,76,186,42,34,22,4,16,17,17
"Caleb Martin","CHA",53,818,67,164,37,30,30,4,3,9,21
"Torrey Craig","PHX",50,803,49,118,29,20,14,10,5,3,17
"Michael Carter-Williams","ORL",31,800,129,313,74,55,33,23,18,5,50
"Daniel Gafford","WAS",54,791,29,66,21,8,10,4,7,1,7
"Eric Gordon","HOU",27,789,71,173,40,31,33,7,0,9,22
"Ty Jerome","OKC",33,788,120,290,70,50,51,13,6,14,36
"Al Horford","OKC",28,782,94,228,54,40,39,11,4,10,30
"Saben Lee","DET",48,781,174,422,100,74,68,19,13,22,52
"Maurice Harkless","MIA",37,772,44,107,25,19,17,7,1,5,14
"Rajon Rondo","LAC",45,769,199,496,101,98,62,22,17,25,73
"Mychal Mulder","GSW",60,766,26,65,13,13,7,2,4,1,12
"Jeremy Lamb","IND",36,765,53,126,33,20,21,8,4,7,13
"Jaylen Nowell","MIN",42,759,62,154,32,30,24,7,1,12,18
"Drew Eubanks","SAS",54,755,42,97,29,13,11,6,12,4,9
"Cam Reddish","ATL",26,750,35,83,22,13,17,4,1,3,10
"Frank Jackson","DET",40,738,36,90,18,18,14,2,2,4,14
"Precious Achiuwa","MIA",61,737,29,79,8,21,4,4,0,9,12
"Mo Bamba","ORL",46,725,35,84,21,14,13,6,2,3,11
"JJ Redick","DAL",44,723,51,113,40,11,33,5,2,1,10
"Yuta Watanabe","TOR",50,723,40,96,24,16,16,8,0,6,10
"Moritz Wagner","ORL",45,722,50,125,25,25,17,7,1,3,22
"Jevon Carter","PHX",60,717,71,177,36,35,20,11,5,10,25
"Frank Kaminsky","PHX",47,715,79,188,49,30,27,14,8,14,16
"DeMarcus Cousins","LAC",41,713,76,187,41,35,27,6,8,13,22
"Naji Marshall","NOP",32,700,88,199,65,23,44,16,5,6,17
"Eric Paschall","GSW",40,695,51,139,14,37,6,6,2,12,25
"Tony Bradley","OKC",42,684,37,82,29,8,13,8,8,2,6
"Tyler Johnson","BKN",39,684,47,112,29,18,22,4,3,8,10
"Obi Toppin","NYK",62,683,29,77,10,19,5,1,4,3,16
"David Nwaba","HOU",30,679,31,79,14,17,13,1,0,5,12
"JaVale McGee","DEN",46,678,39,89,28,11,17,6,5,1,10
"De'Andre Hunter","ATL",23,678,44,109,23,21,18,4,1,4,17
"LaMarcus Aldridge","BKN",26,674,49,124,23,26,14,4,5,4,22
"George Hill","PHI",30,672,73,176,43,30,28,10,5,8,22
"Killian Hayes","DET",26,670,138,333,81,57,64,14,3,16,41
"Aaron Nesmith","BOS",46,669,23,54,15,8,10,3,2,2,6
"Gabe Vincent","MIA",50,655,67,159,42,25,30,10,2,7,18
"Gary Clark","PHI",39,654,31,76,17,14,6,6,5,0,14
"Mike Muscala","OKC",35,645,28,67,17,11,15,1,1,1,10
"Nassir Little","POR",48,640,23,61,8,15,3,2,3,5,10
"Jake Layman","MIN",45,627,28,66,18,10,11,5,2,5,5
"Kevin Love","CLE",25,622,63,146,43,20,31,10,2,4,16
"Brandon Goodwin","ATL",47,620,95,229,56,39,26,18,12,8,31
"Otto Porter Jr.","ORL",28,607,55,129,36,19,23,10,3,6,13
"Avery Bradley","HOU",27,602,46,110,28,18,20,7,1,8,10
"Onyeka Okongwu","ATL",50,601,18,47,7,11,2,2,3,3,8
"Nemanja Bjelica","MIA",37,595,69,169,38,31,26,8,4,15,16
"Nicolas Claxton","BKN",32,594,28,68,16,12,7,8,1,1,11
"Patrick Patterson","LAC",38,582,29,74,13,16,8,3,2,7,9
"Justin Jackson","MIL",34,577,52,131,25,27,18,3,4,8,19
"John Konchar","MEM",43,575,47,123,18,29,11,6,1,7,22
"Nicolo Melli","DAL",45,566,44,112,20,24,13,5,2,4,20
"Goga Bitadze","IND",45,561,37,85,26,11,15,5,6,1,10
"Isaiah Hartenstein","CLE",46,559,55,130,35,20,18,13,4,8,12
"Gorgui Dieng","SAS",38,553,48,111,33,15,18,7,8,2,13
"Thanasis Antetokounmpo","MIL",57,551,46,118,20,26,10,2,8,6,20
"Hassan Whiteside","SAC",36,546,20,50,10,10,7,1,2,3,7
"Damian Jones","SAC",39,546,29,75,12,17,2,7,3,5,12
"Wes Iwundu","DAL",41,535,18,42,12,6,11,1,0,1,5
"Troy Brown Jr.","CHI",34,523,29,70,17,12,7,6,4,2,10
"Armoni Brooks","HOU",20,520,30,75,15,15,12,3,0,3,12
"Miye Oni","UTA",54,519,28,79,5,23,3,2,0,12,11
"Oshae Brissett","IND",21,519,18,47,7,11,5,2,0,4,7
"Dylan Windler","CLE",31,513,33,80,19,14,12,7,0,3,11
"Justise Winslow","MEM",26,507,50,116,34,16,19,11,4,5,11
"Max Strus","MIA",39,507,24,58,14,10,10,4,0,3,7
"Jarrett Culver","MIN",34,499,24,61,11,13,4,6,1,2,11
"Lamar Stevens","CLE",40,499,25,63,12,13,6,3,3,5,8
"DaQuan Jeffries","HOU",31,493,22,56,10,12,8,2,0,3,9
"Chimezie Metu","SAC",36,488,28,68,16,12,9,7,0,5,7
"Javonte Green","CHI",41,474,17,41,10,7,8,2,0,2,5
"Kevin Knox II","NYK",42,464,19,46,11,8,7,3,1,1,7
"Ryan Arcidiacono","CHI",44,450,56,130,38,18,17,18,3,3,15
"KZ Okpala","MIA",37,447,19,48,9,10,7,2,0,4,6
"Josh Green","DAL",39,445,28,70,14,14,12,0,2,4,10
"Langston Galloway","PHX",40,438,26,63,15,11,6,7,2,7,4
"Tyler Cook","DET",32,437,17,41,10,7,5,4,1,0,7
"Al-Farouq Aminu","CHI",23,434,31,75,18,13,9,6,3,3,10
"D.J. Wilson","HOU",35,433,23,57,12,11,10,2,0,3,8
"Isaac Bonga","WAS",40,432,23,52,17,6,7,8,2,3,3
"Dennis Smith Jr.","DET",23,420,77,182,49,28,40,7,2,6,22
"Anthony Lamb","HOU",24,415,23,59,10,13,7,2,1,3,10
"Brodric Thomas","CLE",32,399,30,70,20,10,14,3,3,4,6
"Zeke Nnaji","DEN",42,397,10,23,7,3,5,2,0,0,3
"Amir Coffey","LAC",44,394,22,56,10,12,5,3,2,7,5
"Freddie Gillespie","TOR",20,392,9,18,9,0,5,2,2,0,0
"E'Twaun Moore","PHX",27,389,40,93,27,13,20,4,3,2,11
"Isaiah Joe","PHI",41,383,20,46,14,6,9,3,2,0,6
"Glenn Robinson III","SAC",23,369,20,50,10,10,8,2,0,1,9
"Nico Mannion","GSW",30,364,70,168,42,28,27,8,7,4,24
"Trey Lyles","SAS",23,358,14,31,11,3,7,2,2,1,2
"Abdel Nader","PHX",24,355,19,44,13,6,9,1,3,4,2
"Harry Giles III","POR",38,348,29,73,14,15,9,1,4,5,10
"Luke Kornet","BOS",31,347,24,60,12,12,7,3,2,3,9
"Jahlil Okafor","DET",27,347,13,30,9,4,7,2,0,1,3
"Chandler Hutchison","WAS",25,346,17,42,9,8,6,3,0,1,7
"Josh Hall","OKC",21,336,28,68,16,12,13,2,1,3,9
"Mason Jones","PHI",32,334,42,101,25,17,21,3,1,4,13
"Shaquille Harrison","DEN",34,332,25,66,9,16,3,4,2,6,10
"Matt Thomas","UTA",45,327,19,47,10,9,8,2,0,6,3
"Kelan Martin","IND",35,322,17,40,11,6,3,6,2,1,5
"Frank Ntilikina","NYK",33,322,19,48,9,10,6,0,3,1,9
"Jaylen Hoard","OKC",19,320,24,52,20,4,13,5,2,0,4
"JaKarr Sampson","IND",29,316,4,9,3,1,2,1,0,0,1
"Justin James","SAC",36,310,22,51,15,7,6,6,3,2,5
"Luka Samanic","SAS",33,308,15,32,13,2,10,3,0,0,2
"Jerome Robinson","WAS",17,305,25,59,16,9,7,7,2,2,7
"Trent Forrest","UTA",30,302,45,119,16,29,7,9,0,9,20
"Ed Davis","MIN",23,299,21,53,10,11,5,1,4,1,10
"Paul Watson","TOR",27,297,17,44,7,10,3,3,1,3,7
"Romeo Langford","BOS",18,283,13,29,10,3,4,5,1,0,3
"Vlatko Cancar","DEN",41,281,14,34,8,6,6,2,0,1,5
"Mfiondu Kabengele","CLE",39,280,17,41,10,7,6,3,1,2,5
"Nathan Knight","ATL",33,279,8,21,3,5,2,1,0,1,4
"Carsen Edwards","BOS",31,276,14,37,5,9,3,1,1,5,4
"Jordan Nwora","MIL",30,274,7,15,6,1,6,0,0,1,0
"Boban Marjanovic","DAL",33,271,10,21,9,1,5,2,2,0,1
"Thomas Bryant","WAS",10,271,15,35,10,5,5,4,1,1,4
"Skylar Mays","ATL",33,269,30,72,18,12,15,1,2,4,8
"Tre Jones","SAS",37,269,39,89,28,11,21,2,5,2,9
"Jaren Jackson Jr.","MEM",11,258,12,30,6,6,4,2,0,3,3
"Alfonzo McKinnie","LAL",39,258,6,15,3,3,2,0,1,1,2
"Ignas Brazdeikis","ORL",13,249,17,38,13,4,11,2,0,0,4
"Justin Patton","HOU",13,247,14,36,6,8,5,0,1,3,5
"Keita Bates-Diop","SAS",30,245,12,27,9,3,7,2,0,1,2
"Wenyen Gabriel","NOP",21,241,11,28,5,6,3,1,1,5,1
"Tremont Waters","BOS",26,238,62,144,42,20,29,8,5,11,9
"Mike James","BKN",13,236,54,139,23,31,17,5,1,9,22
"Kyle Guy","SAC",31,235,32,74,22,10,12,6,4,2,8
"Sam Merrill","MIL",30,233,21,52,11,10,5,3,3,4,6
"Chris Chiozza","BKN",22,232,65,151,44,21,32,9,3,5,16
"Bruno Fernando","ATL",33,226,10,23,7,3,2,3,2,0,3
"Matthew Dellavedova","CLE",13,224,58,140,34,24,22,11,1,7,17
"Anthony Gill","WAS",26,218,11,25,8,3,4,2,2,2,1
"Sindarius Thornwell","ORL",21,217,21,51,12,9,8,2,2,2,7
"Markelle Fultz","ORL",8,215,43,103,26,17,11,12,3,1,16
"Gabriel Deck","OKC",10,212,24,60,12,12,8,3,1,2,10
"Reggie Perry","BKN",26,211,14,32,10,4,7,1,2,0,4
"Dewayne Dedmon","MIA",16,210,12,32,4,8,2,1,1,1,7
"Markus Howard","DEN",37,205,18,42,12,6,6,3,3,2,4
"Darius Miller","OKC",18,197,21,51,12,9,9,2,1,2,7
"Jordan Bone","ORL",14,196,18,44,10,8,5,4,1,3,5
"Rodney McGruder","DET",16,194,16,38,10,6,5,3,2,2,4
"CJ Elleby","POR",30,192,10,24,6,4,5,1,0,0,4
"Alize Johnson","BKN",18,189,14,35,7,7,4,3,0,2,5
"Killian Tillie","MEM",18,182,8,19,5,3,1,4,0,1,2
"Donta Hall","ORL",13,179,11,29,4,7,1,2,1,0,7
"Paul Reed","PHI",26,177,12,29,7,5,6,0,1,1,4
"Jalen Harris","TOR",13,172,17,44,7,10,4,2,1,1,9
"Jabari Parker","BOS",13,166,11,26,7,4,4,3,0,1,3
"Daniel Oturu","LAC",30,161,10,23,7,3,5,1,1,0,3
"Bol Bol","DEN",32,160,7,17,4,3,1,1,2,0,3
"Sean McDermott","MEM",18,158,4,10,2,2,2,0,0,1,1
"Quinn Cook","CLE",23,157,18,44,10,8,9,0,1,2,6
"Jalen Smith","PHX",27,156,4,10,2,2,0,1,1,1,1
"Khyri Thomas","HOU",5,153,25,63,12,13,9,2,1,0,13
"Charlie Brown Jr.","OKC",9,152,9,20,7,2,5,1,1,0,2
"Ersan Ilyasova","UTA",17,148,4,10,2,2,1,0,1,0,2
"Juwan Morgan","UTA",29,147,9,23,4,5,4,0,0,3,2
"Mamadi Diakite","MIL",14,141,8,20,4,4,2,0,2,1,3
"Jarrell Brantley","UTA",28,138,15,41,4,11,3,0,1,2,9
"Yogi Ferrell","LAC",10,137,22,52,14,8,9,3,2,5,3
"Tacko Fall","BOS",18,136,3,9,0,3,0,0,0,1,2
"Deividas Sirvydis","DET",20,133,5,14,1,4,1,0,0,1,3
"Rodions Kurucs","MIL",21,125,10,25,5,5,5,0,0,1,4
"Dakota Mathias","PHI",8,123,13,29,10,3,4,4,2,0,3
"Quinndary Weatherspoon","SAS",20,121,8,16,8,0,5,3,0,0,0
"T.J. Warren","IND",4,117,5,13,2,3,1,1,0,2,1
"Dante Exum","CLE",6,116,13,26,13,0,9,3,1,0,0
"Vernon Carey Jr.","CHA",19,115,2,4,2,0,2,0,0,0,0
"Rondae Hollis-Jefferson","POR",11,107,13,32,7,6,4,3,0,2,4
"Robert Franks","ORL",7,101,5,12,3,2,2,1,0,0,2
"Anthony Tolliver","PHI",11,99,2,5,1,1,1,0,0,0,1
"Cassius Winston","WAS",22,98,12,26,10,2,4,4,2,0,2
"Devontae Cacok","LAL",20,98,1,2,1,0,1,0,0,0,0
"Jahmi'us Ramsey","SAC",13,94,6,15,3,3,3,0,0,0,3
"Nate Hinton","DAL",21,93,8,19,5,3,4,0,1,1,2
"Cassius Stanley","IND",24,93,1,3,0,1,0,0,0,1,0
"Chris Silva","SAC",15,92,6,14,4,2,2,1,1,0,2
"Karim Mane","ORL",10,88,4,10,2,2,2,0,0,1,1
"Justin Robinson","OKC",9,88,9,22,5,4,4,1,0,1,3
"Cameron Oliver","HOU",4,87,5,13,2,3,1,1,0,1,2
"Louis King","SAC",6,85,9,22,5,4,4,0,1,1,3
"Jay Scrubb","LAC",4,84,1,2,1,0,0,0,1,0,0
"Alen Smailagic","GSW",15,84,4,9,3,1,2,1,0,0,1
"Cristiano Felicio","CHI",18,84,9,18,9,0,6,2,1,0,0
"Norvel Pelle","NYK",13,83,2,4,2,0,1,1,0,0,0
"Jordan Bell","GSW",6,82,7,17,4,3,3,0,1,1,2
"Jared Dudley","LAL",12,81,5,13,2,3,2,0,0,1,2
"Frank Mason","ORL",4,79,12,25,11,1,6,1,4,0,1
"Thon Maker","CLE",8,76,4,9,3,1,3,0,0,1,0
"Jeremiah Martin","CLE",9,75,4,10,2,2,2,0,0,1,1
"Keljin Blevins","POR",17,75,4,10,2,2,2,0,0,1,1
"Devin Cannady","ORL",8,74,1,3,0,1,0,0,0,0,1
"Tyler Bey","DAL",18,71,3,8,1,2,0,1,0,1,1
"Rayjon Tucker","PHI",14,68,6,14,4,2,2,2,0,0,2
"Spencer Dinwiddie","BKN",3,64,9,24,3,6,2,1,0,1,5
"Elijah Hughes","UTA",18,64,6,15,3,3,2,1,0,2,1
"Andre Roberson","BKN",5,63,4,9,3,1,3,0,0,0,1
"Nick Richards","CHA",18,63,2,4,2,0,1,0,1,0,0
"Tim Frazier","MEM",5,62,16,39,9,7,6,2,1,1,6
"Axel Toupane","MIL",8,61,4,10,2,2,1,0,1,1,1
"Udoka Azubuike","UTA",15,57,0,0,0,0,0,0,0,0,0
"Kostas Antetokounmpo","LAL",15,56,1,3,0,1,0,0,0,0,1